"lang"
{
"Language"	"finnish"
"Tokens"
{
"DOTA_Tooltip_ability_item_bag_of_gold"	"Kultasäkki"
"[english]DOTA_Tooltip_ability_item_bag_of_gold"	"Bag of Gold"
"DOTA_HUD_Victory"	"VOITTO!"
"[english]DOTA_HUD_Victory"	"VICTORY!"
"DOTA_HUD_Defeat"	"TAPPIO!"
"[english]DOTA_HUD_Defeat"	"DEFEAT!"
"DOTA_HUD_Kills"	"TAPPOJA"
"[english]DOTA_HUD_Kills"	"KILLS"
"DOTA_HUD_Deaths"	"KUOLEMAT"
"[english]DOTA_HUD_Deaths"	"DEATHS"
"DOTA_HUD_Bags"	"SÄKIT"
"[english]DOTA_HUD_Bags"	"BAGS"
"DOTA_HUD_Yes"	"KYLLÄ"
"[english]DOTA_HUD_Yes"	"YES"
"DOTA_HUD_No"	"EI"
"[english]DOTA_HUD_No"	"NO"
"DOTA_Holdout_Award_Dominating_Title"	"Liekeissä"
"[english]DOTA_Holdout_Award_Dominating_Title"	"Dominating"
"DOTA_Holdout_Award_Unstoppable_Title"	"Pysäyttämätön"
"[english]DOTA_Holdout_Award_Unstoppable_Title"	"Unstoppable"
"DOTA_Tooltip_Ability_creature_slithereen_crush"	"Bash"
"[english]DOTA_Tooltip_Ability_creature_slithereen_crush"	"Bash"
"DOTA_Tooltip_ability_creature_spawn_broodmother_eggs_Description"	"Laskee useita munia."
"[english]DOTA_Tooltip_ability_creature_spawn_broodmother_eggs_Description"	"Lays several eggs."
"DOTA_Tooltip_ability_holdout_gyrocopter_homing_missile_Description"	"Laukaisee kohteeseensa hakeutuvan raketin."
"[english]DOTA_Tooltip_ability_holdout_gyrocopter_homing_missile_Description"	"Launches a homing missile at a target."
"DOTA_Tooltip_modifier_holdout_gods_strength"	"God's Strength"
"[english]DOTA_Tooltip_modifier_holdout_gods_strength"	"Gods Strength"
"npc_dota_creature_worg"	"Worg"
"[english]npc_dota_creature_worg"	"Worg"
"npc_dota_creature_alpha_worg"	"Alpha Worg"
"[english]npc_dota_creature_alpha_worg"	"Alpha Worg"
"npc_dota_creature_wildwing_laborer"	"Tamed Wildwing"
"[english]npc_dota_creature_wildwing_laborer"	"Tamed Wildwing"
"npc_dota_creature_dazzle"	"Acolyte of Dezun"
"[english]npc_dota_creature_dazzle"	"Acolyte of Dezun"
"npc_dota_creature_hellbear"	"Hell Bear"
"[english]npc_dota_creature_hellbear"	"Hellbear"
"npc_dota_creature_nyx_assassin"	"Zealot Scarab"
"[english]npc_dota_creature_nyx_assassin"	"Zealot Scarab"
"npc_dota_creature_morphling_small"	"Lesser Elemental"
"[english]npc_dota_creature_morphling_small"	"Lesser Elemental"
"npc_dota_creature_morphling_big"	"Greater Elemental"
"[english]npc_dota_creature_morphling_big"	"Greater Elemental"
"npc_dota_creature_bonus_chicken"	"Rooster"
"[english]npc_dota_creature_bonus_chicken"	"Rooster"
"npc_dota_creature_warlock_golem"	"Enthralled Golem"
"[english]npc_dota_creature_warlock_golem"	"Enthralled Golem"
"npc_dota_creature_warlock"	"Demon Charmer"
"[english]npc_dota_creature_warlock"	"Demon Charmer"
"DOTA_Tooltip_ability_item_upgraded_barricade_armor_bonus_per_upgrade"	"LISÄPANSSARI:"
"[english]DOTA_Tooltip_ability_item_upgraded_barricade_armor_bonus_per_upgrade"	"BONUS ARMOR:"
"DOTA_Tooltip_ability_item_tombstone"	"Elvytä liittolainen"
"[english]DOTA_Tooltip_ability_item_tombstone"	"Resurrect Teammate"
"DOTA_Tooltip_ability_holdout_arc_lightning_jump_count"	"LOIKAT:"
"[english]DOTA_Tooltip_ability_holdout_arc_lightning_jump_count"	"JUMPS:"
"DOTA_Tooltip_ability_holdout_static_field_radius"	"KANTOMATKA:"
"[english]DOTA_Tooltip_ability_holdout_static_field_radius"	"RANGE:"
"DOTA_Tooltip_ability_holdout_phantom_strike"	"Phantom Strike"
"[english]DOTA_Tooltip_ability_holdout_phantom_strike"	"Phantom Strike"
"DOTA_Tooltip_ability_holdout_phantom_strike_Description"	"Siirtyy silmänräpäyksessä valitun hahmon viereen ja antaa hyökkäysnopeuslisän, jos kyseessä on vihollinen."
"[english]DOTA_Tooltip_ability_holdout_phantom_strike_Description"	"Teleports to a unit, friendly or enemy, and grants bonus attack speed while attacking if it's an enemy unit."
"DOTA_Tooltip_ability_holdout_phantom_strike_Lore"	"Mortredin silkkinen huntu on viimeinen asia, jonka hänen epäonninen uhrinsa näkee."
"[english]DOTA_Tooltip_ability_holdout_phantom_strike_Lore"	"Mortred's silken veil is the last thing her unfortunate target sees."
"DOTA_Tooltip_ability_holdout_phantom_strike_tooltip_range"	"KANTOMATKA:"
"[english]DOTA_Tooltip_ability_holdout_phantom_strike_tooltip_range"	"RANGE:"
"DOTA_Tooltip_ability_holdout_blur"	"Blur"
"[english]DOTA_Tooltip_ability_holdout_blur"	"Blur"
"DOTA_Tooltip_ability_holdout_blur_Description"	"Phantom Assassin muuttuu vaikeasti nähtäväksi sumentamalla kehonsa ja katoamalla kartalta, kun vihollissankari on lähellä. Osa vihollishyökkäyksistä ei osu."
"[english]DOTA_Tooltip_ability_holdout_blur_Description"	"The Phantom Assassin becomes hard to see by blurring her body and disappearing from the enemy minimap when near enemy heroes. Some enemy attacks miss."
"DOTA_Tooltip_ability_holdout_blur_Lore"	"Meditaatio antaa Huntusiskon ennakoida vihollisensa taistelussa tarkasti."
"[english]DOTA_Tooltip_ability_holdout_blur_Lore"	"Meditation allows a Veiled Sister to carefully anticipate her opponents in combat."
"DOTA_Tooltip_ability_holdout_blur_radius"	"SÄDE:"
"[english]DOTA_Tooltip_ability_holdout_blur_radius"	"RADIUS:"
"DOTA_Tooltip_ability_holdout_coup_de_grace"	"Coup de Grace"
"[english]DOTA_Tooltip_ability_holdout_coup_de_grace"	"Coup de Grace"
"DOTA_Tooltip_ability_holdout_windrun"	"Windrun"
"[english]DOTA_Tooltip_ability_holdout_windrun"	"Windrun"
"DOTA_Tooltip_ability_holdout_focusfire"	"Zephyr"
"[english]DOTA_Tooltip_ability_holdout_focusfire"	"Zephyr"
"DOTA_Tooltip_ability_holdout_mirana_arrow_arrow_range"	"KANTOMATKA:"
"[english]DOTA_Tooltip_ability_holdout_mirana_arrow_arrow_range"	"RANGE:"
"DOTA_Tooltip_ability_holdout_purification_radius"	"SÄDE:"
"[english]DOTA_Tooltip_ability_holdout_purification_radius"	"RADIUS:"
"DOTA_Tooltip_ability_holdout_guardian_angel_radius"	"SÄDE:"
"[english]DOTA_Tooltip_ability_holdout_guardian_angel_radius"	"RADIUS:"
"DOTA_Tooltip_ability_holdout_axe_berserkers_call_bonus_armor"	"LISÄPANSSARI:"
"[english]DOTA_Tooltip_ability_holdout_axe_berserkers_call_bonus_armor"	"BONUS ARMOR:"
"DOTA_Tooltip_ability_holdout_axe_counter_helix"	"Counter Helix"
"[english]DOTA_Tooltip_ability_holdout_axe_counter_helix"	"Counter Helix"
"DOTA_Tooltip_ability_holdout_axe_counter_helix_radius"	"SÄDE:"
"[english]DOTA_Tooltip_ability_holdout_axe_counter_helix_radius"	"RADIUS:"
"DOTA_Tooltip_ability_holdout_voodoo"	"Voodoo"
"[english]DOTA_Tooltip_ability_holdout_voodoo"	"Voodoo"
"DOTA_Tooltip_ability_holdout_shackles"	"Shackles"
"[english]DOTA_Tooltip_ability_holdout_shackles"	"Shackles"
"DOTA_Tooltip_ability_holdout_shadowraze1_shadowraze_range"	"KANTOMATKA:"
"[english]DOTA_Tooltip_ability_holdout_shadowraze1_shadowraze_range"	"RANGE:"
"DOTA_Tooltip_ability_holdout_shadowraze2_shadowraze_range"	"KANTOMATKA:"
"[english]DOTA_Tooltip_ability_holdout_shadowraze2_shadowraze_range"	"RANGE:"
"DOTA_Tooltip_ability_holdout_shadowraze3_shadowraze_range"	"KANTOMATKA:"
"[english]DOTA_Tooltip_ability_holdout_shadowraze3_shadowraze_range"	"RANGE:"
"DOTA_Tooltip_ability_holdout_gush"	"Gush"
"[english]DOTA_Tooltip_ability_holdout_gush"	"Gush"
"DOTA_Tooltip_ability_holdout_culling_blade_damage"	"VAHINKOA:"
"[english]DOTA_Tooltip_ability_holdout_culling_blade_damage"	"DAMAGE:"
"DOTA_Tooltip_ability_holdout_multishot_arrow_range"	"KANTOMATKA:"
"[english]DOTA_Tooltip_ability_holdout_multishot_arrow_range"	"RANGE:"
"DOTA_Tooltip_ability_holdout_marksmanship"	"Marksmanship"
"[english]DOTA_Tooltip_ability_holdout_marksmanship"	"Marksmanship"
"DOTA_Tooltip_ability_holdout_blade_fury"	"Blade Fury"
"[english]DOTA_Tooltip_ability_holdout_blade_fury"	"Blade Fury"
"DOTA_Tooltip_ability_holdout_blade_fury_blade_fury_radius"	"SÄDE:"
"[english]DOTA_Tooltip_ability_holdout_blade_fury_blade_fury_radius"	"RADIUS:"
"DOTA_Tooltip_ability_holdout_blade_fury_damage"	"VAHINKOA:"
"[english]DOTA_Tooltip_ability_holdout_blade_fury_damage"	"DAMAGE:"
"DOTA_Tooltip_ability_holdout_omnislash_image_radius"	"SÄDE:"
"[english]DOTA_Tooltip_ability_holdout_omnislash_image_radius"	"RADIUS:"
"DOTA_Tooltip_ability_holdout_omnislash_range"	"KANTOMATKA:"
"[english]DOTA_Tooltip_ability_holdout_omnislash_range"	"RANGE:"
"DOTA_Tooltip_ability_holdout_storm_bolt_bolt_aoe"	"SÄDE:"
"[english]DOTA_Tooltip_ability_holdout_storm_bolt_bolt_aoe"	"RADIUS:"
"DOTA_Tooltip_ability_holdout_great_cleave_great_cleave_radius"	"SÄDE:"
"[english]DOTA_Tooltip_ability_holdout_great_cleave_great_cleave_radius"	"RADIUS:"
"DOTA_Tooltip_ability_holdout_warcry"	"Warcry"
"[english]DOTA_Tooltip_ability_holdout_warcry"	"Warcry"
"DOTA_Tooltip_ability_holdout_warcry_warcry_radius"	"SÄDE:"
"[english]DOTA_Tooltip_ability_holdout_warcry_warcry_radius"	"RADIUS:"
"DOTA_Tooltip_ability_holdout_warcry_warcry_armor"	"LISÄPANSSARI:"
"[english]DOTA_Tooltip_ability_holdout_warcry_warcry_armor"	"BONUS ARMOR:"
"DOTA_Tooltip_ability_holdout_scourge_ward_ward_hp_tooltip"	"WARDIN TERVEYS:"
"[english]DOTA_Tooltip_ability_holdout_scourge_ward_ward_hp_tooltip"	"WARD HP:"
"DOTA_Tooltip_ability_holdout_poison_nova_radius"	"SÄDE:"
"[english]DOTA_Tooltip_ability_holdout_poison_nova_radius"	"RADIUS:"
"DOTA_Tooltip_ability_holdout_poison_nova_duration"	"KESTO:"
"[english]DOTA_Tooltip_ability_holdout_poison_nova_duration"	"DURATION:"
"DOTA_Tooltip_ability_holdout_poison_nova_damage"	"VAHINKOA:"
"[english]DOTA_Tooltip_ability_holdout_poison_nova_damage"	"DAMAGE:"
"DOTA_Tooltip_ability_holdout_shockwave_shock_damage"	"VAHINKOA:"
"[english]DOTA_Tooltip_ability_holdout_shockwave_shock_damage"	"DAMAGE:"
"DOTA_Tooltip_ability_holdout_shockwave_shock_distance"	"ETÄISYYS:"
"[english]DOTA_Tooltip_ability_holdout_shockwave_shock_distance"	"DISTANCE:"
"DOTA_Tooltip_ability_holdout_friendly_skewer_range"	"ETÄISYYS:"
"[english]DOTA_Tooltip_ability_holdout_friendly_skewer_range"	"DISTANCE:"
"DOTA_Tooltip_ability_holdout_friendly_skewer_skewer_speed"	"NOPEUS:"
"[english]DOTA_Tooltip_ability_holdout_friendly_skewer_skewer_speed"	"SPEED:"
"DOTA_Tooltip_ability_holdout_reverse_polarity"	"Reverse Polarity"
"[english]DOTA_Tooltip_ability_holdout_reverse_polarity"	"Reverse Polarity"
"DOTA_Tooltip_ability_holdout_gladiators_unite_bonus_armor_per_hero"	"LISÄPANSSARI/SANKARI:"
"[english]DOTA_Tooltip_ability_holdout_gladiators_unite_bonus_armor_per_hero"	"BONUS ARMOR PER HERO:"
"DOTA_Tooltip_ability_holdout_gladiators_unite_radius"	"SÄDE:"
"[english]DOTA_Tooltip_ability_holdout_gladiators_unite_radius"	"RADIUS:"
"DOTA_Tooltip_modifier_holdout_gladiators_unite_Description"	"Saadaan %dMODIFIER_PROPERTY_PHYSICAL_ARMOR_BONUS% lisää panssaria, %dMODIFIER_PROPERTY_PREATTACK_BONUS_DAMAGE% lisävahinkoa, ja %dMODIFIER_PROPERTY_TOOLTIP%%% vampirismia hyökkäyksiin."
"[english]DOTA_Tooltip_modifier_holdout_gladiators_unite_Description"	"Gaining %dMODIFIER_PROPERTY_PHYSICAL_ARMOR_BONUS% bonus armor, %dMODIFIER_PROPERTY_PREATTACK_BONUS_DAMAGE% bonus damage, and %dMODIFIER_PROPERTY_TOOLTIP%%% lifesteal on physical attacks."
"DOTA_Tooltip_ability_holdout_dragon_slave"	"Dragon Slave"
"[english]DOTA_Tooltip_ability_holdout_dragon_slave"	"Dragon Slave"
"DOTA_Tooltip_ability_holdout_light_strike_array_light_strike_array_aoe"	"SÄDE:"
"[english]DOTA_Tooltip_ability_holdout_light_strike_array_light_strike_array_aoe"	"RADIUS:"
"DOTA_Tooltip_ability_holdout_caustic_finale_caustic_finale_radius"	"SÄDE:"
"[english]DOTA_Tooltip_ability_holdout_caustic_finale_caustic_finale_radius"	"RADIUS:"
"DOTA_Tooltip_ability_holdout_static_remnant_static_remnant_damage_radius"	"SÄDE:"
"[english]DOTA_Tooltip_ability_holdout_static_remnant_static_remnant_damage_radius"	"RADIUS:"
"DOTA_Tooltip_ability_holdout_static_remnant_static_remnant_damage"	"VAHINKO:"
"[english]DOTA_Tooltip_ability_holdout_static_remnant_static_remnant_damage"	"DAMAGE:"
"DOTA_Tooltip_ability_holdout_overload"	"Overload"
"[english]DOTA_Tooltip_ability_holdout_overload"	"Overload"
"DOTA_Tooltip_ability_holdout_overload_aoe"	"SÄDE:"
"[english]DOTA_Tooltip_ability_holdout_overload_aoe"	"RADIUS:"
"DOTA_Tooltip_ability_holdout_electric_vortex_self_slow"	"HIDASTUS:"
"[english]DOTA_Tooltip_ability_holdout_electric_vortex_self_slow"	"SLOW:"
"DOTA_Tooltip_ability_holdout_ball_lightning_ball_lightning_move_speed"	"NOPEUS:"
"[english]DOTA_Tooltip_ability_holdout_ball_lightning_ball_lightning_move_speed"	"SPEED:"
"DOTA_Tooltip_ability_holdout_ball_lightning_ball_lightning_aoe"	"SÄDE:"
"[english]DOTA_Tooltip_ability_holdout_ball_lightning_ball_lightning_aoe"	"RADIUS:"
"DOTA_Tooltip_ability_holdout_queenofpain_shadow_strike_distance"	"ETÄISYYS:"
"[english]DOTA_Tooltip_ability_holdout_queenofpain_shadow_strike_distance"	"DISTANCE:"
"DOTA_Tooltip_ability_holdout_queenofpain_shadow_strike_radius"	"SÄDE:"
"[english]DOTA_Tooltip_ability_holdout_queenofpain_shadow_strike_radius"	"RADIUS:"
"DOTA_Tooltip_ability_holdout_qop_blink"	"Blink"
"[english]DOTA_Tooltip_ability_holdout_qop_blink"	"Blink"
"DOTA_Tooltip_ability_holdout_scream_of_pain_area_of_effect"	"SÄDE:"
"[english]DOTA_Tooltip_ability_holdout_scream_of_pain_area_of_effect"	"RADIUS:"
"DOTA_Tooltip_ability_holdout_sonic_wave_final_aoe"	"SÄDE:"
"[english]DOTA_Tooltip_ability_holdout_sonic_wave_final_aoe"	"RADIUS:"
"DOTA_Tooltip_ability_holdout_sonic_wave_damage"	"VAHINKO:"
"[english]DOTA_Tooltip_ability_holdout_sonic_wave_damage"	"DAMAGE:"
"DOTA_Tooltip_Ability_Tower_Fortification"	"Fortification"
"[english]DOTA_Tooltip_Ability_Tower_Fortification"	"Fortification"
"DOTA_Tooltip_ability_holdout_paralyzing_cask_bounces_tooltip"	"KIMPOAMISIA:"
"[english]DOTA_Tooltip_ability_holdout_paralyzing_cask_bounces_tooltip"	"BOUNCES:"
"DOTA_Tooltip_ability_holdout_paralyzing_cask_hero_duration"	"SANKARIN TAINNUTUKSEN KESTO:"
"[english]DOTA_Tooltip_ability_holdout_paralyzing_cask_hero_duration"	"HERO STUN DURATION:"
"DOTA_Tooltip_ability_holdout_voodoo_restoration_heal"	"PARANNUS:"
"[english]DOTA_Tooltip_ability_holdout_voodoo_restoration_heal"	"HEAL:"
"DOTA_Tooltip_ability_holdout_voodoo_restoration_radius"	"SÄDE:"
"[english]DOTA_Tooltip_ability_holdout_voodoo_restoration_radius"	"RADIUS:"
"DOTA_Tooltip_ability_holdout_death_ward_damage"	"VAHINKO:"
"[english]DOTA_Tooltip_ability_holdout_death_ward_damage"	"DAMAGE:"
"DOTA_Tooltip_ability_phantom_assassin_stifling_dagger_nb2017_base_damage"	"PERUSVAHINKO:"
"[english]DOTA_Tooltip_ability_phantom_assassin_stifling_dagger_nb2017_base_damage"	"BASE DAMAGE:"
"DOTA_Tooltip_ability_phantom_assassin_phantom_strike_nb2017"	"Phantom Strike"
"[english]DOTA_Tooltip_ability_phantom_assassin_phantom_strike_nb2017"	"Phantom Strike"
"DOTA_Tooltip_ability_phantom_assassin_phantom_strike_nb2017_Lore"	"Mortredin silkkinen huntu on viimeinen asia, jonka hänen epäonninen uhrinsa näkee."
"[english]DOTA_Tooltip_ability_phantom_assassin_phantom_strike_nb2017_Lore"	"Mortred's silken veil is the last thing her unfortunate target sees."
"DOTA_Tooltip_modifier_phantom_assassin_phantom_strike_nb2017"	"Phantom Strike"
"[english]DOTA_Tooltip_modifier_phantom_assassin_phantom_strike_nb2017"	"Phantom Strike"
"DOTA_Tooltip_ability_treant_leech_seed_nb2017"	"Leech Seed"
"[english]DOTA_Tooltip_ability_treant_leech_seed_nb2017"	"Leech Seed"
"DOTA_Tooltip_ability_treant_leech_seed_nb2017_duration"	"KESTO:"
"[english]DOTA_Tooltip_ability_treant_leech_seed_nb2017_duration"	"DURATION:"
"DOTA_Tooltip_ability_treant_great_protector"	"Great Protector"
"[english]DOTA_Tooltip_ability_treant_great_protector"	"Great Protector"
"DOTA_Tooltip_ability_treant_great_protector_bonus_strength"	"VOIMALISÄ:"
"[english]DOTA_Tooltip_ability_treant_great_protector_bonus_strength"	"BONUS STRENGTH:"
"DOTA_Tooltip_ability_treant_great_protector_move_speed"	"LIIKENOPEUS:"
"[english]DOTA_Tooltip_ability_treant_great_protector_move_speed"	"MOVE SPEED:"
"DOTA_Tooltip_ability_treant_great_protector_duration"	"KESTO:"
"[english]DOTA_Tooltip_ability_treant_great_protector_duration"	"DURATION:"
"DOTA_Tooltip_ability_dark_seer_wall_of_replica_nb2017"	"Wall of Replica"
"[english]DOTA_Tooltip_ability_dark_seer_wall_of_replica_nb2017"	"Wall of Replica"
"DOTA_Tooltip_ability_phoenix_fire_spirits_nb2017_damage_per_second"	"VAHINKOA SEKUNNISSA:"
"[english]DOTA_Tooltip_ability_phoenix_fire_spirits_nb2017_damage_per_second"	"DAMAGE PER SECOND:"
"DOTA_Tooltip_ability_phoenix_launch_fire_spirit_nb2017_damage_per_second"	"VAHINKOA SEKUNNISSA:"
"[english]DOTA_Tooltip_ability_phoenix_launch_fire_spirit_nb2017_damage_per_second"	"DAMAGE PER SECOND:"
"DOTA_Tooltip_ability_sniper_assassinate_dm2017"	"Assassinate"
"[english]DOTA_Tooltip_ability_sniper_assassinate_dm2017"	"Assassinate"
"DOTA_Tooltip_ability_zuus_static_field_dark_moon_radius"	"KANTAMA:"
"[english]DOTA_Tooltip_ability_zuus_static_field_dark_moon_radius"	"RANGE:"
"DOTA_Tooltip_ability_techies_suicide"	"Blast Off!"
"[english]DOTA_Tooltip_ability_techies_suicide"	"Blast Off!"
}
}
