"lang"
{
"Language"	"italian"
"Tokens"
{
"DOTA_HUD_Round"	"ROUND"
"[english]DOTA_HUD_Round"	"ROUND"
"DOTA_HUD_EnemiesRemaining"	"NEMICI RIMASTI:"
"[english]DOTA_HUD_EnemiesRemaining"	"ENEMIES REMAINING:"
"DOTA_HUD_NextRound"	"PROSSIMO ROUND: "
"[english]DOTA_HUD_NextRound"	"NEXT ROUND: "
"DOTA_HUD_RoundStart"	"INIZIO DEL ROUND!"
"[english]DOTA_HUD_RoundStart"	"ROUND START!"
"DOTA_HUD_Defeat"	"SCONFITTA!"
"[english]DOTA_HUD_Defeat"	"DEFEAT!"
"DOTA_HUD_Kills"	"UCCISIONI"
"[english]DOTA_HUD_Kills"	"KILLS"
"DOTA_HUD_Deaths"	"MORTI"
"[english]DOTA_HUD_Deaths"	"DEATHS"
"DOTA_HUD_Saves"	"RIANIMAZIONI"
"[english]DOTA_HUD_Saves"	"REVIVES"
"DOTA_HUD_Bags"	"SACCHI"
"[english]DOTA_HUD_Bags"	"BAGS"
"DOTA_HUD_Yes"	"SÌ"
"[english]DOTA_HUD_Yes"	"YES"
"DOTA_HUD_No"	"NO"
"[english]DOTA_HUD_No"	"NO"
"DOTA_HUD_Score"	"PUNTEGGI DEL ROUND"
"[english]DOTA_HUD_Score"	"ROUND SCORE"
"DOTA_HUD_TowersRemaining"	"TORRI RIMASTE"
"[english]DOTA_HUD_TowersRemaining"	"TOWERS REMAINING"
"DOTA_HUD_GoldBags"	"SACCHI OTTENUTI"
"[english]DOTA_HUD_GoldBags"	"GOLD BAGS COLLECTED"
"DOTA_HUD_GoldBagsMissed"	"SACCHI PERSI"
"[english]DOTA_HUD_GoldBagsMissed"	"GOLD BAGS MISSED"
"DOTA_HUD_TeamDeaths"	"MORTI (SQUADRA)"
"[english]DOTA_HUD_TeamDeaths"	"TEAM DEATHS"
"DOTA_HUD_DarkMoonPoints"	"PUNTI"
"[english]DOTA_HUD_DarkMoonPoints"	"POINTS"
"DOTA_HUD_ThisRound"	"PUNTI IN QUESTO ROUND"
"[english]DOTA_HUD_ThisRound"	"POINTS THIS ROUND"
"DOTA_HUD_TotalPoints"	"PUNTI TOTALI OTTENUTI IN QUESTA PARTITA"
"[english]DOTA_HUD_TotalPoints"	"TOTAL POINTS EARNED THIS MATCH"
"DOTA_HUD_Mute"	"SILENZIA"
"[english]DOTA_HUD_Mute"	"MUTE"
"dota_game_end_victory_title_dire"	"Sconfitta!"
"[english]dota_game_end_victory_title_dire"	"Defeated!"
"DOTA_Holdout_Award_MostDeadly_Title"	"Il più letale"
"[english]DOTA_Holdout_Award_MostDeadly_Title"	"Most Deadly"
"DOTA_Holdout_Award_MostDeadly_Desc"	" ha ucciso più nemici in questo round "
"[english]DOTA_Holdout_Award_MostDeadly_Desc"	" got the most kills this round "
"DOTA_Holdout_Award_MostSaves_Title"	"Medico da campo"
"[english]DOTA_Holdout_Award_MostSaves_Title"	"Field Medic"
"DOTA_Holdout_Award_MostSaves_Desc"	" ha rianimato più giocatori in questo round "
"[english]DOTA_Holdout_Award_MostSaves_Desc"	" revived the most other players this round "
"DOTA_Holdout_Award_LeastDeaths_Desc"	" è morto meno volte in questo round "
"[english]DOTA_Holdout_Award_LeastDeaths_Desc"	" had the least deaths this round "
"DOTA_Holdout_Award_MostPotions_Desc"	" ha preso più pozioni in questo round "
"[english]DOTA_Holdout_Award_MostPotions_Desc"	" took the most potions this round "
"DOTA_Holdout_Award_Clutched_Title"	"Sotto pressione"
"[english]DOTA_Holdout_Award_Clutched_Title"	"Clutched"
"DOTA_Holdout_Award_Clutched_Desc"	" ha vinto il round come ultimo giocatore in vita "
"[english]DOTA_Holdout_Award_Clutched_Desc"	" won the round as the last one alive "
"DOTA_Holdout_Award_KillingSpree_Title"	"Serie di uccisioni"
"[english]DOTA_Holdout_Award_KillingSpree_Title"	"Killing Spree"
"DOTA_Holdout_Award_KillingSpree_Desc"	" ha ucciso 100 nemici senza morire "
"[english]DOTA_Holdout_Award_KillingSpree_Desc"	" has a streak of 100 kills without dying "
"DOTA_Holdout_Award_Dominating_Title"	"Dominatore"
"[english]DOTA_Holdout_Award_Dominating_Title"	"Dominating"
"DOTA_Holdout_Award_Dominating_Desc"	" ha ucciso 200 nemici senza morire "
"[english]DOTA_Holdout_Award_Dominating_Desc"	" has a streak of 200 kills without dying "
"DOTA_Holdout_Award_MegaKill_Title"	"Mega-uccisione"
"[english]DOTA_Holdout_Award_MegaKill_Title"	"Mega Kill"
"DOTA_Holdout_Award_MegaKill_Desc"	" ha ucciso 300 nemici senza morire "
"[english]DOTA_Holdout_Award_MegaKill_Desc"	" has a streak of 300 kills without dying "
"DOTA_Holdout_Award_Unstoppable_Title"	"Inarrestabile"
"[english]DOTA_Holdout_Award_Unstoppable_Title"	"Unstoppable"
"DOTA_Holdout_Award_Unstoppable_Desc"	" ha ucciso 400 nemici senza morire "
"[english]DOTA_Holdout_Award_Unstoppable_Desc"	" has a streak of 400 kills without dying "
"DOTA_Holdout_Award_WickedSick_Title"	"Maniaco omicida"
"[english]DOTA_Holdout_Award_WickedSick_Title"	"Wicked Sick"
"DOTA_Holdout_Award_WickedSick_Desc"	" ha ucciso 500 nemici senza morire "
"[english]DOTA_Holdout_Award_WickedSick_Desc"	" has a streak of 500 kills without dying "
"DOTA_Holdout_Award_MonsterKill_Title"	"Uccisione mostruosa"
"[english]DOTA_Holdout_Award_MonsterKill_Title"	"Monster Kill"
"DOTA_Holdout_Award_MonsterKill_Desc"	" ha ucciso 600 nemici senza morire "
"[english]DOTA_Holdout_Award_MonsterKill_Desc"	" has a streak of 600 kills without dying "
"DOTA_Holdout_Award_GodLike_Title"	"Divino"
"[english]DOTA_Holdout_Award_GodLike_Title"	"Godlike"
"DOTA_Holdout_Award_GodLike_Desc"	" ha ucciso 700 nemici senza morire "
"[english]DOTA_Holdout_Award_GodLike_Desc"	" has a streak of 700 kills without dying "
"DOTA_Holdout_Award_Beyond_GodLike_Title"	"Più che divino"
"[english]DOTA_Holdout_Award_Beyond_GodLike_Title"	"Beyond Godlike"
"DOTA_Holdout_Award_Beyond_GodLike_Desc"	" ha ucciso 800 nemici senza morire "
"[english]DOTA_Holdout_Award_Beyond_GodLike_Desc"	" has a streak of 800 kills without dying "
"DOTA_Holdout_Award_UltraKill_Title"	"Ultra-uccisione"
"[english]DOTA_Holdout_Award_UltraKill_Title"	"Ultra Kill"
"DOTA_Holdout_Award_UltraKill_Desc"	" ha ucciso 25 o più creep in poco tempo "
"[english]DOTA_Holdout_Award_UltraKill_Desc"	" killed 25 or more creeps in a short time "
"DOTA_Holdout_Award_Rampage_Title"	"SCATENATO"
"[english]DOTA_Holdout_Award_Rampage_Title"	"RAMPAGE"
"DOTA_Holdout_Award_Rampage_Desc"	" ha ucciso 50 o più creep in poco tempo "
"[english]DOTA_Holdout_Award_Rampage_Desc"	" killed 50 or more creeps in a short time "
"DOTA_Tooltip_Ability_item_health_potion"	"Pozione di guarigione"
"[english]DOTA_Tooltip_Ability_item_health_potion"	"Health Potion"
"DOTA_Tooltip_Ability_item_mana_potion"	"Pozione di mana"
"[english]DOTA_Tooltip_Ability_item_mana_potion"	"Mana Potion"
"DOTA_Tooltip_Ability_creature_aura_health_regen"	"Aura lenitiva"
"[english]DOTA_Tooltip_Ability_creature_aura_health_regen"	"Healing Aura"
"DOTA_Tooltip_Ability_creature_acid_spray"	"Esplosione"
"[english]DOTA_Tooltip_Ability_creature_acid_spray"	"Burst"
"DOTA_Tooltip_Ability_creature_zombie_berserk"	"Furia omicida"
"[english]DOTA_Tooltip_Ability_creature_zombie_berserk"	"Berserk"
"DOTA_Tooltip_Ability_creature_melee_smash"	"Schianto"
"[english]DOTA_Tooltip_Ability_creature_melee_smash"	"Smash"
"DOTA_Tooltip_Ability_lesser_nightcrawler_pounce"	"Balzo"
"[english]DOTA_Tooltip_Ability_lesser_nightcrawler_pounce"	"Pounce"
"DOTA_Tooltip_Ability_creature_sprint"	"Scatto"
"[english]DOTA_Tooltip_Ability_creature_sprint"	"Sprint"
"DOTA_Tooltip_Ability_creature_slithereen_crush"	"Colpo"
"[english]DOTA_Tooltip_Ability_creature_slithereen_crush"	"Bash"
"DOTA_Tooltip_Ability_creature_self_haste"	"Rapidità"
"[english]DOTA_Tooltip_Ability_creature_self_haste"	"Haste"
"DOTA_Tooltip_Ability_creature_hatch_broodmother"	"Schiusa"
"[english]DOTA_Tooltip_Ability_creature_hatch_broodmother"	"Hatch"
"DOTA_Tooltip_Ability_creature_split_a"	"Sgretolamento"
"[english]DOTA_Tooltip_Ability_creature_split_a"	"Crumble"
"DOTA_Tooltip_Ability_creature_split_b"	"Sgretolamento"
"[english]DOTA_Tooltip_Ability_creature_split_b"	"Crumble"
"DOTA_Tooltip_Ability_holdout_ancient_apparition_ice_blast"	"Esplosione glaciale"
"[english]DOTA_Tooltip_Ability_holdout_ancient_apparition_ice_blast"	"Ice Blast"
"DOTA_Tooltip_creature_slithereen_crush_slow"	"Stordito"
"[english]DOTA_Tooltip_creature_slithereen_crush_slow"	"Stunned"
"npc_dota_creature_worg"	"Worg"
"[english]npc_dota_creature_worg"	"Worg"
"npc_dota_creature_dazzle"	"Accolito di Dezun"
"[english]npc_dota_creature_dazzle"	"Acolyte of Dezun"
"npc_dota_creature_hellbear"	"Orso infernale"
"[english]npc_dota_creature_hellbear"	"Hellbear"
"npc_dota_creature_nyx_assassin"	"Scarabeo devoto"
"[english]npc_dota_creature_nyx_assassin"	"Zealot Scarab"
"npc_dota_creature_morphling_small"	"Elementale inferiore"
"[english]npc_dota_creature_morphling_small"	"Lesser Elemental"
"npc_dota_creature_morphling_big"	"Elementale superiore"
"[english]npc_dota_creature_morphling_big"	"Greater Elemental"
"npc_dota_creature_bonus_chicken"	"Gallo"
"[english]npc_dota_creature_bonus_chicken"	"Rooster"
"npc_dota_creature_warlock_golem"	"Golem incantato"
"[english]npc_dota_creature_warlock_golem"	"Enthralled Golem"
"npc_dota_creature_lifestealer"	"Divoratore infuriato"
"[english]npc_dota_creature_lifestealer"	"Enraged Devourer"
"npc_dota_creature_kunkka_mini"	"Recluta"
"[english]npc_dota_creature_kunkka_mini"	"Recruit"
"npc_dota_creature_kunkka_medium"	"Capitano"
"[english]npc_dota_creature_kunkka_medium"	"Captain"
"npc_dota_creature_kunkka_large"	"Ammiraglio della flotta"
"[english]npc_dota_creature_kunkka_large"	"Fleet Admiral"
"npc_dota_creature_tidehunter_mini"	"Divoratore di gamberetti"
"[english]npc_dota_creature_tidehunter_mini"	"Krill-eater"
"npc_dota_creature_tidehunter_medium"	"Divoratore di squali"
"[english]npc_dota_creature_tidehunter_medium"	"Shark-eater"
"npc_dota_creature_tidehunter_large"	"Divoratore di balene"
"[english]npc_dota_creature_tidehunter_large"	"Whale-eater"
"npc_dota_creature_satyr_soulstealer"	"Usurpatore di anime"
"[english]npc_dota_creature_satyr_soulstealer"	"Soulstealer"
"npc_dota_creature_night_stalker"	"Cacciatore"
"[english]npc_dota_creature_night_stalker"	"Hunter"
"npc_dota_creature_enigma"	"Abisso"
"[english]npc_dota_creature_enigma"	"The Abyss"
"npc_dota_creature_techies_bomb_planter"	"Bombardiere"
"[english]npc_dota_creature_techies_bomb_planter"	"Bomber"
"npc_dota_creature_techies_land_mine"	"Mina"
"[english]npc_dota_creature_techies_land_mine"	"Land Mine"
"npc_dota_creature_quas_invoker"	"Scolaro di Koryx"
"[english]npc_dota_creature_quas_invoker"	"Scholar of Koryx"
"npc_dota_creature_wex_invoker"	"Mente di Tornarus"
"[english]npc_dota_creature_wex_invoker"	"Mind of Tornarus"
"npc_dota_creature_exort_invoker"	"Agente di Gallaron"
"[english]npc_dota_creature_exort_invoker"	"Agent of Gallaron"
"npc_dota_creature_boss_invoker"	"Mago oscuro"
"[english]npc_dota_creature_boss_invoker"	"The Dark Magus"
"npc_dota_holdout_tower"	"Torre"
"[english]npc_dota_holdout_tower"	"Tower"
"npc_dota_holdout_goodguys_fort"	"Tempio"
"[english]npc_dota_holdout_goodguys_fort"	"Temple"
"npc_dota_badguys_tower1_top"	"Torre della Luna Oscura"
"[english]npc_dota_badguys_tower1_top"	"Dark Moon Tower"
"DOTA_Holdout_Round_Nyx_Hellbear"	"Nyx Nyx Nyx"
"[english]DOTA_Holdout_Round_Nyx_Hellbear"	"Nyx Nyx Nyx"
"DOTA_Tooltip_ability_item_upgraded_mortar_bonus_per_upgrade"	"DANNO AGGIUNTIVO:"
"[english]DOTA_Tooltip_ability_item_upgraded_mortar_bonus_per_upgrade"	"BONUS DAMAGE:"
"DOTA_Tooltip_ability_item_upgraded_barricade"	"Barricata migliorata"
"[english]DOTA_Tooltip_ability_item_upgraded_barricade"	"Upgraded Barricade"
"DOTA_Tooltip_ability_item_upgraded_barricade_Description"	"Nome in inglese: <font color='#F2A93E'>Upgraded Barricade</font>\n \nMigliora permanentemente l'armatura e la salute della torre scelta."
"[english]DOTA_Tooltip_ability_item_upgraded_barricade_Description"	"Applies a permanent armor and hitpoint upgrade to the target tower."
"DOTA_Tooltip_ability_item_upgraded_barricade_hp_bonus_per_upgrade"	"SALUTE AGGIUNTIVA:"
"[english]DOTA_Tooltip_ability_item_upgraded_barricade_hp_bonus_per_upgrade"	"BONUS HP:"
"DOTA_Tooltip_ability_item_upgraded_barricade_armor_bonus_per_upgrade"	"ARMATURA AGGIUNTIVA:"
"[english]DOTA_Tooltip_ability_item_upgraded_barricade_armor_bonus_per_upgrade"	"BONUS ARMOR:"
"DOTA_Tooltip_ability_item_book_of_intelligence"	"Pergamena dell'Intelligenza"
"[english]DOTA_Tooltip_ability_item_book_of_intelligence"	"Scroll of Intelligence"
"DOTA_Tooltip_ability_item_book_of_intelligence_Description"	"Nome in inglese: <font color='#F2A93E'>Scroll of Intelligence</font>\n \nAumenta permanentemente l'Intelligenza di 5 punti."
"[english]DOTA_Tooltip_ability_item_book_of_intelligence_Description"	"Grants a permanent 5 Intelligence boost."
"DOTA_Tooltip_ability_item_book_of_strength"	"Pergamena della Forza"
"[english]DOTA_Tooltip_ability_item_book_of_strength"	"Scroll of Strength"
"DOTA_Tooltip_ability_item_book_of_strength_Description"	"Nome in inglese: <font color='#F2A93E'>Scroll of Strength</font>\n \nAumenta permanentemente la Forza di 5 punti."
"[english]DOTA_Tooltip_ability_item_book_of_strength_Description"	"Grants a permanent 5 Strength boost."
"DOTA_Tooltip_ability_item_book_of_agility"	"Pergamena dell'Agilità"
"[english]DOTA_Tooltip_ability_item_book_of_agility"	"Scroll of Agility"
"DOTA_Tooltip_ability_item_book_of_agility_Description"	"Nome in inglese: <font color='#F2A93E'>Scroll of Agility</font>\n \nAumenta permanentemente l'Agilità di 5 punti."
"[english]DOTA_Tooltip_ability_item_book_of_agility_Description"	"Grants a permanent 5 Agility boost."
"DOTA_Tooltip_ability_item_tombstone"	"Rianima l'alleato"
"[english]DOTA_Tooltip_ability_item_tombstone"	"Resurrect Teammate"
"DOTA_Chat_Tombstone_Pinged"	"C'è un alleato morto qui."
"[english]DOTA_Chat_Tombstone_Pinged"	"Fallen teammate here."
"DOTA_Tooltip_ability_keeper_of_the_light_mana_overload"	"Sovraccarico di mana"
"[english]DOTA_Tooltip_ability_keeper_of_the_light_mana_overload"	"Mana Overload"
"DOTA_Tooltip_ability_keeper_of_the_light_mana_overload_Description"	"Nome in inglese: <font color='#F2A93E'>Mana Overload</font>\n \nAttacco un nemico con pura essenza magica, infliggendogli gravi danni. Se il nemico muore durante l'attacco, la sua energia verrà sprigionata con forza, danneggiando tutti i suoi alleati vicini."
"[english]DOTA_Tooltip_ability_keeper_of_the_light_mana_overload_Description"	"Assaults an enemy with pure magical essence, causing heavy damage. If they die during the assault, they energy will burst forth, damaging all nearby enemies."
"DOTA_Tooltip_ability_keeper_of_the_light_mana_overload_Lore"	"Ezalor richiama il potere dell'armonia Primordiale per sopraffare i suoi nemici."
"[english]DOTA_Tooltip_ability_keeper_of_the_light_mana_overload_Lore"	"Ezalor calls upon Primordial harmony, overwhelming his enemies with its power."
"DOTA_Tooltip_ability_keeper_of_the_light_mana_overlord_damage"	"DANNO PER INTERVALLO:"
"[english]DOTA_Tooltip_ability_keeper_of_the_light_mana_overlord_damage"	"DAMAGE PER INTERVAL:"
"DOTA_Tooltip_ability_keeper_of_the_light_mana_overlord_think_interval"	"INTERVALLO:"
"[english]DOTA_Tooltip_ability_keeper_of_the_light_mana_overlord_think_interval"	"INTERVAL:"
"DOTA_Tooltip_ability_keeper_of_the_light_mana_overlord_explode_damage"	"DANNO DELL'ESPLOSIONE:"
"[english]DOTA_Tooltip_ability_keeper_of_the_light_mana_overlord_explode_damage"	"EXPLODE DAMAGE:"
"DOTA_Tooltip_ability_keeper_of_the_light_mana_overlord_explode_radius"	"RAGGIO DELL'ESPLOSIONE:"
"[english]DOTA_Tooltip_ability_keeper_of_the_light_mana_overlord_explode_radius"	"EXPLODE RADIUS:"
"DOTA_Tooltip_ability_holdout_arc_lightning"	"Arco elettrico"
"[english]DOTA_Tooltip_ability_holdout_arc_lightning"	"Arc Lightning"
"DOTA_Tooltip_ability_holdout_arc_lightning_Description"	"Nome in inglese: <font color='#F2A93E'>Arc Lightning</font>\n \nScaglia una saetta che colpisce tutte le Unità nemiche vicine."
"[english]DOTA_Tooltip_ability_holdout_arc_lightning_Description"	"Hurls a bolt of lightning that leaps through nearby enemy units."
"DOTA_Tooltip_ability_holdout_arc_lightning_Lore"	"L'Arco elettrico è l'incantesimo preferito da Zeus contro gli inferiori mortali."
"[english]DOTA_Tooltip_ability_holdout_arc_lightning_Lore"	"Arc Lightning is Zeus' favorite spell to use against puny mortals."
"DOTA_Tooltip_ability_holdout_arc_lightning_jump_count"	"BALZI:"
"[english]DOTA_Tooltip_ability_holdout_arc_lightning_jump_count"	"JUMPS:"
"DOTA_Tooltip_ability_holdout_lightning_bolt"	"Saetta"
"[english]DOTA_Tooltip_ability_holdout_lightning_bolt"	"Lightning Bolt"
"DOTA_Tooltip_ability_holdout_lightning_bolt_Description"	"Nome in inglese: <font color='#F2A93E'>Lightning Bolt</font>\n \nEvoca una saetta che colpisce un'Unità nemica, danneggiandola ed infliggendole un mini-stordimento. La Saetta dona Vera visione intorno al bersaglio in un raggio di 900 unità."
"[english]DOTA_Tooltip_ability_holdout_lightning_bolt_Description"	"Summons a bolt of lightning to strike an enemy unit, causing damage and a mini-stun. Lightning Bolt also provides True Sight around the target in a radius of 900."
"DOTA_Tooltip_ability_holdout_static_field_radius"	"GITTATA:"
"[english]DOTA_Tooltip_ability_holdout_static_field_radius"	"RANGE:"
"DOTA_Tooltip_ability_zuus_thundergods_vengeance_damage"	"DANNO:"
"[english]DOTA_Tooltip_ability_zuus_thundergods_vengeance_damage"	"DAMAGE:"
"DOTA_Tooltip_ability_zuus_thundergods_vengeance_sight_duration"	"DURATA:"
"[english]DOTA_Tooltip_ability_zuus_thundergods_vengeance_sight_duration"	"DURATION:"
"DOTA_Tooltip_ability_holdout_stifling_dagger_duration"	"DURATA:"
"[english]DOTA_Tooltip_ability_holdout_stifling_dagger_duration"	"DURATION:"
"DOTA_Tooltip_ability_holdout_phantom_strike_bonus_max_attack_count"	"ATTACCHI MASSIMI:"
"[english]DOTA_Tooltip_ability_holdout_phantom_strike_bonus_max_attack_count"	"MAX ATTACKS:"
"DOTA_Tooltip_ability_holdout_phantom_strike_bonus_attack_speed"	"VELOCITÀ DI ATTACCO AGGIUNTIVA:"
"[english]DOTA_Tooltip_ability_holdout_phantom_strike_bonus_attack_speed"	"BONUS ATTACK SPEED:"
"DOTA_Tooltip_ability_holdout_phantom_strike_tooltip_range"	"GITTATA:"
"[english]DOTA_Tooltip_ability_holdout_phantom_strike_tooltip_range"	"RANGE:"
"DOTA_Tooltip_ability_holdout_blur"	"Sfocatura"
"[english]DOTA_Tooltip_ability_holdout_blur"	"Blur"
"DOTA_Tooltip_ability_holdout_blur_Description"	"Nome in inglese: <font color='#F2A93E'>Blur</font>\n \nPhantom Assassin diventa difficile da vedere, sfocando il suo corpo e scomparendo dalla minimappa avversaria quando è nelle vicinanze degli Eroi nemici. Gli attacchi nemici possono mancare Phantom Assassin."
"[english]DOTA_Tooltip_ability_holdout_blur_Description"	"The Phantom Assassin becomes hard to see by blurring her body and disappearing from the enemy minimap when near enemy heroes. Some enemy attacks miss."
"DOTA_Tooltip_ability_holdout_blur_Lore"	"La meditazione consente ad una Sorella del Velo di anticipare con cautela i suoi avversari in combattimento."
"[english]DOTA_Tooltip_ability_holdout_blur_Lore"	"Meditation allows a Veiled Sister to carefully anticipate her opponents in combat."
"DOTA_Tooltip_ability_holdout_blue_Note0"	"Non è cumulabile con altre fonti di elusività."
"[english]DOTA_Tooltip_ability_holdout_blue_Note0"	"Doesn't stack with other sources of evasion."
"DOTA_Tooltip_ability_holdout_blue_Note1"	"Non si attiva su Eroi invisibili."
"[english]DOTA_Tooltip_ability_holdout_blue_Note1"	"Doesn't trigger from invisible heroes."
"DOTA_Tooltip_ability_holdout_blur_radius"	"RAGGIO:"
"[english]DOTA_Tooltip_ability_holdout_blur_radius"	"RADIUS:"
"DOTA_Tooltip_ability_holdout_coup_de_grace"	"Colpo di grazia"
"[english]DOTA_Tooltip_ability_holdout_coup_de_grace"	"Coup de Grace"
"DOTA_Tooltip_ability_holdout_coup_de_grace_Description"	"Nome in inglese: <font color='#F2A93E'>Coup de Grace</font>\n \nPhantom Assassin perfeziona le sue abilità di combattimento, ottenendo la probabilità di assestare un devastante colpo critico che perfora le Unità nemiche. Phantom Assassin può anche attivare il Colpo di grazia per ottenere un colpo critico garantito al prossimo attacco."
"[english]DOTA_Tooltip_ability_holdout_coup_de_grace_Description"	"Phantom Assassin refines her combat abilities, gaining a chance of delivering a devastating critical strike that cleaves through enemy units.  Phantom Assassin can also activate Coup de Grace to get a guaranteed critical strike on the next attack."
"DOTA_Tooltip_ability_holdout_coup_de_grace_Lore"	"Con un colpo divino, Mortred onora i suoi avversari scegliendoli per la loro morte."
"[english]DOTA_Tooltip_ability_holdout_coup_de_grace_Lore"	"A divine strike, Mortred honors her opponent by choosing them for death."
"DOTA_Tooltip_ability_holdout_coup_de_grace_crit_radius"	"RAGGIO DELLO SQUARCIO:"
"[english]DOTA_Tooltip_ability_holdout_coup_de_grace_crit_radius"	"CLEAVE RADIUS:"
"DOTA_Tooltip_ability_axe_battle_rage"	"Brama di guerra"
"[english]DOTA_Tooltip_ability_axe_battle_rage"	"Battle Rage"
"DOTA_Tooltip_ability_holdout_windrun"	"Soffio di vento"
"[english]DOTA_Tooltip_ability_holdout_windrun"	"Windrun"
"DOTA_Tooltip_ability_holdout_focusfire"	"Brezza"
"[english]DOTA_Tooltip_ability_holdout_focusfire"	"Zephyr"
"DOTA_Tooltip_ability_dark_seer_wall_of_discord_damage"	"DANNO:"
"[english]DOTA_Tooltip_ability_dark_seer_wall_of_discord_damage"	"DAMAGE:"
"DOTA_Tooltip_ability_dark_seer_wall_of_discord_duration"	"DURATA:"
"[english]DOTA_Tooltip_ability_dark_seer_wall_of_discord_duration"	"DURATION:"
"DOTA_Tooltip_ability_magnataur_skewer_holdout"	"Infilzamento"
"[english]DOTA_Tooltip_ability_magnataur_skewer_holdout"	"Skewer"
"DOTA_Tooltip_ability_magnataur_skewer_holdout_range"	"DISTANZA:"
"[english]DOTA_Tooltip_ability_magnataur_skewer_holdout_range"	"DISTANCE:"
"DOTA_Tooltip_ability_magnataur_skewer_holdout_skewer_speed"	"VELOCITÀ:"
"[english]DOTA_Tooltip_ability_magnataur_skewer_holdout_skewer_speed"	"SPEED:"
"DOTA_Tooltip_ability_magnataur_skewer_holdout_skewer_damage"	"DANNO:"
"[english]DOTA_Tooltip_ability_magnataur_skewer_holdout_skewer_damage"	"DAMAGE:"
"DOTA_Tooltip_ability_mirana_moonfall"	"Tempesta lunare"
"[english]DOTA_Tooltip_ability_mirana_moonfall"	"Moonfall"
"DOTA_Tooltip_ability_mirana_moonfall_radius"	"RAGGIO:"
"[english]DOTA_Tooltip_ability_mirana_moonfall_radius"	"RADIUS:"
"DOTA_Tooltip_ability_holdout_mirana_arrow_arrow_range"	"GITTATA:"
"[english]DOTA_Tooltip_ability_holdout_mirana_arrow_arrow_range"	"RANGE:"
"DOTA_Tooltip_ability_holdout_purification_radius"	"RAGGIO:"
"[english]DOTA_Tooltip_ability_holdout_purification_radius"	"RADIUS:"
"DOTA_Tooltip_ability_holdout_guardian_angel_Note1"	"Può essere purgato."
"[english]DOTA_Tooltip_ability_holdout_guardian_angel_Note1"	"Can be purged."
"DOTA_Tooltip_ability_holdout_guardian_angel_duration"	"DURATA:"
"[english]DOTA_Tooltip_ability_holdout_guardian_angel_duration"	"DURATION:"
"DOTA_Tooltip_ability_holdout_guardian_angel_radius"	"RAGGIO:"
"[english]DOTA_Tooltip_ability_holdout_guardian_angel_radius"	"RADIUS:"
"DOTA_Tooltip_ability_holdout_axe_berserkers_call_bonus_armor"	"ARMATURA AGGIUNTIVA:"
"[english]DOTA_Tooltip_ability_holdout_axe_berserkers_call_bonus_armor"	"BONUS ARMOR:"
"DOTA_Tooltip_ability_holdout_axe_counter_helix_radius"	"RAGGIO:"
"[english]DOTA_Tooltip_ability_holdout_axe_counter_helix_radius"	"RADIUS:"
"DOTA_Tooltip_ability_holdout_voodoo"	"Vudù"
"[english]DOTA_Tooltip_ability_holdout_voodoo"	"Voodoo"
"DOTA_Tooltip_ability_holdout_voodoo_duration"	"DURATA:"
"[english]DOTA_Tooltip_ability_holdout_voodoo_duration"	"DURATION:"
"DOTA_Tooltip_ability_holdout_shackles"	"Catene"
"[english]DOTA_Tooltip_ability_holdout_shackles"	"Shackles"
"DOTA_Tooltip_ability_holdout_shadowraze1_shadowraze_range"	"GITTATA:"
"[english]DOTA_Tooltip_ability_holdout_shadowraze1_shadowraze_range"	"RANGE:"
"DOTA_Tooltip_ability_holdout_shadowraze2_shadowraze_range"	"GITTATA:"
"[english]DOTA_Tooltip_ability_holdout_shadowraze2_shadowraze_range"	"RANGE:"
"DOTA_Tooltip_ability_holdout_shadowraze3_shadowraze_range"	"GITTATA:"
"[english]DOTA_Tooltip_ability_holdout_shadowraze3_shadowraze_range"	"RANGE:"
"DOTA_Tooltip_ability_holdout_spell_steal_duration"	"DURATA:"
"[english]DOTA_Tooltip_ability_holdout_spell_steal_duration"	"DURATION:"
"DOTA_Tooltip_ability_holdout_gush"	"Getto d'acqua"
"[english]DOTA_Tooltip_ability_holdout_gush"	"Gush"
"DOTA_Tooltip_ability_holdout_gush_duration"	"DURATA:"
"[english]DOTA_Tooltip_ability_holdout_gush_duration"	"DURATION:"
"DOTA_Tooltip_ability_holdout_culling_blade_damage"	"DANNO:"
"[english]DOTA_Tooltip_ability_holdout_culling_blade_damage"	"DAMAGE:"
"DOTA_Tooltip_ability_holdout_multishot_arrow_range"	"GITTATA:"
"[english]DOTA_Tooltip_ability_holdout_multishot_arrow_range"	"RANGE:"
"DOTA_Tooltip_ability_holdout_blade_fury_blade_fury_radius"	"RAGGIO:"
"[english]DOTA_Tooltip_ability_holdout_blade_fury_blade_fury_radius"	"RADIUS:"
"DOTA_Tooltip_ability_holdout_blade_fury_damage"	"DANNO:"
"[english]DOTA_Tooltip_ability_holdout_blade_fury_damage"	"DAMAGE:"
"DOTA_Tooltip_ability_holdout_blade_fury_duration"	"DURATA:"
"[english]DOTA_Tooltip_ability_holdout_blade_fury_duration"	"DURATION:"
"DOTA_Tooltip_ability_holdout_omnislash_image_radius"	"RAGGIO:"
"[english]DOTA_Tooltip_ability_holdout_omnislash_image_radius"	"RADIUS:"
"DOTA_Tooltip_ability_holdout_omnislash_range"	"GITTATA:"
"[english]DOTA_Tooltip_ability_holdout_omnislash_range"	"RANGE:"
"DOTA_Tooltip_ability_holdout_storm_bolt_bolt_stun_duration"	"DURATA:"
"[english]DOTA_Tooltip_ability_holdout_storm_bolt_bolt_stun_duration"	"DURATION:"
"DOTA_Tooltip_ability_holdout_storm_bolt_bolt_aoe"	"RAGGIO:"
"[english]DOTA_Tooltip_ability_holdout_storm_bolt_bolt_aoe"	"RADIUS:"
"DOTA_Tooltip_ability_holdout_great_cleave_great_cleave_radius"	"RAGGIO:"
"[english]DOTA_Tooltip_ability_holdout_great_cleave_great_cleave_radius"	"RADIUS:"
"DOTA_Tooltip_ability_holdout_warcry"	"Grido di guerra"
"[english]DOTA_Tooltip_ability_holdout_warcry"	"Warcry"
"DOTA_Tooltip_ability_holdout_warcry_warcry_radius"	"RAGGIO:"
"[english]DOTA_Tooltip_ability_holdout_warcry_warcry_radius"	"RADIUS:"
"DOTA_Tooltip_ability_holdout_warcry_warcry_armor"	"ARMATURA AGGIUNTIVA:"
"[english]DOTA_Tooltip_ability_holdout_warcry_warcry_armor"	"BONUS ARMOR:"
"DOTA_Tooltip_ability_holdout_gods_strength"	"Forza divina"
"[english]DOTA_Tooltip_ability_holdout_gods_strength"	"God's Strength"
"DOTA_Tooltip_ability_holdout_scourge_venomous_gale_duration"	"DURATA:"
"[english]DOTA_Tooltip_ability_holdout_scourge_venomous_gale_duration"	"DURATION:"
"DOTA_Tooltip_ability_holdout_scourge_ward_duration"	"DURATA:"
"[english]DOTA_Tooltip_ability_holdout_scourge_ward_duration"	"DURATION:"
"DOTA_Tooltip_ability_holdout_poison_nova_radius"	"RAGGIO:"
"[english]DOTA_Tooltip_ability_holdout_poison_nova_radius"	"RADIUS:"
"DOTA_Tooltip_ability_holdout_poison_nova_duration"	"DURATA:"
"[english]DOTA_Tooltip_ability_holdout_poison_nova_duration"	"DURATION:"
"DOTA_Tooltip_ability_holdout_poison_nova_damage"	"DANNO:"
"[english]DOTA_Tooltip_ability_holdout_poison_nova_damage"	"DAMAGE:"
"DOTA_Tooltip_ability_holdout_shockwave_shock_damage"	"DANNO:"
"[english]DOTA_Tooltip_ability_holdout_shockwave_shock_damage"	"DAMAGE:"
"DOTA_Tooltip_ability_holdout_shockwave_shock_distance"	"DISTANZA:"
"[english]DOTA_Tooltip_ability_holdout_shockwave_shock_distance"	"DISTANCE:"
"DOTA_Tooltip_ability_holdout_friendly_skewer_range"	"DISTANZA:"
"[english]DOTA_Tooltip_ability_holdout_friendly_skewer_range"	"DISTANCE:"
"DOTA_Tooltip_ability_holdout_friendly_skewer_skewer_speed"	"VELOCITÀ:"
"[english]DOTA_Tooltip_ability_holdout_friendly_skewer_skewer_speed"	"SPEED:"
"DOTA_Tooltip_ability_holdout_gladiators_unite_duration"	"DURATA:"
"[english]DOTA_Tooltip_ability_holdout_gladiators_unite_duration"	"DURATION:"
"DOTA_Tooltip_ability_holdout_gladiators_unite_radius"	"RAGGIO:"
"[english]DOTA_Tooltip_ability_holdout_gladiators_unite_radius"	"RADIUS:"
"DOTA_Tooltip_ability_holdout_light_strike_array_light_strike_array_aoe"	"RAGGIO:"
"[english]DOTA_Tooltip_ability_holdout_light_strike_array_light_strike_array_aoe"	"RADIUS:"
"DOTA_Tooltip_modifier_holdout_arcane_aura_aura_effect"	"Aura arcana"
"[english]DOTA_Tooltip_modifier_holdout_arcane_aura_aura_effect"	"Arcane Aura"
"DOTA_Tooltip_ability_holdout_caustic_finale"	"Finale caustico"
"[english]DOTA_Tooltip_ability_holdout_caustic_finale"	"Caustic Finale"
"DOTA_Tooltip_ability_holdout_caustic_finale_caustic_finale_radius"	"RAGGIO:"
"[english]DOTA_Tooltip_ability_holdout_caustic_finale_caustic_finale_radius"	"RADIUS:"
"DOTA_Tooltip_ability_holdout_Caustic_finale_caustic_finale_duration"	"DURATA:"
"[english]DOTA_Tooltip_ability_holdout_Caustic_finale_caustic_finale_duration"	"DURATION:"
"DOTA_Tooltip_ability_holdout_static_remnant_static_remnant_damage_radius"	"RAGGIO:"
"[english]DOTA_Tooltip_ability_holdout_static_remnant_static_remnant_damage_radius"	"RADIUS:"
"DOTA_Tooltip_ability_holdout_static_remnant_static_remnant_damage"	"DANNO:"
"[english]DOTA_Tooltip_ability_holdout_static_remnant_static_remnant_damage"	"DAMAGE:"
"DOTA_Tooltip_ability_holdout_overload"	"Sovraccarico"
"[english]DOTA_Tooltip_ability_holdout_overload"	"Overload"
"DOTA_Tooltip_ability_holdout_overload_aoe"	"RAGGIO:"
"[english]DOTA_Tooltip_ability_holdout_overload_aoe"	"RADIUS:"
"DOTA_Tooltip_ability_holdout_electric_vortex_duration"	"DURATA:"
"[english]DOTA_Tooltip_ability_holdout_electric_vortex_duration"	"DURATION:"
"DOTA_Tooltip_ability_holdout_electric_vortex_self_slow"	"RALLENTAMENTO:"
"[english]DOTA_Tooltip_ability_holdout_electric_vortex_self_slow"	"SLOW:"
"DOTA_Tooltip_ability_holdout_ball_lightning_ball_lightning_move_speed"	"VELOCITÀ:"
"[english]DOTA_Tooltip_ability_holdout_ball_lightning_ball_lightning_move_speed"	"SPEED:"
"DOTA_Tooltip_ability_holdout_ball_lightning_ball_lightning_aoe"	"RAGGIO:"
"[english]DOTA_Tooltip_ability_holdout_ball_lightning_ball_lightning_aoe"	"RADIUS:"
"DOTA_Tooltip_ability_holdout_queenofpain_shadow_strike_distance"	"DISTANZA:"
"[english]DOTA_Tooltip_ability_holdout_queenofpain_shadow_strike_distance"	"DISTANCE:"
"DOTA_Tooltip_ability_holdout_queenofpain_shadow_strike_radius"	"RAGGIO:"
"[english]DOTA_Tooltip_ability_holdout_queenofpain_shadow_strike_radius"	"RADIUS:"
"DOTA_Tooltip_ability_holdout_qop_blink"	"Baleno"
"[english]DOTA_Tooltip_ability_holdout_qop_blink"	"Blink"
"DOTA_Tooltip_ability_holdout_scream_of_pain_area_of_effect"	"RAGGIO:"
"[english]DOTA_Tooltip_ability_holdout_scream_of_pain_area_of_effect"	"RADIUS:"
"DOTA_Tooltip_ability_holdout_sonic_wave_final_aoe"	"RAGGIO:"
"[english]DOTA_Tooltip_ability_holdout_sonic_wave_final_aoe"	"RADIUS:"
"DOTA_Tooltip_ability_holdout_sonic_wave_damage"	"DANNO:"
"[english]DOTA_Tooltip_ability_holdout_sonic_wave_damage"	"DAMAGE:"
"DOTA_Tooltip_ability_templar_assassin_refraction_holdout_duration"	"DURATA:"
"[english]DOTA_Tooltip_ability_templar_assassin_refraction_holdout_duration"	"DURATION:"
"DOTA_Tooltip_ability_holdout_paralyzing_cask_bounces_tooltip"	"RIMBALZI:"
"[english]DOTA_Tooltip_ability_holdout_paralyzing_cask_bounces_tooltip"	"BOUNCES:"
"DOTA_Tooltip_ability_holdout_voodoo_restoration_heal"	"CURA:"
"[english]DOTA_Tooltip_ability_holdout_voodoo_restoration_heal"	"HEAL:"
"DOTA_Tooltip_ability_holdout_voodoo_restoration_radius"	"RAGGIO:"
"[english]DOTA_Tooltip_ability_holdout_voodoo_restoration_radius"	"RADIUS:"
"DOTA_Tooltip_ability_holdout_death_ward_damage"	"DANNO:"
"[english]DOTA_Tooltip_ability_holdout_death_ward_damage"	"DAMAGE:"
"DOTA_Tooltip_ability_tusk_walrus_wallop_nb2017_knockback_duration"	"DURATA:"
"[english]DOTA_Tooltip_ability_tusk_walrus_wallop_nb2017_knockback_duration"	"DURATION:"
"DOTA_Tooltip_ability_disruptor_glimpse_nb2017"	"Allucinazione"
"[english]DOTA_Tooltip_ability_disruptor_glimpse_nb2017"	"Glimpse"
"DOTA_Tooltip_ability_disruptor_glimpse_nb2017_radius"	"RAGGIO:"
"[english]DOTA_Tooltip_ability_disruptor_glimpse_nb2017_radius"	"RADIUS:"
"DOTA_Tooltip_ability_phantom_assassin_phantom_strike_nb2017_duration"	"DURATA:"
"[english]DOTA_Tooltip_ability_phantom_assassin_phantom_strike_nb2017_duration"	"DURATION:"
"DOTA_Tooltip_ability_ember_spirit_flame_guard_nb2017_duration"	"DURATA:"
"[english]DOTA_Tooltip_ability_ember_spirit_flame_guard_nb2017_duration"	"DURATION:"
"DOTA_Tooltip_ability_ember_spirit_flame_guard_nb2017_radius"	"RAGGIO:"
"[english]DOTA_Tooltip_ability_ember_spirit_flame_guard_nb2017_radius"	"RADIUS:"
"DOTA_Tooltip_ability_medusa_mystic_snake_dm2017_snake_jumps"	"BALZI:"
"[english]DOTA_Tooltip_ability_medusa_mystic_snake_dm2017_snake_jumps"	"JUMPS:"
"DOTA_Tooltip_ability_medusa_mystic_snake_dm2017_snake_damage"	"DANNO:"
"[english]DOTA_Tooltip_ability_medusa_mystic_snake_dm2017_snake_damage"	"DAMAGE:"
"DOTA_Tooltip_ability_treant_leech_seed_nb2017_radius"	"RAGGIO:"
"[english]DOTA_Tooltip_ability_treant_leech_seed_nb2017_radius"	"RADIUS:"
"DOTA_Tooltip_ability_treant_leech_seed_nb2017_duration"	"DURATA:"
"[english]DOTA_Tooltip_ability_treant_leech_seed_nb2017_duration"	"DURATION:"
"DOTA_Tooltip_ability_treant_great_protector_Lore"	"	"
"[english]DOTA_Tooltip_ability_treant_great_protector_Lore"	""
"DOTA_Tooltip_ability_treant_great_protector_duration"	"DURATA:"
"[english]DOTA_Tooltip_ability_treant_great_protector_duration"	"DURATION:"
"DOTA_Tooltip_ability_phoenix_fire_spirits_nb2017_radius"	"RAGGIO:"
"[english]DOTA_Tooltip_ability_phoenix_fire_spirits_nb2017_radius"	"RADIUS:"
"DOTA_Tooltip_ability_phoenix_launch_fire_spirit_nb2017_radius"	"RAGGIO:"
"[english]DOTA_Tooltip_ability_phoenix_launch_fire_spirit_nb2017_radius"	"RADIUS:"
"DOTA_Tooltip_ability_sniper_assassinate_dm2017_assassinate_damage"	"DANNO:"
"[english]DOTA_Tooltip_ability_sniper_assassinate_dm2017_assassinate_damage"	"DAMAGE:"
"DOTA_Tooltip_ability_sniper_assassinate_dm2017_tooltip_range"	"GITTATA:"
"[english]DOTA_Tooltip_ability_sniper_assassinate_dm2017_tooltip_range"	"RANGE:"
"DOTA_Tooltip_ability_tiny_trample"	"Pestone"
"[english]DOTA_Tooltip_ability_tiny_trample"	"Trample"
"DOTA_Tooltip_modifier_tiny_trample"	"Pestone"
"[english]DOTA_Tooltip_modifier_tiny_trample"	"Trample"
"DOTA_Tooltip_ability_zuus_static_field_dark_moon_radius"	"GITTATA:"
"[english]DOTA_Tooltip_ability_zuus_static_field_dark_moon_radius"	"RANGE:"
"DOTA_Tooltip_ability_techies_suicide_radius"	"RAGGIO:"
"[english]DOTA_Tooltip_ability_techies_suicide_radius"	"RADIUS:"
}
}
