"lang"
{
"Language"	"finnish"
"Tokens"
{
"DOTA_BroadcasterToasts_HeroAbilityMovie_Title"	"<hc>{s:hero_name}:</hc> <ac>{s:ability_name}</ac>"
"[english]DOTA_BroadcasterToasts_HeroAbilityMovie_Title"	"<hc>{s:hero_name}:</hc> <ac>{s:ability_name}</ac>"
"DOTA_BroadcasterToasts_ItemMovie_Title"	"<ic>{s:item_name}</ic>"
"[english]DOTA_BroadcasterToasts_ItemMovie_Title"	"<ic>{s:item_name}</ic>"
"DOTA_BroadcastFact_Stat_hero_player_pick_count"	"{s:player_name} on valinnut sankarin <hc>{s:hero_name}</hc> <nc>{d:count}</nc> pelissä."
"[english]DOTA_BroadcastFact_Stat_hero_player_pick_count"	"<pc>{s:player_name}</pc> has picked <hc>{s:hero_name}</hc> in <nc>{d:count}</nc> game(s)."
"DOTA_BroadcastFact_Stat_item_pick_count"	"<ic>{s:item_name}</ic> on ostettu <nc>{d:count}</nc> pelissä"
"[english]DOTA_BroadcastFact_Stat_item_pick_count"	"<ic>{s:item_name}</ic> has been purchased in <nc>{d:count}</nc> game(s)"
"DOTA_BroadcastFact_Stat_hero_pick_count"	"<hc>{s:hero_name}</hc> on valittu <nc>{d:count}</nc> pelissä."
"[english]DOTA_BroadcastFact_Stat_hero_pick_count"	"<hc>{s:hero_name}</hc> has been picked in <nc>{d:count}</nc> game(s)."
"DOTA_BroadcastFact_Stat_hero_win_count"	"Sankarilla {s:hero_name} on voitettu {d:count} peliä."
"[english]DOTA_BroadcastFact_Stat_hero_win_count"	"<hc>{s:hero_name}</hc> has won <nc>{d:count}</nc> game(s)."
"DOTA_BroadcastFact_Stat_league_item_hero_pick_count"	"<ic>{s:item_name}</ic> on ostettu sankarille <hc>{s:hero_name}</hc> <nc>{d:count}</nc> pelissä (<ec>{s:event_name}</ec>)."
"[english]DOTA_BroadcastFact_Stat_league_item_hero_pick_count"	"<hc>{s:hero_name}</hc> players have purchased <ic>{s:item_name}</ic> in <nc>{d:count}</nc> game(s) at <ec>{s:event_name}</ec>."
"DOTA_BroadcastFact_Stat_league_item_player_win_count"	"<pc>{s:player_name}</pc> on voittanut <nc>{d:count}</nc> peliä, joissa osti esineen <ic>{s:item_name}</ic> (<ec>{s:event_name}</ec>)."
"[english]DOTA_BroadcastFact_Stat_league_item_player_win_count"	"<pc>{s:player_name}</pc> has won <nc>{d:count}</nc> game(s) at <ec>{s:event_name}</ec> with <ic>{s:item_name}</ic> purchased."
"DOTA_BroadcastFact_Stat_league_item_player_pick_count"	"<pc>{s:player_name}</pc> on ostanut esineen <ic>{s:item_name}</ic> <nc>{d:count}</nc> pelissä (<ec>{s:event_name}</ec>)."
"[english]DOTA_BroadcastFact_Stat_league_item_player_pick_count"	"<pc>{s:player_name}</pc> has purchased <ic>{s:item_name}</ic> in <nc>{d:count}</nc> game(s) at <ec>{s:event_name}</ec>."
"DOTA_BroadcastFact_Stat_league_hero_player_win_count"	"<pc>{s:player_name}</pc> on voittanut <nc>{d:count}</nc> peliä sankarilla <hc>{s:hero_name}</hc> (<ec>{s:event_name}</ec>)."
"[english]DOTA_BroadcastFact_Stat_league_hero_player_win_count"	"<pc>{s:player_name}</pc> has won <nc>{d:count}</nc> game(s) at <ec>{s:event_name}</ec> with <hc>{s:hero_name}</hc>."
"DOTA_BroadcastFact_Stat_league_hero_player_pick_count"	"<pc>{s:player_name}</pc> on pelannut sankarilla <hc>{s:hero_name}</hc> <nc>{d:count}</nc> pelissä (<ec>{s:event_name}</ec>)."
"[english]DOTA_BroadcastFact_Stat_league_hero_player_pick_count"	"<pc>{s:player_name}</pc> has picked <hc>{s:hero_name}</hc> in <nc>{d:count}</nc> game(s) at <ec>{s:event_name}</ec>."
"DOTA_BroadcastFact_Stat_league_item_pick_count"	"<ic>{s:item_name}</ic> on ostettu <nc>{d:count}</nc> pelissä (<ec>{s:event_name}</ec>)."
"[english]DOTA_BroadcastFact_Stat_league_item_pick_count"	"<ic>{s:item_name}</ic> has been picked in <nc>{d:count}</nc> game(s) at <ec>{s:event_name}</ec>."
"DOTA_BroadcastFact_Stat_league_hero_pick_count"	"<hc>{s:hero_name}</hc> on valittu <nc>{d:count}</nc> kertaa (<ec>{s:event_name}</ec>)."
"[english]DOTA_BroadcastFact_Stat_league_hero_pick_count"	"<hc>{s:hero_name}</hc> has been picked <nc>{d:count}</nc> time(s) at <ec>{s:event_name}</ec>."
"DOTA_BroadcastFact_Stat_league_hero_win_count"	"Sankarilla <hc>{s:hero_name}</hc> on voitettu <nc>{d:count}</nc> peliä (<ec>{s:event_name}</ec>)."
"[english]DOTA_BroadcastFact_Stat_league_hero_win_count"	"<hc>{s:hero_name}</hc> has won <nc>{d:count}</nc> game(s) at <ec>{s:event_name}</ec>."
"DOTA_BroadcastFact_ItemMovie_item_bloodthorn"	"Hiljentää vihollisen ja nostaa kriittisen osuman todennäköisyyttä."
"[english]DOTA_BroadcastFact_ItemMovie_item_bloodthorn"	"Silences enemies and increases the chance of critical strikes."
"DOTA_BroadcastFact_ItemMovie_item_bottle_haste"	"Voi säilyttää riimuja myöhempää käyttöä varten. Riimut myös palauttavat pullon latauksia."
"[english]DOTA_BroadcastFact_ItemMovie_item_bottle_haste"	"Has ability to store runes for later use, replenishing a player's bottle charges."
"DOTA_BroadcastFact_ItemMovie_item_crimson_guard"	"Estää osan kantajaan ja lähellä oleviin liittolaisiin tehdystä hyökkäysvahingosta."
"[english]DOTA_BroadcastFact_ItemMovie_item_crimson_guard"	"Blocks a portion of physical damage for the player and any allies in the area."
"DOTA_BroadcastFact_ItemMovie_item_dust"	"Paljastaa näkymättömät viholliset hetkellisesti."
"[english]DOTA_BroadcastFact_ItemMovie_item_dust"	"Reveals invisible units for a short duration."
"DOTA_BroadcastFact_ItemMovie_item_gem"	"Paljastaa ympärillä olevat näkymättömät viholliset."
"[english]DOTA_BroadcastFact_ItemMovie_item_gem"	"Gives vision of nearby invisible units."
"DOTA_BroadcastFact_ItemMovie_item_mjollnir"	"Lisää Maelstromille aktiivisen salamasuojan."
"[english]DOTA_BroadcastFact_ItemMovie_item_mjollnir"	"Adds an active lightning shield ability to Maelstrom."
"DOTA_BroadcastFact_ItemMovie_item_maelstrom"	"Nostaa vahinkoa ja hyökkäysnopeutta sekä antaa passiivisen salamahyökkäyksen."
"[english]DOTA_BroadcastFact_ItemMovie_item_maelstrom"	"Increases damage and attack speed, and provides passive Chain Lightning."
"DOTA_BroadcastFact_ItemMovie_item_pipe"	"Suojaa lähellä olevia liittolaisia 400 loitsuvahingolta."
"[english]DOTA_BroadcastFact_ItemMovie_item_pipe"	"Shields allies in an area from a fixed amount of damage."
"DOTA_BroadcastFact_ItemMovie_item_radiance"	"Tekee vahinkoa ympäröiviin vihollisiin ja saa heidät lyömään osan hyökkäyksistään ohi."
"[english]DOTA_BroadcastFact_ItemMovie_item_radiance"	"Damages and causes nearby enemies to miss attacks."
"DOTA_BroadcastFact_ItemMovie_item_satanic"	"Varastaa paljon terveyttä joka hyökkäyksellä."
"[english]DOTA_BroadcastFact_ItemMovie_item_satanic"	"Provides massive lifesteal with each attack."
"DOTA_BroadcastFact_ItemMovie_item_ward_sentry"	"Paljastaa näkymättömät viholliset ympäriltään."
"[english]DOTA_BroadcastFact_ItemMovie_item_ward_sentry"	"Gives vision of nearby invisible units."
"DOTA_BroadcastFact_ItemMovie_item_invis_sword"	"Antaa käyttäjälleen näkymättömyyden ja lisää liikenopeutta."
"[english]DOTA_BroadcastFact_ItemMovie_item_invis_sword"	"Grants invisibility and increased movement speed."
"DOTA_BroadcastFact_ItemMovie_item_silver_edge"	"Hyödyllinen vahvojen passiivisten kykyjen poistamiseen."
"[english]DOTA_BroadcastFact_ItemMovie_item_silver_edge"	"Useful for attacking heroes with strong passive abilities."
"DOTA_BroadcastFact_ItemMovie_item_shivas_guard"	"Luo vihollisia hidastavan aluepurkauksen käyttäjän ympärille."
"[english]DOTA_BroadcastFact_ItemMovie_item_shivas_guard"	"Releases an AoE wave to slow down enemies."
"DOTA_BroadcastFact_ItemMovie_item_tpscroll"	"Teleporttaa käyttäjän nopeasti liittolaisrakennuksen luokse."
"[english]DOTA_BroadcastFact_ItemMovie_item_tpscroll"	"Allows heroes to quickly teleport to allied structures."
"DOTA_BroadcastFact_ItemMovie_item_smoke_of_deceit"	"Piilottaa lähellä olevat liittolaiset ja antaa lisää liikenopeutta."
"[english]DOTA_BroadcastFact_ItemMovie_item_smoke_of_deceit"	"Hides all nearby allies and grants them increased movement speed."
"DOTA_BroadcastFact_ItemMovie_item_sheepstick"	"Noituu valitun vihollisen avuttomaksi elukaksi."
"[english]DOTA_BroadcastFact_ItemMovie_item_sheepstick"	"Hexes enemies, turning them into helpless creatures."
"DOTA_BroadcastFact_ItemMovie_item_sphere"	"Käyttövalmiudessa estää yhden kohdistetun viholliskyvyn."
"[english]DOTA_BroadcastFact_ItemMovie_item_sphere"	"Can block a single targeted ability when off cooldown."
"DOTA_BroadcastFact_ItemMovie_item_hurricane_pike"	"Työntää valitun vihollisen pois. Viholliseen voi hyökätä neljä kertaa miltä etäisyydeltä tahansa."
"[english]DOTA_BroadcastFact_ItemMovie_item_hurricane_pike"	"Can push an enemy away, allowing four ranged attacks."
"DOTA_BroadcastFact_ItemMovie_item_glimmer_cape"	"Antaa näkymättömyyden valitulle liittolaiselle. Voi käyttää kanavoitujen loitsujen aikana."
"[english]DOTA_BroadcastFact_ItemMovie_item_glimmer_cape"	"Grants invisibility and can be cast while channeling spells."
"DOTA_BroadcastFact_ItemMovie_item_force_staff"	"Työntää valittua vihollista tai liittolaista hänen katselusuuntaansa."
"[english]DOTA_BroadcastFact_ItemMovie_item_force_staff"	"Allows its wielder to push enemies or allies in their direction of travel."
"DOTA_BroadcastFact_ItemMovie_item_cyclone"	"Heittää valitun vihollisen ilmaan ja keskeyttää hänen toimintansa."
"[english]DOTA_BroadcastFact_ItemMovie_item_cyclone"	"Can be used to disable an enemy and interrupt their abilities."
"DOTA_BroadcastFact_ItemMovie_item_dagon"	"Laukaisee voimakkaan vahinkoloitsun valittuun viholliseen."
"[english]DOTA_BroadcastFact_ItemMovie_item_dagon"	"Emits a powerful burst of magical damage."
"DOTA_BroadcastFact_ItemMovie_item_travel_boots"	"Teleporttaa käyttäjän nopeasti liittolaiskätyrin tai -rakennuksen luokse."
"[english]DOTA_BroadcastFact_ItemMovie_item_travel_boots"	"Allows a hero to teleport to any allied non-hero unit."
"DOTA_BroadcastFact_ItemMovie_item_blink"	"Siirtää käyttäjän salamannopeasti lyhyen matkan päähän."
"[english]DOTA_BroadcastFact_ItemMovie_item_blink"	"Allows a hero to jump a short distance."
"DOTA_BroadcastFact_ItemMovie_item_black_king_bar"	"Antaa käyttäjälleen loitsuimmuniteetin hetkeksi."
"[english]DOTA_BroadcastFact_ItemMovie_item_black_king_bar"	"Provides spell immunity for a short duration."
"DOTA_BroadcastFact_ItemMovie_item_abyssal_blade"	"Antaa sekä passiivisen että aktiivisen tainnutuskyvyn."
"[english]DOTA_BroadcastFact_ItemMovie_item_abyssal_blade"	"Grants a passive chance to stun on attacks and an active disable."
"DOTA_BroadcastFact_AbilityMovie_invoker_sun_strike"	"Tekee vahinkoa mihin tahansa sijaintiin."
"[english]DOTA_BroadcastFact_AbilityMovie_invoker_sun_strike"	"Summoned anywhere in the map to deal damage."
"DOTA_BroadcastFact_AbilityMovie_invoker_tornado"	"Heittää viholliset ilmaan ja tekee heihin vahinkoa."
"[english]DOTA_BroadcastFact_AbilityMovie_invoker_tornado"	"Throws enemies into the air, dealing damage."
"DOTA_BroadcastFact_AbilityMovie_abaddon_mist_coil"	"Vahingoittaa vihollisia tai parantaa liittolaisia, mutta vahingoittaa Abaddonia."
"[english]DOTA_BroadcastFact_AbilityMovie_abaddon_mist_coil"	"Damages foes or heals allies at the cost of health."
"DOTA_BroadcastFact_AbilityMovie_abaddon_aphotic_shield"	"Suojaa liittolaista. Vahingoittaa vihollisia suojan loppuessa."
"[english]DOTA_BroadcastFact_AbilityMovie_abaddon_aphotic_shield"	"Shields an ally. Damages enemies upon bursting."
"DOTA_BroadcastFact_AbilityMovie_abaddon_curse_of_avernus"	"Hyökkäykset langettavat vihollisiin kirouksen, joka antaa liittolaisille liike- ja hyökkäysnopeutta."
"[english]DOTA_BroadcastFact_AbilityMovie_abaddon_curse_of_avernus"	"A curse that boosts allied movement and attack speed."
"DOTA_BroadcastFact_AbilityMovie_abaddon_borrowed_time"	"Kaikki käyttäjään tehtävä vahinko muuttuu parannukseksi. Aktivoituu automaattisesti lähellä kuolemaa."
"[english]DOTA_BroadcastFact_AbilityMovie_abaddon_borrowed_time"	"When activated, all damage taken heals instead of harms."
"DOTA_BroadcastFact_AbilityMovie_alchemist_acid_spray"	"Kaataa maahan happoa, joka tekee vahinkoa ja vähentää vihollisten panssaria."
"[english]DOTA_BroadcastFact_AbilityMovie_alchemist_acid_spray"	"Sprays acid, causing damage and armor reduction."
"DOTA_BroadcastFact_AbilityMovie_alchemist_unstable_concoction"	"Sekoittaa tuhdin rohdon, joka tainnuttaa vihollisen heitettäessä. Voi myös tainnuttaa käyttäjänsä."
"[english]DOTA_BroadcastFact_AbilityMovie_alchemist_unstable_concoction"	"Brews a potion to throw and stun. Can self-stun."
"DOTA_BroadcastFact_AbilityMovie_alchemist_greevil's_greed"	"Antaa lisäkultaa kätyritapoista ja palkkioriimuista."
"[english]DOTA_BroadcastFact_AbilityMovie_alchemist_greevil's_greed"	"Grants bonus gold to last hits and bounty runes."
"DOTA_BroadcastFact_AbilityMovie_alchemist_chemical_rage"	"Antaa liike- ja hyökkäysnopeutta sekä terveydenpalautumista."
"[english]DOTA_BroadcastFact_AbilityMovie_alchemist_chemical_rage"	"Grants attack and move speed, and health regen."
"DOTA_BroadcastFact_AbilityMovie_ancient_apparition_cold_feet"	"Tainnuttaa vihollisen, jos hän ei liiku tarpeeksi kauas."
"[english]DOTA_BroadcastFact_AbilityMovie_ancient_apparition_cold_feet"	"Freezes an enemy in place if they don't move."
"DOTA_BroadcastFact_AbilityMovie_ancient_apparition_ice_vortex"	"Hidastaa vihollisia ja nostaa heidän ottamaansa loitsuvahinkoa."
"[english]DOTA_BroadcastFact_AbilityMovie_ancient_apparition_ice_vortex"	"Slows enemies and increases magic damage."
"DOTA_BroadcastFact_AbilityMovie_ancient_apparition_chilling_touch"	"Antaa liittolaisille lisää hyökkäysvahinkoa."
"[english]DOTA_BroadcastFact_AbilityMovie_ancient_apparition_chilling_touch"	"Grants allies bonus attack damage."
"DOTA_BroadcastFact_AbilityMovie_ancient_apparition_ice_blast"	"Laukaisee minne tahansa jääloitsun, joka tekee vahinkoa ja estää parantumisen."
"[english]DOTA_BroadcastFact_AbilityMovie_ancient_apparition_ice_blast"	"Aims a blast across the map that damages and prevents healing. "
"DOTA_BroadcastFact_AbilityMovie_anti-mage_mana_break"	"Polttaa vihollisen manaa joka hyökkäyksellä."
"[english]DOTA_BroadcastFact_AbilityMovie_anti-mage_mana_break"	"Burns an enemy's mana with each attack."
"DOTA_BroadcastFact_AbilityMovie_anti-mage_blink"	"Siirtyy salamannopeasti lyhyen matkan päähän."
"[english]DOTA_BroadcastFact_AbilityMovie_anti-mage_blink"	"Teleports a short distance."
"DOTA_BroadcastFact_AbilityMovie_anti-mage_spell_shield"	"Nostaa loitsunvastustusta."
"[english]DOTA_BroadcastFact_AbilityMovie_anti-mage_spell_shield"	"Increases resistance to magic damage."
"DOTA_BroadcastFact_AbilityMovie_anti-mage_mana_void"	"Tekee valitun vihollisen ympärille vahinkoa kohteen puuttuvan manamäärän mukaan."
"[english]DOTA_BroadcastFact_AbilityMovie_anti-mage_mana_void"	"Deals damage in an area for each point of mana the target is missing."
"DOTA_BroadcastFact_AbilityMovie_arc_warden_flux"	"Hidastaa liikenopeutta ja tekee vahinkoa kohteeseen, jos kohteella ei ole liittolaisia ympärillään."
"[english]DOTA_BroadcastFact_AbilityMovie_arc_warden_flux"	"Slows movement speed and damages over time."
"DOTA_BroadcastFact_AbilityMovie_arc_warden_magnetic_field"	"Luo suojakentän, joka estää ulkopuolella olevia vihollisia osumasta sisälle."
"[english]DOTA_BroadcastFact_AbilityMovie_arc_warden_magnetic_field"	"Creates a field that shields from outside attackers."
"DOTA_BroadcastFact_AbilityMovie_arc_warden_spark_wraith"	"Luo vartiohaamun, joka hidastaa ja vahingoittaa ensimmäistä lähelle tulevaa vihollista."
"[english]DOTA_BroadcastFact_AbilityMovie_arc_warden_spark_wraith"	"Guards an area. Slows and damages an enemy that enters."
"DOTA_BroadcastFact_AbilityMovie_arc_warden_tempest_double"	"Luo kopion <hc>Arc Wardenista</hc>, joka voi käyttää samoja kykyjä ja esineitä."
"[english]DOTA_BroadcastFact_AbilityMovie_arc_warden_tempest_double"	"Creates a copy of <hc>Arc Warden</hc> with its own ability and item cooldowns."
"DOTA_BroadcastFact_AbilityMovie_axe_berserker's_call"	"Yllyttää lähellä olevia vihollisia hyökkäämään häneen."
"[english]DOTA_BroadcastFact_AbilityMovie_axe_berserker's_call"	"Taunts nearby enemies, forcing them to attack."
"DOTA_BroadcastFact_AbilityMovie_axe_battle_hunger"	"Tekee vahinkoa valittuun viholliseen, kunnes hän tappaa jotain."
"[english]DOTA_BroadcastFact_AbilityMovie_axe_battle_hunger"	"Damages an enemy until it kills another unit."
"DOTA_BroadcastFact_AbilityMovie_axe_counter_helix"	"Vastahyökkäys, joka vahingoittaa ympäröiviä vihollisia."
"[english]DOTA_BroadcastFact_AbilityMovie_axe_counter_helix"	"Spinning counter-attack that hurts nearby enemies."
"DOTA_BroadcastFact_AbilityMovie_axe_culling_blade"	"Tappaa välittömästi heikon vihollisen."
"[english]DOTA_BroadcastFact_AbilityMovie_axe_culling_blade"	"Instantly kills an enemy hero with low health."
"DOTA_BroadcastFact_AbilityMovie_bane_enfeeble"	"Heikentää valitun vihollisen hyökkäysvahinkoa."
"[english]DOTA_BroadcastFact_AbilityMovie_bane_enfeeble"	"Weakens an enemy's physical attacks."
"DOTA_BroadcastFact_AbilityMovie_bane_brain_sap"	"Tekee vahinkoa valittuun viholliseen ja parantaa <hc>Baneä</hc>."
"[english]DOTA_BroadcastFact_AbilityMovie_bane_brain_sap"	"Deals damage while healing <hc>Bane</hc>."
"DOTA_BroadcastFact_AbilityMovie_bane_nightmare"	"Nukuttaa vihollisen, joka herää hyökkäyksestä tai tehdystä vahingosta."
"[english]DOTA_BroadcastFact_AbilityMovie_bane_nightmare"	"Puts an enemy to sleep until it is attacked."
"DOTA_BroadcastFact_AbilityMovie_bane_fiend's_grip"	"Kanavoi valittuun viholliseen loitsun, joka tainnuttaa sen ja tekee paljon vahinkoa."
"[english]DOTA_BroadcastFact_AbilityMovie_bane_fiend's_grip"	"Grips an enemy, disabling it and causing heavy damage."
"DOTA_BroadcastFact_AbilityMovie_batrider_sticky_napalm"	"Tahmainen öljy hidastaa vihollisia ja nostaa loitsijan tekemää vahinkoa."
"[english]DOTA_BroadcastFact_AbilityMovie_batrider_sticky_napalm"	"Sticky oil slows enemies and boosts damage taken."
"DOTA_BroadcastFact_AbilityMovie_batrider_flamebreak"	"Räjähtävä polttopullo, joka työntää vihollisia."
"[english]DOTA_BroadcastFact_AbilityMovie_batrider_flamebreak"	"An explosive cocktail that knocks back enemies."
"DOTA_BroadcastFact_AbilityMovie_batrider_firefly"	"Antaa loitsijan lentää. Jättää palavan tulivanan jälkeensä."
"[english]DOTA_BroadcastFact_AbilityMovie_batrider_firefly"	"Grants flying movement. Lays a trail of flames."
"DOTA_BroadcastFact_AbilityMovie_batrider_flaming_lasso"	"Nappaa valitun vihollisen ja raahaa sitä Batriderin perässä."
"[english]DOTA_BroadcastFact_AbilityMovie_batrider_flaming_lasso"	"Grabs an enemy and drags them behind Batrider."
"DOTA_BroadcastFact_AbilityMovie_beastmaster_wild_axes"	"Heittää kirveet, jotka kaatavat puita ja vahingoittavat vihollisia."
"[english]DOTA_BroadcastFact_AbilityMovie_beastmaster_wild_axes"	"Throws axes in an arc, cutting trees and enemies."
"DOTA_BroadcastFact_AbilityMovie_beastmaster_call_of_the_wild"	"Kutsuu haukan tai villisian."
"[english]DOTA_BroadcastFact_AbilityMovie_beastmaster_call_of_the_wild"	"Summons a flying hawk or beast."
"DOTA_BroadcastFact_AbilityMovie_beastmaster_inner_beast"	"Nostaa ympäröivien liittolaisten hyökkäysnopeutta."
"[english]DOTA_BroadcastFact_AbilityMovie_beastmaster_inner_beast"	"Increases the attack speed of nearby allies."
"DOTA_BroadcastFact_AbilityMovie_beastmaster_primal_roar"	"Vahingoittaa ja tainnuttaa valitun vihollisen. Läpäisee loitsuimmuniteetin."
"[english]DOTA_BroadcastFact_AbilityMovie_beastmaster_primal_roar"	"Damages and stuns enemies in a cone. Pierces BKB."
"DOTA_BroadcastFact_AbilityMovie_bloodseeker_bloodrage"	"Nostaa kohteen tekemää ja ottamaa vahinkoa. Jokainen tappo parantaa kohdetta tai kohteen tappajaa."
"[english]DOTA_BroadcastFact_AbilityMovie_bloodseeker_bloodrage"	"Increases damage dealt and taken. Heals on kill."
"DOTA_BroadcastFact_AbilityMovie_bloodseeker_blood_rite"	"Verinen rituaaliympyrä, joka vahingoittaa ja hiljentää sisällään olevat viholliset."
"[english]DOTA_BroadcastFact_AbilityMovie_bloodseeker_blood_rite"	"A circle of blood that damages and silences an area."
"DOTA_BroadcastFact_AbilityMovie_bloodseeker_thirst"	"Antaa lisää liikenopeutta ja vahinkoa, kun vihollisilla on vähän terveyttä."
"[english]DOTA_BroadcastFact_AbilityMovie_bloodseeker_thirst"	"Bonus speed and damage when enemies have low HP."
"DOTA_BroadcastFact_AbilityMovie_bloodseeker_rupture"	"Tekee paljon vahinkoa valittuun viholliseen, jos hän liikkuu. Läpäisee loitsuimmuniteetin."
"[english]DOTA_BroadcastFact_AbilityMovie_bloodseeker_rupture"	"Causes massive damage to enemies who move. Pierces BKB."
"DOTA_BroadcastFact_AbilityMovie_bounty_hunter_shuriken_toss"	"Heittää heittotähden, joka vahingoittaa ja keskeyttää kanavoinnit."
"[english]DOTA_BroadcastFact_AbilityMovie_bounty_hunter_shuriken_toss"	"Throws a blade for damage and mini-stun."
"DOTA_BroadcastFact_AbilityMovie_bounty_hunter_jinada"	"Antaa lisävahinkoa ja hidastuksen yhteen hyökkäykseen."
"[english]DOTA_BroadcastFact_AbilityMovie_bounty_hunter_jinada"	"Grants bonus damage and slow to a single attack."
"DOTA_BroadcastFact_AbilityMovie_bounty_hunter_shadow_walk"	"Antaa näkymättömyyden ja lisävahinkoa seuraavaan hyökkäykseen."
"[english]DOTA_BroadcastFact_AbilityMovie_bounty_hunter_shadow_walk"	"Invisibility. Gives bonus damage to next attack."
"DOTA_BroadcastFact_AbilityMovie_bounty_hunter_track"	"Antaa näkyvyyden viholliseen ja lisäkultaa sen kuollessa."
"[english]DOTA_BroadcastFact_AbilityMovie_bounty_hunter_track"	"Gives True Sight of an enemy, bonus gold upon their death."
"DOTA_BroadcastFact_AbilityMovie_brewmaster_thunder_clap"	"Lyö maata ympärillään, hidastaen ja vahingoittaen vihollisia."
"[english]DOTA_BroadcastFact_AbilityMovie_brewmaster_thunder_clap"	"Slams the earth, damaging and slowing enemies."
"DOTA_BroadcastFact_AbilityMovie_brewmaster_drunken_haze"	"Humalluttaa valitun vihollisen, jonka myötä sen hyökkäykset menevät ohi."
"[english]DOTA_BroadcastFact_AbilityMovie_brewmaster_drunken_haze"	"Drenches a target, causing them to miss attacks."
"DOTA_BroadcastFact_AbilityMovie_brewmaster_drunken_brawler"	"Antaa mahdollisuuden väistää hyökkäyksiä ja tehdä lisävahinkoa."
"[english]DOTA_BroadcastFact_AbilityMovie_brewmaster_drunken_brawler"	"Gives a chance to avoid attacks and deal critical damage."
"DOTA_BroadcastFact_AbilityMovie_brewmaster_primal_split"	"Jakaa <hc>Brewmasterin</hc> kolmeen elementtisoturiin. Jos kaikki kuolevat, Brewmaster kuolee."
"[english]DOTA_BroadcastFact_AbilityMovie_brewmaster_primal_split"	"Splits <hc>Brewmaster</hc> into three warriors. If any survive, he is reborn."
"DOTA_BroadcastFact_AbilityMovie_bristleback_viscous_nasal_goo"	"Räkäisee valitun vihollisen päälle, mikä vähentää sen liikenopeutta ja panssaria."
"[english]DOTA_BroadcastFact_AbilityMovie_bristleback_viscous_nasal_goo"	"Covers a target in snot, reducing speed and armor."
"DOTA_BroadcastFact_AbilityMovie_bristleback_quill_spray"	"Ampuu piikkejä ympärilleen. Vihollisten ottama vahinko kasvaa, kun se ottaa enemmän piikkejä."
"[english]DOTA_BroadcastFact_AbilityMovie_bristleback_quill_spray"	"Launches quills in all directions. Damage stacks."
"DOTA_BroadcastFact_AbilityMovie_bristleback_bristleback"	"Vähentää kylki- tai selkäpuolelta otettua vahinkoa."
"[english]DOTA_BroadcastFact_AbilityMovie_bristleback_bristleback"	"Reduces damage taken from the side or rear."
"DOTA_BroadcastFact_AbilityMovie_bristleback_warpath"	"Nostaa liikenopeutta ja vahinkoa jokaisella loitsulla."
"[english]DOTA_BroadcastFact_AbilityMovie_bristleback_warpath"	"Increases movement speed and damage each time he casts a spell."
"DOTA_BroadcastFact_AbilityMovie_broodmother_spawn_spiderlings"	"Munii viholliseen hämähäkinmunia, jotka kuoriutuvat, jos vihollinen kuolee."
"[english]DOTA_BroadcastFact_AbilityMovie_broodmother_spawn_spiderlings"	"Injects eggs into an enemy that hatch if it dies."
"DOTA_BroadcastFact_AbilityMovie_broodmother_spin_web"	"Verkot antavat näkymättömyyden, liikenopeutta ja terveydenpalautumista."
"[english]DOTA_BroadcastFact_AbilityMovie_broodmother_spin_web"	"Webs grant invisibility, movement, and HP regen."
"DOTA_BroadcastFact_AbilityMovie_broodmother_incapacitating_bite"	"Hyökkäysten myrkky hidastaa vihollisia ja aiheuttaa ohilyöntejä."
"[english]DOTA_BroadcastFact_AbilityMovie_broodmother_incapacitating_bite"	"Venom slows enemies and causes them to miss attacks."
"DOTA_BroadcastFact_AbilityMovie_broodmother_insatiable_hunger"	"Hämähäkin kiihko antaa lisävahinkoa ja vampirismia."
"[english]DOTA_BroadcastFact_AbilityMovie_broodmother_insatiable_hunger"	"A violent urge grants bonus damage and lifesteal to her attacks."
"DOTA_BroadcastFact_AbilityMovie_centaur_warrunner_hoof_stomp"	"Tainnuttaa ja vahingoittaa ympäröiviä vihollisia."
"[english]DOTA_BroadcastFact_AbilityMovie_centaur_warrunner_hoof_stomp"	"Stuns and damages enemies around him."
"DOTA_BroadcastFact_AbilityMovie_centaur_warrunner_double_edge"	"Vahingoittaa ympäröiviä vihollisia ja <hc>Centaur Warrunneria</hc> itseään."
"[english]DOTA_BroadcastFact_AbilityMovie_centaur_warrunner_double_edge"	"Damages enemies in an area and <hc>Centaur Warrunner</hc> himself."
"DOTA_BroadcastFact_AbilityMovie_centaur_warrunner_return"	"<hc>Centaur Warrunneriin</hc> hyökkäävät viholliset ottavat vahinkoa."
"[english]DOTA_BroadcastFact_AbilityMovie_centaur_warrunner_return"	"Causes enemies to take damage when attacking <hc>Centaur Warrunner</hc>."
"DOTA_BroadcastFact_AbilityMovie_centaur_warrunner_stampede"	"Antaa kaikille liittolaisille maksimiliikenopeuden."
"[english]DOTA_BroadcastFact_AbilityMovie_centaur_warrunner_stampede"	"Leads a charge that allows allies to move through units at max speed."
"DOTA_BroadcastFact_AbilityMovie_tidehunter_ravage"	"Suuri lonkeropurkaus tainnuttaa ja vahingoittaa lähialueen vihoillisia."
"[english]DOTA_BroadcastFact_AbilityMovie_tidehunter_ravage"	"Stuns a large area with tentacles, causing damage."
"DOTA_BroadcastFact_AbilityMovie_treant_protector_overgrowth"	"Sitoo viholliset köynnöksillä, jotta ne eivät voi hyökätä tai liikkua."
"[english]DOTA_BroadcastFact_AbilityMovie_treant_protector_overgrowth"	"Summons vines to hold enemies in place and prevent attacks."
"DOTA_BroadcastFact_AbilityMovie_tusk_snowball"	"<hc>Tusk</hc> muuttuu lumipalloksi ja vyöryy sillä vihollista päin."
"[english]DOTA_BroadcastFact_AbilityMovie_tusk_snowball"	"<hc>Tusk</hc> rolls into a snowball to chase down an enemy."
"DOTA_BroadcastFact_AbilityMovie_tusk_walrus_punch"	"Iskee niin lujaa, että vihollinen lentää ilmaan."
"[english]DOTA_BroadcastFact_AbilityMovie_tusk_walrus_punch"	"A mighty punch that launches an enemy into the air."
"DOTA_BroadcastFact_AbilityMovie_underlord_dark_rift"	"Teleporttaa <hc>Underlordin</hc> ja läheiset liittolaiset valitun kätyrin luo."
"[english]DOTA_BroadcastFact_AbilityMovie_underlord_dark_rift"	"Teleports <hc>Underlord</hc> and nearby allies to an allied creep."
"DOTA_BroadcastFact_AbilityMovie_undying_tombstone"	"Luo hautakiven, joka synnyttää hidastavia zombeja."
"[english]DOTA_BroadcastFact_AbilityMovie_undying_tombstone"	"Summons a tombstone and spawns zombies. "
"DOTA_BroadcastFact_AbilityMovie_ursa_fury_swipes"	"Peräkkäiset iskut samaan kohteeseen tekevät jatkuvasti enemmän vahinkoa."
"[english]DOTA_BroadcastFact_AbilityMovie_ursa_fury_swipes"	"Subsequent hits on same target do bonus damage."
"DOTA_BroadcastFact_AbilityMovie_ursa_enrage"	"Nostaa <ac>Fury Swipesin</ac> vahinkoa ja vähentää otettua vahinkoa huomattavasti."
"[english]DOTA_BroadcastFact_AbilityMovie_ursa_enrage"	"Increases <ac>Fury Swipe</ac> damage and reduces incoming damage."
"DOTA_BroadcastFact_AbilityMovie_vengeful_spirit_nether_swap"	"Vaihtaa paikkaa minkä tahansa sankarin kanssa."
"[english]DOTA_BroadcastFact_AbilityMovie_vengeful_spirit_nether_swap"	"Swaps position with another hero—friend or foe."
"DOTA_BroadcastFact_AbilityMovie_venomancer_poison_nova"	"Ruiskuttaa ympärille myrkkyä, joka vahingoittaa hitaasti mutta ei voi tappaa."
"[english]DOTA_BroadcastFact_AbilityMovie_venomancer_poison_nova"	"Sprays poison in a ring. Damages over time, but cannot kill enemies."
"DOTA_BroadcastFact_AbilityMovie_warlock_chaotic_offering"	"Kutsuu jättimäisen golemin, joka tainnuttaa viholliset."
"[english]DOTA_BroadcastFact_AbilityMovie_warlock_chaotic_offering"	"Summons a mighty, fiery golem, stunning nearby enemies. "
}
}
