"lang"
{
"Language"	"czech"
"Tokens"
{
"DOTA_BroadcasterToasts_HeroAbilityMovie_Title"	"<hc>{s:hero_name}:</hc> <ac>{s:ability_name}</ac>"
"[english]DOTA_BroadcasterToasts_HeroAbilityMovie_Title"	"<hc>{s:hero_name}:</hc> <ac>{s:ability_name}</ac>"
"DOTA_BroadcasterToasts_ItemMovie_Title"	"<ic>{s:item_name}</ic>"
"[english]DOTA_BroadcasterToasts_ItemMovie_Title"	"<ic>{s:item_name}</ic>"
"DOTA_BroadcastFact_Stat_item_player_win_percent"	"Hráči, kteří si zakoupili předmět <ic>{s:item_name}</ic>, měli <nc>{s:percent}%</nc> úspěšnost."
"[english]DOTA_BroadcastFact_Stat_item_player_win_percent"	"Players who bought <ic>{s:item_name}</ic> have a <nc>{s:percent}%</nc> win rate."
"DOTA_BroadcastFact_Stat_item_player_pick_percent"	"Předmět <ic>{s:item_name}</ic> byl zakoupen v <nc>{s:percent}%</nc> her."
"[english]DOTA_BroadcastFact_Stat_item_player_pick_percent"	"<ic>{s:item_name}</ic> has been bought in <nc>{s:percent}%</nc> of games."
"DOTA_BroadcastFact_Stat_item_pick_rate"	"Předmět <ic>{s:item_name}</ic> byl zakoupen v <nc>{s:percent}%</nc> všech her."
"[english]DOTA_BroadcastFact_Stat_item_pick_rate"	"<ic>{s:item_name}</ic> has been picked in <nc>{s:percent}%</nc> of all games."
"DOTA_BroadcastFact_Stat_hero_pick_rate"	"Hrdina <hc>{s:hero_name}</hc> byl vybrán v <nc>{s:percent}%</nc> všech her."
"[english]DOTA_BroadcastFact_Stat_hero_pick_rate"	"<hc>{s:hero_name}</hc> has been picked in <nc>{s:percent}%</nc> of all games."
"DOTA_BroadcastFact_Stat_hero_win_rate"	"Hrdina <hc>{s:hero_name}</hc> má na <ec>{s:event_name}</ec> <nc>{s:percent}%</nc> úspěšnost."
"[english]DOTA_BroadcastFact_Stat_hero_win_rate"	"<hc>{s:hero_name}</hc> has a <nc>{s:percent}%</nc> win rate in games."
"DOTA_BroadcastFact_Stat_league_item_player_win_percent"	"Hráči, kteří si zakoupili předmět <ic>{s:item_name}</ic>, měli na <ec>{s:event_name}</ec> <nc>{s:percent}%</nc> úspěšnost."
"[english]DOTA_BroadcastFact_Stat_league_item_player_win_percent"	"Players who bought <ic>{s:item_name}</ic> have a <nc>{s:percent}%</nc> win rate at <ec>{s:event_name}</ec>."
"DOTA_BroadcastFact_Stat_league_item_player_pick_percent"	"Předmět <ic>{s:item_name}</ic> byl zakoupen v <nc>{s:percent}%</nc> všech her na <ec>{s:event_name}</ec>."
"[english]DOTA_BroadcastFact_Stat_league_item_player_pick_percent"	"<ic>{s:item_name}</ic> has been bought in <nc>{s:percent}%</nc> of games at <ec>{s:event_name}</ec>."
"DOTA_BroadcastFact_Stat_league_hero_pick_rate"	"Na <ec>{s:event_name}</ec> byl hrdina <hc>{s:hero_name}</hc> vybrán v <nc>{s:percent}%</nc> her."
"[english]DOTA_BroadcastFact_Stat_league_hero_pick_rate"	"At <ec>{s:event_name}</ec>, <hc>{s:hero_name}</hc> has been picked in <nc>{s:percent}%</nc> of games."
"DOTA_BroadcastFact_Stat_hero_player_pick_count"	"Hráč {s:player_name} si vybral hrdinu <hc>{s:hero_name}</hc> v <nc>{d:count}</nc> hrách."
"[english]DOTA_BroadcastFact_Stat_hero_player_pick_count"	"{s:player_name} has picked <hc>{s:hero_name}</hc> in <nc>{d:count}</nc> games."
}
}
