"lang"
{
"Language"	"hungarian"
"Tokens"
{
"DOTA_BroadcasterToasts_HeroAbilityMovie_Title"	"<hc>{s:hero_name}:</hc> <ac>{s:ability_name}</ac>"
"[english]DOTA_BroadcasterToasts_HeroAbilityMovie_Title"	"<hc>{s:hero_name}:</hc> <ac>{s:ability_name}</ac>"
"DOTA_BroadcasterToasts_ItemMovie_Title"	"<ic>{s:item_name}</ic>"
"[english]DOTA_BroadcasterToasts_ItemMovie_Title"	"<ic>{s:item_name}</ic>"
"DOTA_BroadcastFact_Stat_item_hero_win_percent"	"<hc>{s:hero_name}</hc> hőssel játszó játékosok a játékaik <nc>{s:percent}%</nc>-át nyerték meg <ic>{s:item_name}</ic> vásárlása után."
"[english]DOTA_BroadcastFact_Stat_item_hero_win_percent"	"<hc>{s:hero_name}</hc> players have won <nc>{s:percent}%</nc> of their games when purchasing <ic>{s:item_name}</ic>."
"DOTA_BroadcastFact_Stat_item_hero_pick_percent"	"<hc>{s:hero_name}</hc> hőssel játszó játékosok <ic>{s:item_name}</ic> tárgyat játékaik <nc>{s:percent}%</nc>-ában vásároltak."
"[english]DOTA_BroadcastFact_Stat_item_hero_pick_percent"	"<hc>{s:hero_name}</hc> players have purchased <ic>{s:item_name}</ic> in <nc>{s:percent}%</nc> of their games."
"DOTA_BroadcastFact_Stat_item_player_win_percent"	"<pc>{s:player_name}</pc> játékosnak <nc>{s:percent}%</nc>-os győzelmi aránya van <ic>{s:item_name}</ic> tárggyal."
"[english]DOTA_BroadcastFact_Stat_item_player_win_percent"	"<pc>{s:player_name}</pc> has a <nc>{s:percent}%</nc> win rate with <ic>{s:item_name}</ic>."
"DOTA_BroadcastFact_Stat_item_player_pick_percent"	"<pc>{s:player_name}</pc> játékos <ic>{s:item_name}</ic> tárgyat a játékai <nc>{s:percent}%</nc>-ában vásárolt."
"[english]DOTA_BroadcastFact_Stat_item_player_pick_percent"	"<pc>{s:player_name}</pc> has purchased <ic>{s:item_name}</ic> in <nc>{s:percent}%</nc> of his games."
"DOTA_BroadcastFact_Stat_hero_player_win_rate"	"<pc>{s:player_name}</pc> játékai <nc>{s:percent}%</nc>-át nyerte meg <hc>{s:hero_name}</hc> hőst választva."
"[english]DOTA_BroadcastFact_Stat_hero_player_win_rate"	"<pc>{s:player_name}</pc> has won <nc>{s:percent}%</nc> of his games when picking <hc>{s:hero_name}</hc>."
"DOTA_BroadcastFact_Stat_hero_player_pick_rate"	"<pc>{s:player_name}</pc> <hc>{s:hero_name}</hc> hőst választotta a játékai <nc>{s:percent}%</nc>-ában."
"[english]DOTA_BroadcastFact_Stat_hero_player_pick_rate"	"<pc>{s:player_name}</pc> has picked <hc>{s:hero_name}</hc> in <nc>{s:percent}%</nc> of his games."
"DOTA_BroadcastFact_Stat_item_pick_rate"	"<ic>{s:item_name}</ic> tárgyat az összes játék <nc>{s:percent}%</nc>-ában vásároltak."
"[english]DOTA_BroadcastFact_Stat_item_pick_rate"	"<ic>{s:item_name}</ic> has been purchased in <nc>{s:percent}%</nc> of all games."
"DOTA_BroadcastFact_Stat_item_win_rate"	"A játékosok megnyerték azon játékaik <nc>{s:percent}%</nc>-át, amelyben <ic>{s:item_name}</ic> tárgyat vásároltak."
"[english]DOTA_BroadcastFact_Stat_item_win_rate"	"Players have won <nc>{s:percent}%</nc> of their games in which they purchased <ic>{s:item_name}</ic>."
"DOTA_BroadcastFact_Stat_hero_pick_rate"	"A(z) <hc>{s:hero_name}</hc> hőst az összes játék <nc>{s:percent}%</nc>-ában választották."
"[english]DOTA_BroadcastFact_Stat_hero_pick_rate"	"<hc>{s:hero_name}</hc> has been picked in <nc>{s:percent}%</nc> of all games."
"DOTA_BroadcastFact_Stat_hero_win_rate"	"<hc>{s:hero_name}</hc> <nc>{s:percent}%</nc>-os győzelmi aránnyal rendelkezik a játékokban."
"[english]DOTA_BroadcastFact_Stat_hero_win_rate"	"<hc>{s:hero_name}</hc> has a <nc>{s:percent}%</nc> win rate across all games."
"DOTA_BroadcastFact_Stat_league_item_hero_win_percent"	"<hc>{s:hero_name}</hc> hőssel játszó játékosok megnyerték a játékaik <nc>{s:percent}%</nc>-át a(z) <ec>{s:event_name}</ec> eseményen, mikor <ic>{s:item_name}</ic> tárgyat vásároltak."
"[english]DOTA_BroadcastFact_Stat_league_item_hero_win_percent"	"<hc>{s:hero_name}</hc> players have won <nc>{s:percent}%</nc> of their games at <ec>{s:event_name}</ec> when purchasing <ic>{s:item_name}</ic>."
"DOTA_BroadcastFact_Stat_league_item_hero_pick_percent"	"<hc>{s:hero_name}</hc> hőssel játszó játékosok megvásárolták a(z) <ic>{s:item_name}</ic> tárgyat a játékaik <nc>{s:percent}%</nc>-ában a(z) <ec>{s:event_name}</ec> eseményen."
"[english]DOTA_BroadcastFact_Stat_league_item_hero_pick_percent"	"<hc>{s:hero_name}</hc> players have purchased <ic>{s:item_name}</ic> in <nc>{s:percent}%</nc> of their games at <ec>{s:event_name}</ec>."
"DOTA_BroadcastFact_Stat_league_item_player_win_percent"	"<pc>{s:player_name}</pc> játékosnak <nc>{s:percent}%</nc>-os győzelmi aránya van <ic>{s:item_name}</ic> tárggyal a(z) <ec>{s:event_name}</ec> eseményen."
"[english]DOTA_BroadcastFact_Stat_league_item_player_win_percent"	"<pc>{s:player_name}</pc> has a <nc>{s:percent}%</nc> win rate with  <ic>{s:item_name}</ic> at <ec>{s:event_name}</ec>."
"DOTA_BroadcastFact_Stat_league_item_player_pick_percent"	"<pc>{s:player_name}</pc> játékos megvásárolta a(z) <ic>{s:item_name}</ic> tárgyat a játékai <nc>{s:percent}%</nc>-ában a(z) <ec>{s:event_name}</ec> eseményen."
"[english]DOTA_BroadcastFact_Stat_league_item_player_pick_percent"	"<pc>{s:player_name}</pc> has purchased <ic>{s:item_name}</ic> in <nc>{s:percent}%</nc> of his games at <ec>{s:event_name}</ec>."
"DOTA_BroadcastFact_Stat_league_hero_player_win_rate"	"<pc>{s:player_name}</pc> <hc>{s:hero_name}</hc> hőst választotta <nc>{s:percent}%</nc>-os győzelmi aránnyal a(z) <ec>{s:event_name}</ec> eseményen."
"[english]DOTA_BroadcastFact_Stat_league_hero_player_win_rate"	"<pc>{s:player_name}</pc> has picked <hc>{s:hero_name}</hc> with a <nc>{s:percent}%</nc> win rate at <ec>{s:event_name}</ec>."
"DOTA_BroadcastFact_Stat_league_hero_player_pick_rate"	"<pc>{s:player_name}</pc> játékos <hc>{s:hero_name}</hc> hőst választotta a játékai <nc>{s:percent}%</nc>-ában a(z) <ec>{s:event_name}</ec> eseményen."
"[english]DOTA_BroadcastFact_Stat_league_hero_player_pick_rate"	"<pc>{s:player_name}</pc> has picked <hc>{s:hero_name}</hc> in <nc>{s:percent}%</nc> of his games at <ec>{s:event_name}</ec>."
"DOTA_BroadcastFact_Stat_league_item_pick_rate"	"<ic>{s:item_name}</ic> tárgyat a játékok <nc>{s:percent}%</nc>-ában vásároltak a(z) <ec>{s:event_name}</ec> eseményen."
"[english]DOTA_BroadcastFact_Stat_league_item_pick_rate"	"<ic>{s:item_name}</ic> has been purchased in <nc>{s:percent}%</nc> of all games at <ec>{s:event_name}</ec>."
"DOTA_BroadcastFact_Stat_league_item_win_rate"	"A(z) <ic>{s:item_name}</ic> tárgynak <nc>{s:percent}%</nc>-os győzelmi aránya van a(z) {s:event_name} eseményen."
"[english]DOTA_BroadcastFact_Stat_league_item_win_rate"	"<ic>{s:item_name}</ic> has a <nc>{s:percent}%</nc> win rate at {s:event_name}."
"DOTA_BroadcastFact_Stat_league_hero_pick_rate"	"<hc>{s:hero_name}</hc> hőst a játékok <nc>{s:percent}%</nc>-ában választották a(z) <ec>{s:event_name}</ec> eseményen."
"[english]DOTA_BroadcastFact_Stat_league_hero_pick_rate"	"<hc>{s:hero_name}</hc> has been picked in <nc>{s:percent}%</nc> of games at <ec>{s:event_name}</ec>."
"DOTA_BroadcastFact_Stat_league_hero_win_rate"	"<hc>{s:hero_name}</hc> hősnek <nc>{s:percent}%</nc>-os győzelmi aránya van a(z) <ec>{s:event_name}</ec> eseményen."
"[english]DOTA_BroadcastFact_Stat_league_hero_win_rate"	"<hc>{s:hero_name}</hc> has a <nc>{s:percent}%</nc> win rate at <ec>{s:event_name}</ec>."
"DOTA_BroadcastFact_Stat_league_full_set_win_rate"	"<pc>{s:player_name}</pc> játékos megnyerte a játékai <nc>{s:percent}%</nc>-át a(z) <ec>{s:event_name}</ec> eseményen, amikor <ic>{s:item_name}</ic> tárgyat vásárolt <hc>{s:hero_name}</hc> hősnek."
"[english]DOTA_BroadcastFact_Stat_league_full_set_win_rate"	"<pc>{s:player_name}</pc> has won <nc>{s:percent}%</nc> of his games at <ec>{s:event_name}</ec> when purchasing <ic>{s:item_name}</ic> on <hc>{s:hero_name}</hc>."
"DOTA_BroadcastFact_Stat_league_full_set_pick_rate"	"<pc>{s:player_name}</pc> <ic>{s:item_name}</ic> tárgyat a játékai <nc>{s:percent}%</nc>-ában vásárolt <hc>{s:hero_name}</hc> hőssel a(z) <ec>{s:event_name}</ec> eseményen."
"[english]DOTA_BroadcastFact_Stat_league_full_set_pick_rate"	"<pc>{s:player_name}</pc> has purchased <ic>{s:item_name}</ic> in <nc>{s:percent}%</nc> of his <hc>{s:hero_name}</hc> games at <ec>{s:event_name}</ec>."
"DOTA_BroadcastFact_Stat_full_set_win_rate"	"<pc>{s:player_name}</pc> a(z) <ic>{s:item_name}</ic> tárgyat választotta <hc>{s:hero_name}</hc> hőssel játszva, és a játékai <nc>{s:percent}%</nc>-át nyerte meg."
"[english]DOTA_BroadcastFact_Stat_full_set_win_rate"	"<pc>{s:player_name}</pc> has won <nc>{s:percent}%</nc> of his games when purchasing <ic>{s:item_name}</ic> on <hc>{s:hero_name}</hc>."
"DOTA_BroadcastFact_Stat_full_set_pick_rate"	"<pc>{s:player_name}</pc> <ic>{s:item_name}</ic> tárgyat a játékai <nc>{s:percent}%</nc>-ában vásárolt <hc>{s:hero_name}</hc> hőssel."
"[english]DOTA_BroadcastFact_Stat_full_set_pick_rate"	"<pc>{s:player_name}</pc> has purchased <ic>{s:item_name}</ic> in <nc>{s:percent}%</nc> of his games on <hc>{s:hero_name}</hc>."
"DOTA_BroadcastFact_Stat_item_hero_win_count"	"<hc>{s:hero_name}</hc> hőssel játszó játékosok <nc>{d:count}</nc> játékot nyertek, amikor <ic>{s:item_name}</ic> tárgyat vásároltak."
"[english]DOTA_BroadcastFact_Stat_item_hero_win_count"	"<hc>{s:hero_name}</hc> players have won <nc>{d:count}</nc> games when purchasing <ic>{s:item_name}</ic>."
"DOTA_BroadcastFact_Stat_item_hero_pick_count"	"<hc>{s:hero_name}</hc> hőssel játszó játékosok a(z) <ic>{s:item_name}</ic> tárgyat <nc>{d:count}</nc> játékban vásárolták meg."
"[english]DOTA_BroadcastFact_Stat_item_hero_pick_count"	"<hc>{s:hero_name}</hc> players have purchased <ic>{s:item_name}</ic> in <nc>{d:count}</nc> games."
"DOTA_BroadcastFact_Stat_item_player_win_count"	"<pc>{s:player_name}</pc> <nc>{d:count}</nc> játékot nyert <ic>{s:item_name}</ic> tárggyal."
"[english]DOTA_BroadcastFact_Stat_item_player_win_count"	"<pc>{s:player_name}</pc> has won <nc>{d:count}</nc> games with <ic>{s:item_name}</ic>."
"DOTA_BroadcastFact_Stat_item_player_pick_count"	"<pc>{s:player_name}</pc> <ic>{s:item_name}</ic> tárgyat <nc>{d:count}</nc> játékban vásárolt."
"[english]DOTA_BroadcastFact_Stat_item_player_pick_count"	"<pc>{s:player_name}</pc> has purchased <ic>{s:item_name}</ic> in <nc>{d:count}</nc> games."
"DOTA_BroadcastFact_Stat_hero_player_win_count"	"<pc>{s:player_name}</pc> <nc>{d:count}</nc> játékot nyert <hc>{s:hero_name}</hc> hőst választva."
"[english]DOTA_BroadcastFact_Stat_hero_player_win_count"	"<pc>{s:player_name}</pc> has won <nc>{d:count}</nc> games when picking <hc>{s:hero_name}</hc>."
"DOTA_BroadcastFact_Stat_hero_player_pick_count"	"<pc>{s:player_name}</pc> <hc>{s:hero_name}</hc> hőst <nc>{d:count}</nc> játékban választotta."
"[english]DOTA_BroadcastFact_Stat_hero_player_pick_count"	"<pc>{s:player_name}</pc> has picked <hc>{s:hero_name}</hc> in <nc>{d:count}</nc> games."
"DOTA_BroadcastFact_Stat_item_pick_count"	"<ic>{s:item_name}</ic> tárgyat <nc>{d:count}</nc> játékban vásároltak."
"[english]DOTA_BroadcastFact_Stat_item_pick_count"	"<ic>{s:item_name}</ic> has been purchased in <nc>{d:count}</nc> games"
"DOTA_BroadcastFact_Stat_item_win_count"	"Olyan játékokban ahol <ic>{s:item_name}</ic> tárgyat vásárolták, a játékosok <nc>{d:count}</nc> alkalommal győztek."
"[english]DOTA_BroadcastFact_Stat_item_win_count"	"<nc>{d:count}</nc> games have been decided in which <ic>{s:item_name}</ic> was purchased by the winning team."
"DOTA_BroadcastFact_Stat_hero_pick_count"	"<hc>{s:hero_name}</hc> hőst <nc>{d:count}</nc> játékban választották."
"[english]DOTA_BroadcastFact_Stat_hero_pick_count"	"<hc>{s:hero_name}</hc> has been picked in <nc>{d:count}</nc> games."
"DOTA_BroadcastFact_Stat_hero_win_count"	"<hc>{s:hero_name}</hc> <nc>{d:count}</nc> játékot nyert."
"[english]DOTA_BroadcastFact_Stat_hero_win_count"	"<hc>{s:hero_name}</hc> has won <nc>{d:count}</nc> games."
"DOTA_BroadcastFact_Stat_league_item_hero_win_count"	"<hc>{s:hero_name}</hc> hőssel játszó játékosok <nc>{d:count}</nc> játékot nyertek a(z) <ec>{s:event_name}</ec> eseményen, <ic>{s:item_name}</ic> tárgyat vásárolva."
"[english]DOTA_BroadcastFact_Stat_league_item_hero_win_count"	"<hc>{s:hero_name}</hc> players have won <nc>{d:count}</nc> games at <ec>{s:event_name}</ec> with <ic>{s:item_name}</ic> purchased."
"DOTA_BroadcastFact_Stat_league_item_hero_pick_count"	"<hc>{s:hero_name}</hc> hőssel játszva a játékosok <ic>{s:item_name}</ic> tárgyat <nc>{d:count}</nc> játékban vásároltak a(z) <ec>{s:event_name}</ec> eseményen."
"[english]DOTA_BroadcastFact_Stat_league_item_hero_pick_count"	"<hc>{s:hero_name}</hc> players have purchased <ic>{s:item_name}</ic> in <nc>{d:count}</nc> games at <ec>{s:event_name}</ec>."
"DOTA_BroadcastFact_Stat_league_item_player_win_count"	"<pc>{s:player_name}</pc> <nc>{d:count}</nc> játékot nyert a(z) <ec>{s:event_name}</ec> eseményen, <ic>{s:item_name}</ic> tárgyat vásárolva."
"[english]DOTA_BroadcastFact_Stat_league_item_player_win_count"	"<pc>{s:player_name}</pc> has won <nc>{d:count}</nc> games at <ec>{s:event_name}</ec> with <ic>{s:item_name}</ic> purchased."
"DOTA_BroadcastFact_Stat_league_item_player_pick_count"	"<pc>{s:player_name}</pc> <ic>{s:item_name}</ic> tárgyat <nc>{d:count}</nc> játékban vásárolt a(z) <ec>{s:event_name}</ec> eseményen."
"[english]DOTA_BroadcastFact_Stat_league_item_player_pick_count"	"<pc>{s:player_name}</pc> has purchased <ic>{s:item_name}</ic> in <nc>{d:count}</nc> games at <ec>{s:event_name}</ec>."
"DOTA_BroadcastFact_Stat_league_hero_player_win_count"	"<pc>{s:player_name}</pc> <nc>{d:count}</nc> játékot nyert a(z) <ec>{s:event_name}</ec> eseményen <hc>{s:hero_name}</hc> hőssel."
"[english]DOTA_BroadcastFact_Stat_league_hero_player_win_count"	"<pc>{s:player_name}</pc> has won <nc>{d:count}</nc> games at <ec>{s:event_name}</ec> with <hc>{s:hero_name}</hc>."
"DOTA_BroadcastFact_Stat_league_hero_player_pick_count"	"<pc>{s:player_name}</pc> <hc>{s:hero_name}</hc> hőst <nc>{d:count}</nc> játékban választotta a(z) <ec>{s:event_name}</ec> eseményen."
"[english]DOTA_BroadcastFact_Stat_league_hero_player_pick_count"	"<pc>{s:player_name}</pc> has picked <hc>{s:hero_name}</hc> in <nc>{d:count}</nc> games at <ec>{s:event_name}</ec>."
"DOTA_BroadcastFact_Stat_league_item_pick_count"	"<ic>{s:item_name}</ic> tárgyat <nc>{d:count}</nc> játékban vásároltak a(z) <ec>{s:event_name}</ec> eseményen."
"[english]DOTA_BroadcastFact_Stat_league_item_pick_count"	"<ic>{s:item_name}</ic> has been purchased <nc>{d:count}</nc> times at <ec>{s:event_name}</ec>."
"DOTA_BroadcastFact_Stat_league_item_win_count"	"<nc>A(z) <ec>{s:event_name}</ec> eseményen {d:count}</nc> játék végződött <ic>{s:item_name}</ic> tárggyal a nyertes csapatnál."
"[english]DOTA_BroadcastFact_Stat_league_item_win_count"	"<nc>At <ec>{s:event_name}</ec>, {d:count}</nc> games have ended with a <ic>{s:item_name}</ic> on the winning team."
"DOTA_BroadcastFact_Stat_league_hero_pick_count"	"<hc>{s:hero_name}</hc> hőst <nc>{d:count}</nc> alkalommal választották a(z) <ec>{s:event_name}</ec> eseményen."
"[english]DOTA_BroadcastFact_Stat_league_hero_pick_count"	"<hc>{s:hero_name}</hc> has been picked <nc>{d:count}</nc> times at <ec>{s:event_name}</ec>."
"DOTA_BroadcastFact_Stat_league_hero_win_count"	"<hc>{s:hero_name}</hc> <nc>{d:count}</nc> játékot nyert a(z) <ec>{s:event_name}</ec> eseményen."
"[english]DOTA_BroadcastFact_Stat_league_hero_win_count"	"<hc>{s:hero_name}</hc> has won <nc>{d:count}</nc> games at <ec>{s:event_name}</ec>."
"DOTA_BroadcastFact_Stat_full_set_win_count"	"<pc>{s:player_name}</pc> <nc>{d:count}</nc> játékot nyert <ic>{s:item_name}</ic> vásárlása után <hc>{s:hero_name}</hc> hőssel."
"[english]DOTA_BroadcastFact_Stat_full_set_win_count"	"<pc>{s:player_name}</pc> has won <nc>{d:count}</nc> games after purchasing <ic>{s:item_name}</ic> on <hc>{s:hero_name}</hc>."
"DOTA_BroadcastFact_Stat_full_set_pick_count"	"<pc>{s:player_name}</pc> <ic>{s:item_name}</ic> tárgyat <hc>{s:hero_name}</hc> hőssel <nc>{d:count}</nc> játékban vásárolt."
"[english]DOTA_BroadcastFact_Stat_full_set_pick_count"	"<pc>{s:player_name}</pc> has purchased <ic>{s:item_name}</ic> on <hc>{s:hero_name}</hc> in <nc>{d:count}</nc> games."
"DOTA_BroadcastFact_Stat_league_full_set_win_count"	"<pc>{s:player_name}</pc> <nc>{d:count}</nc> játékot nyert a(z) <ec>{s:event_name}</ec> eseményen a(z) <ic>{s:item_name}</ic> tárgy megvásárlása után <hc>{s:hero_name}</hc> hőssel."
"[english]DOTA_BroadcastFact_Stat_league_full_set_win_count"	"<pc>{s:player_name}</pc> has won <nc>{d:count}</nc> games at <ec>{s:event_name}</ec> after purchasing <ic>{s:item_name}</ic> on <hc>{s:hero_name}</hc>."
"DOTA_BroadcastFact_Stat_league_full_set_pick_count"	"<pc>{s:player_name}</pc> <ic>{s:item_name}</ic> tárgyat <hc>{s:hero_name}</hc> hőssel <nc>{d:count}</nc> játékban vásárolt a(z) <ec>{s:event_name}</ec> eseményen."
"[english]DOTA_BroadcastFact_Stat_league_full_set_pick_count"	"<pc>{s:player_name}</pc> has purchased <ic>{s:item_name}</ic> on <hc>{s:hero_name}</hc> in <nc>{d:count}</nc> games at <ec>{s:event_name}</ec>."
"DOTA_BroadcastFact_ItemMovie_item_bloodthorn"	"Némítja az ellenségeket és növeli a kritikus támadások esélyét."
"[english]DOTA_BroadcastFact_ItemMovie_item_bloodthorn"	"Silences enemies and increases the chance of critical strikes."
"DOTA_BroadcastFact_ItemMovie_item_bottle_haste"	"Képes elraktározni rúnákat későbbi felhasználásra, feltöltve egy játékos Bottle tölteteit."
"[english]DOTA_BroadcastFact_ItemMovie_item_bottle_haste"	"Has ability to store runes for later use, replenishing a player's bottle charges."
"DOTA_BroadcastFact_ItemMovie_item_crimson_guard"	"Blokkolja a fizikai sebzés egy részét a játékosnak és a területen belüli szövetségeseknek."
"[english]DOTA_BroadcastFact_ItemMovie_item_crimson_guard"	"Blocks a portion of physical damage for the player and any allies in the area."
"DOTA_BroadcastFact_ItemMovie_item_dust"	"Rövid időre felfedi a láthatatlan egységeket."
"[english]DOTA_BroadcastFact_ItemMovie_item_dust"	"Reveals invisible units for a short duration."
"DOTA_BroadcastFact_ItemMovie_item_gem"	"Láthatóvá teszi a közeli láthatatlan egységeket."
"[english]DOTA_BroadcastFact_ItemMovie_item_gem"	"Gives vision of nearby invisible units."
"DOTA_BroadcastFact_ItemMovie_item_mjollnir"	"Aktív villámpajzs képességet ad a <ic>Maelstromhoz</ic>."
"[english]DOTA_BroadcastFact_ItemMovie_item_mjollnir"	"Adds an active lightning shield ability to <ic>Maelstrom</ic>."
"DOTA_BroadcastFact_ItemMovie_item_maelstrom"	"Növeli a sebzést és a támadási sebességet, és passzív Chain Lightningot biztosít."
"[english]DOTA_BroadcastFact_ItemMovie_item_maelstrom"	"Increases damage and attack speed, and provides passive Chain Lightning."
"DOTA_BroadcastFact_ItemMovie_item_pipe"	"Egy területen belül védi az ellenségeket egy adott mennyiségű sebzéstől."
"[english]DOTA_BroadcastFact_ItemMovie_item_pipe"	"Shields allies in an area from a fixed amount of damage."
"DOTA_BroadcastFact_ItemMovie_item_radiance"	"Sebzi és a támadások elvétésére kényszeríti a közeli ellenségeket."
"[english]DOTA_BroadcastFact_ItemMovie_item_radiance"	"Damages and causes nearby enemies to miss attacks."
"DOTA_BroadcastFact_ItemMovie_item_satanic"	"Óriási életlopást ad minden egyes támadással."
"[english]DOTA_BroadcastFact_ItemMovie_item_satanic"	"Provides massive lifesteal with each attack."
"DOTA_BroadcastFact_ItemMovie_item_ward_sentry"	"Láthatóvá teszi a közeli láthatatlan egységeket."
"[english]DOTA_BroadcastFact_ItemMovie_item_ward_sentry"	"Gives vision of nearby invisible units."
"DOTA_BroadcastFact_ItemMovie_item_invis_sword"	"Láthatatlanságot és megnövelt mozgási sebességet biztosít."
"[english]DOTA_BroadcastFact_ItemMovie_item_invis_sword"	"Grants invisibility and increased movement speed."
"DOTA_BroadcastFact_ItemMovie_item_silver_edge"	"Hasznos erős passzív képességekkel rendelkező hősök támadására."
"[english]DOTA_BroadcastFact_ItemMovie_item_silver_edge"	"Useful for attacking heroes with strong passive abilities."
"DOTA_BroadcastFact_ItemMovie_item_shivas_guard"	"Kibocsájt egy területi hullámot, hogy lelassítsa az ellenségeket."
"[english]DOTA_BroadcastFact_ItemMovie_item_shivas_guard"	"Releases an AoE wave to slow down enemies."
"DOTA_BroadcastFact_ItemMovie_item_tpscroll"	"Lehetővé teszi a hősök számára, hogy gyorsan szövetséges építményekhez teleportáljanak."
"[english]DOTA_BroadcastFact_ItemMovie_item_tpscroll"	"Allows heroes to quickly teleport to allied structures."
"DOTA_BroadcastFact_ItemMovie_item_smoke_of_deceit"	"Elrejti az összes közeli szövetségest és megnövelt mozgási sebességet biztosít számukra."
"[english]DOTA_BroadcastFact_ItemMovie_item_smoke_of_deceit"	"Hides all nearby allies and grants them increased movement speed."
"DOTA_BroadcastFact_ItemMovie_item_sheepstick"	"<ac>Hexeli</ac> az ellenségeket, tehetetlen teremtményekké változtatva őket."
"[english]DOTA_BroadcastFact_ItemMovie_item_sheepstick"	"<ac>Hexes</ac> enemies, turning them into helpless creatures."
"DOTA_BroadcastFact_ItemMovie_item_sphere"	"Blokkolni tud egyetlen célzott képességet, amikor nincs újratöltődésen."
"[english]DOTA_BroadcastFact_ItemMovie_item_sphere"	"Can block a single targeted ability when off cooldown."
"DOTA_BroadcastFact_ItemMovie_item_hurricane_pike"	"Képes ellökni egy ellenséget, lehetővé téve a távolsági támadást."
"[english]DOTA_BroadcastFact_ItemMovie_item_hurricane_pike"	"Can push an enemy away, allowing for ranged attacks."
"DOTA_BroadcastFact_ItemMovie_item_glimmer_cape"	"Láthatatlanságot biztosít és használható varázslatok fenntartása közben."
"[english]DOTA_BroadcastFact_ItemMovie_item_glimmer_cape"	"Grants invisibility and can be cast while channeling spells."
"DOTA_BroadcastFact_ItemMovie_item_cyclone"	"Egy ellenség bénítására és képességeinek megszakítására használható."
"[english]DOTA_BroadcastFact_ItemMovie_item_cyclone"	"Can be used to disable an enemy and interrupt their abilities."
"DOTA_BroadcastFact_ItemMovie_item_dagon"	"Erőteljes mágikus sebzéskitörést bocsát ki."
"[english]DOTA_BroadcastFact_ItemMovie_item_dagon"	"Emits a powerful burst of magical damage."
"DOTA_BroadcastFact_ItemMovie_item_travel_boots"	"Lehetővé teszi egy hősnek a teleportálást bármely szövetséges nem-hős egységhez."
"[english]DOTA_BroadcastFact_ItemMovie_item_travel_boots"	"Allows a hero to teleport to any allied non-hero unit."
"DOTA_BroadcastFact_ItemMovie_item_blink"	"Lehetővé teszi egy hősnek, hogy ugorjon egy rövid távolságot."
"[english]DOTA_BroadcastFact_ItemMovie_item_blink"	"Allows a hero to jump a short distance."
"DOTA_BroadcastFact_ItemMovie_item_black_king_bar"	"Rövid ideig varázsimmunitást biztosít."
"[english]DOTA_BroadcastFact_ItemMovie_item_black_king_bar"	"Provides spell immunity for a short duration."
"DOTA_BroadcastFact_ItemMovie_item_abyssal_blade"	"Passzív esélyt ad a támadáskori bénításra, valamint egy aktív bénítást."
"[english]DOTA_BroadcastFact_ItemMovie_item_abyssal_blade"	"Grants a passive chance to stun on attacks and an active disable."
"DOTA_BroadcastFact_AbilityMovie_invoker_sun_strike"	"A pályán bárhol megidézhető, hogy sebzést okozzon."
"[english]DOTA_BroadcastFact_AbilityMovie_invoker_sun_strike"	"Strikes anywhere in the map to deal damage."
"DOTA_BroadcastFact_AbilityMovie_invoker_tornado"	"A levegőbe dobja az ellenségeket, sebezve őket."
"[english]DOTA_BroadcastFact_AbilityMovie_invoker_tornado"	"Throws enemies into the air, dealing damage."
"DOTA_BroadcastFact_AbilityMovie_abaddon_mist_coil"	"Sebzi az ellenségeket vagy gyógyítja a szövetségeseket életerőért cserébe."
"[english]DOTA_BroadcastFact_AbilityMovie_abaddon_mist_coil"	"Damages foes or heals allies at the cost of health."
"DOTA_BroadcastFact_AbilityMovie_abaddon_aphotic_shield"	"Pajzsot hoz létre egy szövetségesen. Megrepedéskor sebzi az ellenségeket."
"[english]DOTA_BroadcastFact_AbilityMovie_abaddon_aphotic_shield"	"Shields an ally. Damages enemies upon bursting."
"DOTA_BroadcastFact_AbilityMovie_abaddon_curse_of_avernus"	"Átok, amely növeli a szövetséges mozgási- és támadási sebességet."
"[english]DOTA_BroadcastFact_AbilityMovie_abaddon_curse_of_avernus"	"A curse that boosts allied movement and attack speed."
"DOTA_BroadcastFact_AbilityMovie_abaddon_borrowed_time"	"Amikor aktiválva van, minden elszenvedett sebzés gyógyít, nem árt."
"[english]DOTA_BroadcastFact_AbilityMovie_abaddon_borrowed_time"	"When activated, all damage taken heals instead of harms."
"DOTA_BroadcastFact_AbilityMovie_alchemist_acid_spray"	"Savat permetez, sebzést és páncélcsökkentést okozva."
"[english]DOTA_BroadcastFact_AbilityMovie_alchemist_acid_spray"	"Sprays acid, causing damage and armor reduction."
"DOTA_BroadcastFact_AbilityMovie_alchemist_unstable_concoction"	"Kifőz egy varázsitalt, hogy eldobja és bénítson vele. Saját magát is béníthatja."
"[english]DOTA_BroadcastFact_AbilityMovie_alchemist_unstable_concoction"	"Brews a potion to throw and stun. Can self-stun."
"DOTA_BroadcastFact_AbilityMovie_alchemist_greevil's_greed"	"Bónusz aranyat biztosít az utolsó találatoknak és az Adomány rúnáknak."
"[english]DOTA_BroadcastFact_AbilityMovie_alchemist_greevil's_greed"	"Grants bonus gold to last hits and bounty runes."
"DOTA_BroadcastFact_AbilityMovie_alchemist_chemical_rage"	"Támadási és mozgási sebességet, valamint életerő-töltődést biztosít."
"[english]DOTA_BroadcastFact_AbilityMovie_alchemist_chemical_rage"	"Grants attack and move speed, and health regen."
"DOTA_BroadcastFact_AbilityMovie_ancient_apparition_cold_feet"	"Helyhez fagyaszt egy ellenséget, ha az nem mozdul."
"[english]DOTA_BroadcastFact_AbilityMovie_ancient_apparition_cold_feet"	"Freezes an enemy in place if they don't move."
"DOTA_BroadcastFact_AbilityMovie_ancient_apparition_ice_vortex"	"Lassítja az ellenségeket és növeli a mágikus sebzést."
"[english]DOTA_BroadcastFact_AbilityMovie_ancient_apparition_ice_vortex"	"Slows enemies and increases magic damage."
"DOTA_BroadcastFact_AbilityMovie_ancient_apparition_chilling_touch"	"Bónusz támadási sebzést ad szövetségeseknek."
"[english]DOTA_BroadcastFact_AbilityMovie_ancient_apparition_chilling_touch"	"Grants allies bonus attack damage."
"DOTA_BroadcastFact_AbilityMovie_ancient_apparition_ice_blast"	"Egy robbanást lő ki a pályán át, amely sebez és gátolja a gyógyulást."
"[english]DOTA_BroadcastFact_AbilityMovie_ancient_apparition_ice_blast"	"Aims a blast across the map that damages and prevents healing. "
"DOTA_BroadcastFact_AbilityMovie_anti-mage_mana_break"	"Minden támadással égeti egy ellenség manáját."
"[english]DOTA_BroadcastFact_AbilityMovie_anti-mage_mana_break"	"Burns an enemy's mana with each attack."
"DOTA_BroadcastFact_AbilityMovie_anti-mage_blink"	"Teleportál egy rövid távolságra."
"[english]DOTA_BroadcastFact_AbilityMovie_anti-mage_blink"	"Teleports a short distance."
"DOTA_BroadcastFact_AbilityMovie_anti-mage_spell_shield"	"Növeli a mágikus sebzéssel szembeni ellenállást."
"[english]DOTA_BroadcastFact_AbilityMovie_anti-mage_spell_shield"	"Increases resistance to magic damage."
"DOTA_BroadcastFact_AbilityMovie_anti-mage_mana_void"	"Sebzést okoz egy területen annak függvényében, hogy a célpontnak mennyi manája hiányzik."
"[english]DOTA_BroadcastFact_AbilityMovie_anti-mage_mana_void"	"Deals damage in an area for each point of mana the target is missing."
"DOTA_BroadcastFact_AbilityMovie_arc_warden_flux"	"Lassítja a mozgási sebességet és időarányosan sebez."
"[english]DOTA_BroadcastFact_AbilityMovie_arc_warden_flux"	"Slows movement speed and damages over time."
"DOTA_BroadcastFact_AbilityMovie_arc_warden_magnetic_field"	"Létrehoz egy mezőt, amely véd a kívül lévő támadóktól."
"[english]DOTA_BroadcastFact_AbilityMovie_arc_warden_magnetic_field"	"Creates a field that shields from outside attackers."
"DOTA_BroadcastFact_AbilityMovie_arc_warden_spark_wraith"	"Védelmez egy területet. Lassítja és sebzi azt az ellenséget, aki belép."
"[english]DOTA_BroadcastFact_AbilityMovie_arc_warden_spark_wraith"	"Guards an area. Slows and damages an enemy that enters."
"DOTA_BroadcastFact_AbilityMovie_arc_warden_tempest_double"	"Létrehoz egy <hc>Arc Warden</hc> másolatot a saját képességeivel és tárgy-újratöltődési időkkel."
"[english]DOTA_BroadcastFact_AbilityMovie_arc_warden_tempest_double"	"Creates a copy of <hc>Arc Warden</hc> with its own ability and item cooldowns."
"DOTA_BroadcastFact_AbilityMovie_axe_berserker's_call"	"Gúnyolja a közeli ellenségeket, támadásra kényszerítve őket."
"[english]DOTA_BroadcastFact_AbilityMovie_axe_berserker's_call"	"Taunts nearby enemies, forcing them to attack."
"DOTA_BroadcastFact_AbilityMovie_axe_battle_hunger"	"Addig sebez egy ellenséget, amíg az meg nem öl egy másik egységet."
"[english]DOTA_BroadcastFact_AbilityMovie_axe_battle_hunger"	"Damages an enemy until it kills another unit."
"DOTA_BroadcastFact_AbilityMovie_axe_counter_helix"	"Pörgő ellentámadás, ami árt a közeli ellenségeknek."
"[english]DOTA_BroadcastFact_AbilityMovie_axe_counter_helix"	"Spinning counter-attack that hurts nearby enemies."
"DOTA_BroadcastFact_AbilityMovie_axe_culling_blade"	"Azonnal megöl egy alacsony életerejű ellenséges hőst."
"[english]DOTA_BroadcastFact_AbilityMovie_axe_culling_blade"	"Instantly kills an enemy hero with low health."
"DOTA_BroadcastFact_AbilityMovie_bane_enfeeble"	"Gyengíti egy ellenség fizikai támadásait."
"[english]DOTA_BroadcastFact_AbilityMovie_bane_enfeeble"	"Weakens an enemy's physical attacks."
"DOTA_BroadcastFact_AbilityMovie_bane_brain_sap"	"Sebzést okoz, <hc>Bane</hc>-t pedig gyógyítja."
"[english]DOTA_BroadcastFact_AbilityMovie_bane_brain_sap"	"Deals damage while healing <hc>Bane</hc>."
"DOTA_BroadcastFact_AbilityMovie_bane_fiend's_grip"	"Megragad egy ellenséget, mozgásképtelenné téve és súlyosan sebezve azt."
"[english]DOTA_BroadcastFact_AbilityMovie_bane_fiend's_grip"	"Grips an enemy, disabling it and causing heavy damage."
"DOTA_BroadcastFact_AbilityMovie_batrider_flamebreak"	"Robbanékony koktél, ami hátralöki az ellenséget."
"[english]DOTA_BroadcastFact_AbilityMovie_batrider_flamebreak"	"An explosive cocktail that knocks back enemies."
"DOTA_BroadcastFact_AbilityMovie_batrider_firefly"	"Repülő mozgást biztosít. Lángösvényt hagy maga után."
"[english]DOTA_BroadcastFact_AbilityMovie_batrider_firefly"	"Grants flying movement. Lays a trail of flames."
"DOTA_BroadcastFact_AbilityMovie_batrider_flaming_lasso"	"<hc>Batrider</hc> elkap és maga után vonszol egy ellenséget."
"[english]DOTA_BroadcastFact_AbilityMovie_batrider_flaming_lasso"	"Grabs an enemy and drags them behind <hc>Batrider</hc>."
"DOTA_BroadcastFact_AbilityMovie_beastmaster_inner_beast"	"Növeli a közeli szövetségesek támadási sebességét."
"[english]DOTA_BroadcastFact_AbilityMovie_beastmaster_inner_beast"	"Increases the attack speed of nearby allies."
"DOTA_BroadcastFact_AbilityMovie_bloodseeker_bloodrage"	"Növeli az okozott és kapott sebzést. Öléskor gyógyít."
"[english]DOTA_BroadcastFact_AbilityMovie_bloodseeker_bloodrage"	"Increases damage dealt and taken. Heals on kill."
"DOTA_BroadcastFact_AbilityMovie_bloodseeker_blood_rite"	"Vérkör, ami sebez és elhallgattat egy területen."
"[english]DOTA_BroadcastFact_AbilityMovie_bloodseeker_blood_rite"	"A circle of blood that damages and silences an area."
"DOTA_BroadcastFact_AbilityMovie_bloodseeker_thirst"	"Bónusz sebesség és sebzés, amikor az ellenségnek alacsony az életereje."
"[english]DOTA_BroadcastFact_AbilityMovie_bloodseeker_thirst"	"Bonus speed and damage when enemies have low HP."
"DOTA_BroadcastFact_AbilityMovie_bounty_hunter_shuriken_toss"	"Eldob egy pengét sebzés és minibénítás okozására."
"[english]DOTA_BroadcastFact_AbilityMovie_bounty_hunter_shuriken_toss"	"Throws a blade for damage and mini-stun."
"DOTA_BroadcastFact_AbilityMovie_bounty_hunter_jinada"	"Bónusz sebzést és lassítást ad egyetlen támadáshoz."
"[english]DOTA_BroadcastFact_AbilityMovie_bounty_hunter_jinada"	"Grants bonus damage and slow to a single attack."
"DOTA_BroadcastFact_AbilityMovie_bounty_hunter_shadow_walk"	"Láthatatlanság. Bónusz sebzést ad a következő támadáshoz."
"[english]DOTA_BroadcastFact_AbilityMovie_bounty_hunter_shadow_walk"	"Invisibility. Gives bonus damage to next attack."
"DOTA_BroadcastFact_AbilityMovie_bounty_hunter_track"	"Igazlátást ad egy ellenségen, és bónuszaranyat annak halálakor."
"[english]DOTA_BroadcastFact_AbilityMovie_bounty_hunter_track"	"Gives True Sight of an enemy, bonus gold upon their death."
"DOTA_BroadcastFact_AbilityMovie_brewmaster_thunder_clap"	"A földre csap, sebezve és lassítva az ellenséget."
"[english]DOTA_BroadcastFact_AbilityMovie_brewmaster_thunder_clap"	"Slams the earth, damaging and slowing enemies."
"DOTA_BroadcastFact_AbilityMovie_brewmaster_drunken_haze"	"Eláztat egy célpontot, amitől az elvéti a támadásait."
"[english]DOTA_BroadcastFact_AbilityMovie_brewmaster_drunken_haze"	"Drenches a target, causing them to miss attacks."
"DOTA_BroadcastFact_AbilityMovie_brewmaster_drunken_brawler"	"Esélyt ad támadások elkerülésére és kritikus sebzés okozására."
"[english]DOTA_BroadcastFact_AbilityMovie_brewmaster_drunken_brawler"	"Gives a chance to avoid attacks and deal critical damage."
"DOTA_BroadcastFact_AbilityMovie_brewmaster_primal_split"	"Három harcossá hasítja <hc>Brewmaster</hc>t. Ha bármelyikük életben marad, a hős újraszületik."
"[english]DOTA_BroadcastFact_AbilityMovie_brewmaster_primal_split"	"Splits <hc>Brewmaster</hc> into three warriors. If any survive, he is reborn."
"DOTA_BroadcastFact_AbilityMovie_bristleback_viscous_nasal_goo"	"Takonnyal borít be egy célpontot, csökkentve sebességét és páncélját."
"[english]DOTA_BroadcastFact_AbilityMovie_bristleback_viscous_nasal_goo"	"Covers a target in snot, reducing speed and armor."
"DOTA_BroadcastFact_AbilityMovie_bristleback_quill_spray"	"Tüskéket lő ki minden irányban. A sebzés összeadódik."
"[english]DOTA_BroadcastFact_AbilityMovie_bristleback_quill_spray"	"Launches quills in all directions. Damage stacks."
"DOTA_BroadcastFact_AbilityMovie_bristleback_bristleback"	"Csökkenti az oldalról vagy hátulról kapott sebzést."
"[english]DOTA_BroadcastFact_AbilityMovie_bristleback_bristleback"	"Reduces damage taken from the side or rear."
"DOTA_BroadcastFact_AbilityMovie_bristleback_warpath"	"Növeli a mozgási sebességet és sebzést, valahányszor varázsol."
"[english]DOTA_BroadcastFact_AbilityMovie_bristleback_warpath"	"Increases movement speed and damage each time he casts a spell."
"DOTA_BroadcastFact_AbilityMovie_broodmother_spawn_spiderlings"	"Petéket rak egy ellenségbe, amelyek annak halálakor kikelnek."
"[english]DOTA_BroadcastFact_AbilityMovie_broodmother_spawn_spiderlings"	"Injects eggs into an enemy that hatch if it dies."
"DOTA_BroadcastFact_AbilityMovie_broodmother_spin_web"	"A hálók láthatatlanságot, mozgási sebességet és ÉP-töltődést adnak."
"[english]DOTA_BroadcastFact_AbilityMovie_broodmother_spin_web"	"Webs grant invisibility, movement, and HP regen."
"DOTA_BroadcastFact_AbilityMovie_broodmother_incapacitating_bite"	"A méreg lassítja az ellenséget és támadásaik elvétését okozza."
"[english]DOTA_BroadcastFact_AbilityMovie_broodmother_incapacitating_bite"	"Venom slows enemies and causes them to miss attacks."
"DOTA_BroadcastFact_AbilityMovie_broodmother_insatiable_hunger"	"Erőszakos vágy ad bónusz sebzést és életlopást támadásainak."
"[english]DOTA_BroadcastFact_AbilityMovie_broodmother_insatiable_hunger"	"A violent urge grants bonus damage and lifesteal to her attacks."
"DOTA_BroadcastFact_AbilityMovie_centaur_warrunner_hoof_stomp"	"Bénítja és sebzi a körülötte levő ellenségeket."
"[english]DOTA_BroadcastFact_AbilityMovie_centaur_warrunner_hoof_stomp"	"Stuns and damages enemies around him."
"DOTA_BroadcastFact_AbilityMovie_centaur_warrunner_double_edge"	"Sebzi az ellenségeket egy területen, és magát <hc>Centaur Warrunner</hc>t is."
"[english]DOTA_BroadcastFact_AbilityMovie_centaur_warrunner_double_edge"	"Damages enemies in an area and <hc>Centaur Warrunner</hc> himself."
"DOTA_BroadcastFact_AbilityMovie_centaur_warrunner_return"	"Hatására az ellenségek sebzést szenvednek, amikor <hc>Centaur Warrunner</hc>t támadják."
"[english]DOTA_BroadcastFact_AbilityMovie_centaur_warrunner_return"	"Causes enemies to take damage when attacking <hc>Centaur Warrunner</hc>."
"DOTA_BroadcastFact_AbilityMovie_centaur_warrunner_stampede"	"Rohamot vezet, ami lehetővé teszi a szövetségeseknek, hogy maximális sebességgel áthaladjanak az egységeken."
"[english]DOTA_BroadcastFact_AbilityMovie_centaur_warrunner_stampede"	"Leads a charge that allows allies to move through units at max speed."
"DOTA_BroadcastFact_AbilityMovie_chaos_knight_chaos_bolt"	"Lövedék, ami véletlen nagyságú sebzést és hosszúságú bénítást okoz."
"[english]DOTA_BroadcastFact_AbilityMovie_chaos_knight_chaos_bolt"	"Bolt that deals random damage and stun duration."
"DOTA_BroadcastFact_AbilityMovie_chaos_knight_reality_rift"	"A célponthoz teleportálja az illúzióit, csökkentve annak páncélját."
"[english]DOTA_BroadcastFact_AbilityMovie_chaos_knight_reality_rift"	"Teleports his illusions to target, reducing its armor."
"DOTA_BroadcastFact_AbilityMovie_chaos_knight_chaos_strike"	"A támadásoknak esélye van bónusz sebzésre. A kritikus találatok életet lopnak."
"[english]DOTA_BroadcastFact_AbilityMovie_chaos_knight_chaos_strike"	"Attacks have a chance for bonus damage. Lifesteal on crits."
"DOTA_BroadcastFact_AbilityMovie_chaos_knight_phantasm"	"Másolatokat idéz meg <hc>Chaos Knight</hc>ból, amelyek támadásai teljes sebzést okoznak."
"[english]DOTA_BroadcastFact_AbilityMovie_chaos_knight_phantasm"	"Summons copies of <hc>Chaos Knight</hc> that deal full damage on attacks."
"DOTA_BroadcastFact_AbilityMovie_chen_penitence"	"Lelassít egy ellenséget. A célpont több sebzést szenved."
"[english]DOTA_BroadcastFact_AbilityMovie_chen_penitence"	"Slows an enemy. Targets take more damage."
"DOTA_BroadcastFact_AbilityMovie_chen_test_of_faith"	"Az ellenségeket sebzi, a szövetségeseket a bázisra teleportálja."
"[english]DOTA_BroadcastFact_AbilityMovie_chen_test_of_faith"	"Deals damage to enemies. Teleports allies to base."
"DOTA_BroadcastFact_AbilityMovie_chen_holy_persuasion"	"Véglegesen átveszi egy ellenséges vagy semleges creep irányítását."
"[english]DOTA_BroadcastFact_AbilityMovie_chen_holy_persuasion"	"Permanently takes control of an enemy or neutral creep."
"DOTA_BroadcastFact_AbilityMovie_chen_hand_of_god"	"Gyógyítja az összes semleges hőst és irányított creepet a pályán."
"[english]DOTA_BroadcastFact_AbilityMovie_chen_hand_of_god"	"Heals all allied heroes and controlled creeps on the map."
"DOTA_BroadcastFact_AbilityMovie_clinkz_strafe"	"Rövid időre hatalmas mértékben növeli a támadási sebességet."
"[english]DOTA_BroadcastFact_AbilityMovie_clinkz_strafe"	"Massively boosts attack speed for a short time."
"DOTA_BroadcastFact_AbilityMovie_clinkz_searing_arrows"	"Extra sebzésért lángra gyújtja a nyilakat."
"[english]DOTA_BroadcastFact_AbilityMovie_clinkz_searing_arrows"	"Imbues arrows with fire for extra damage."
"DOTA_BroadcastFact_AbilityMovie_clinkz_skeleton_walk"	"Láthatatlanná válik és mozgási sebességet nyer."
"[english]DOTA_BroadcastFact_AbilityMovie_clinkz_skeleton_walk"	"Becomes invisible and gains move speed."
"DOTA_BroadcastFact_AbilityMovie_clinkz_death_pact"	"Felfal egy creepet, ÉP-je egy részét megkapva életerőként és sebzésként."
"[english]DOTA_BroadcastFact_AbilityMovie_clinkz_death_pact"	"Devours a creep, gaining a percentage of its HP as health and damage."
"DOTA_BroadcastFact_AbilityMovie_clockwerk_battery_assault"	"Repeszeket bocsát ki, amelyek sebeznek és minibénítást okoznak."
"[english]DOTA_BroadcastFact_AbilityMovie_clockwerk_battery_assault"	"Discharges shrapnel that damages and ministuns."
"DOTA_BroadcastFact_AbilityMovie_clockwerk_rocket_flare"	"Robbanó rakéta. 10 másodpercre látóteret ad."
"[english]DOTA_BroadcastFact_AbilityMovie_clockwerk_rocket_flare"	"An explosive rocket. Provides vision for 10 seconds."
"DOTA_BroadcastFact_AbilityMovie_clockwerk_hookshot"	"Horgot lő ki, ami a célponthoz húzza <hc>Clockwerk</hc>et. Bénít és sebez."
"[english]DOTA_BroadcastFact_AbilityMovie_clockwerk_hookshot"	"Fires a hook that reels <hc>Clockwerk</hc> to the target. Stuns and deals damage."
"DOTA_BroadcastFact_AbilityMovie_crystal_maiden_crystal_nova"	"Fagykitörés ami sebzi és lassítja az ellenséget."
"[english]DOTA_BroadcastFact_AbilityMovie_crystal_maiden_crystal_nova"	"A burst of frost that damages and slows enemies."
"DOTA_BroadcastFact_AbilityMovie_crystal_maiden_frostbite"	"Sebző jéggel helyhez köt egy ellenséget."
"[english]DOTA_BroadcastFact_AbilityMovie_crystal_maiden_frostbite"	"Roots an enemy with damaging ice."
"DOTA_BroadcastFact_AbilityMovie_crystal_maiden_arcane_aura"	"Bónusz manatöltődést biztosít minden baráti egységnek."
"[english]DOTA_BroadcastFact_AbilityMovie_crystal_maiden_arcane_aura"	"Provides bonus mana regen to all friendly units."
"DOTA_BroadcastFact_AbilityMovie_crystal_maiden_freezing_field"	"Jeges robbanásokkal borít el egy területet, amelyek sebzik és lassítják az ellenséget."
"[english]DOTA_BroadcastFact_AbilityMovie_crystal_maiden_freezing_field"	"Covers the area in icy explosions that damage and slow enemies."
"DOTA_BroadcastFact_AbilityMovie_dark_seer_vacuum"	"Egy célzott pont felé húzza az ellenségeket."
"[english]DOTA_BroadcastFact_AbilityMovie_dark_seer_vacuum"	"Sucks enemies towards a target point."
"DOTA_BroadcastFact_AbilityMovie_dark_seer_ion_shell"	"Sebző energiapajzsot hoz létre egy egység körül."
"[english]DOTA_BroadcastFact_AbilityMovie_dark_seer_ion_shell"	"Creates a damaging energy shield around a unit."
"DOTA_BroadcastFact_AbilityMovie_dark_seer_surge"	"Megnövelt mozgási sebességet ad magának vagy szövetségeseknek."
"[english]DOTA_BroadcastFact_AbilityMovie_dark_seer_surge"	"Charges self or allies with increased move speed."
"DOTA_BroadcastFact_AbilityMovie_dark_seer_wall_of_replica"	"Fal, amely illúziókat hoz létre a rajta áthaladó ellenségekből."
"[english]DOTA_BroadcastFact_AbilityMovie_dark_seer_wall_of_replica"	"A wall that spawns illusions of enemies that pass through."
"DOTA_BroadcastFact_AbilityMovie_dazzle_poison_touch"	"Ártó varázslat, ami lassítja és sebzi az ellenséget."
"[english]DOTA_BroadcastFact_AbilityMovie_dazzle_poison_touch"	"A noxious spell that slows and damages enemies."
"DOTA_BroadcastFact_AbilityMovie_dazzle_shallow_grave"	"Rövid időre meggátolja egy szövetséges halálát."
"[english]DOTA_BroadcastFact_AbilityMovie_dazzle_shallow_grave"	"Prevents an ally from dying for a short time."
"DOTA_BroadcastFact_AbilityMovie_dazzle_weave"	"Erősíti a szövetségesek páncélját, miközben gyengíti az ellenségekét."
"[english]DOTA_BroadcastFact_AbilityMovie_dazzle_weave"	"Buffs allies' armor while decreasing enemy armor."
"DOTA_BroadcastFact_AbilityMovie_death_prophet_silence"	"Elhallgattatja az ellenségeket egy célterületen."
"[english]DOTA_BroadcastFact_AbilityMovie_death_prophet_silence"	"Silences enemies in a target area."
"DOTA_BroadcastFact_AbilityMovie_death_prophet_spirit_siphon"	"Életerőt szív és lassít egy ellenséges hőst."
"[english]DOTA_BroadcastFact_AbilityMovie_death_prophet_spirit_siphon"	"Drains health and slows an enemy hero."
"DOTA_BroadcastFact_AbilityMovie_death_prophet_exorcism"	"Lelkek viharát szabadítja el, amelyek sebzik a közeli ellenségeket és épületeket."
"[english]DOTA_BroadcastFact_AbilityMovie_death_prophet_exorcism"	"Unleashes a storm of spirits that damages nearby enemies and structures."
"DOTA_BroadcastFact_AbilityMovie_disruptor_thunder_strike"	"Többször villámmal csap le a célpontra."
"[english]DOTA_BroadcastFact_AbilityMovie_disruptor_thunder_strike"	"Repeatedly strikes target with lightning."
"DOTA_BroadcastFact_AbilityMovie_disruptor_glimpse"	"Oda teleportálja a célpontot, ahol az pár másodperccel korábban volt."
"[english]DOTA_BroadcastFact_AbilityMovie_disruptor_glimpse"	"Teleports the target back to where it was a few seconds ago."
"DOTA_BroadcastFact_AbilityMovie_disruptor_kinetic_field"	"Körkörös akadályt hoz létre, amin az ellenség nem tud áthaladni."
"[english]DOTA_BroadcastFact_AbilityMovie_disruptor_kinetic_field"	"Creates a circular barrier that enemies can't pass."
"DOTA_BroadcastFact_AbilityMovie_disruptor_static_storm"	"Vihart kelt, ami sebzi és elhallgattatja az ellenséget."
"[english]DOTA_BroadcastFact_AbilityMovie_disruptor_static_storm"	"Brews a storm that damages and silences enemies."
"DOTA_BroadcastFact_AbilityMovie_doom_devour"	"Megeszik egy nem baráti creepet és megkapja annak képességeit."
"[english]DOTA_BroadcastFact_AbilityMovie_doom_devour"	"Eats a non-friendly creep and grants its abilities."
"DOTA_BroadcastFact_AbilityMovie_doom_scorched_earth"	"Öngyógyító lángmező, ami sebzi az ellenséget."
"[english]DOTA_BroadcastFact_AbilityMovie_doom_scorched_earth"	"A self-healing flame field that damages enemies."
"DOTA_BroadcastFact_AbilityMovie_doom_infernal_blade"	"Rövid időre bénít és időarányos sebzést okoz."
"[english]DOTA_BroadcastFact_AbilityMovie_doom_infernal_blade"	"Briefly stuns and deals damage over time."
"DOTA_BroadcastFact_AbilityMovie_dragon_knight_breathe_fire"	"Tűzhullám, ami gyengíti az ellenség támadásait."
"[english]DOTA_BroadcastFact_AbilityMovie_dragon_knight_breathe_fire"	"A wave of fire that weakens enemy attacks."
"DOTA_BroadcastFact_AbilityMovie_dragon_knight_dragon_tail"	"Bénít egy közelharci távolságban levő ellenséget."
"[english]DOTA_BroadcastFact_AbilityMovie_dragon_knight_dragon_tail"	"Stuns an enemy in melee range."
"DOTA_BroadcastFact_AbilityMovie_dragon_knight_dragon_blood"	"Javítja az életerő-töltődést és páncélt."
"[english]DOTA_BroadcastFact_AbilityMovie_dragon_knight_dragon_blood"	"Improves health regeneration and armor."
"DOTA_BroadcastFact_AbilityMovie_drow_ranger_gust"	"Elhallgattat és visszalök ellenséges egységeket."
"[english]DOTA_BroadcastFact_AbilityMovie_drow_ranger_gust"	"Silences and knocks back enemies."
"DOTA_BroadcastFact_AbilityMovie_drow_ranger_precision_aura"	"Növeli a szövetségesek távolsági támadásainak sebzését."
"[english]DOTA_BroadcastFact_AbilityMovie_drow_ranger_precision_aura"	"Increases damage of allies' ranged attacks."
"DOTA_BroadcastFact_AbilityMovie_drow_ranger_marksmanship"	"Bónusz ügyességet ad, amikor nincsenek ellenségek a közelben."
"[english]DOTA_BroadcastFact_AbilityMovie_drow_ranger_marksmanship"	"Grants bonus agility if no enemies are nearby."
"DOTA_BroadcastFact_AbilityMovie_earth_spirit_rolling_boulder"	"Átalakul és a célpont felé gurul."
"[english]DOTA_BroadcastFact_AbilityMovie_earth_spirit_rolling_boulder"	"Transforms and rolls toward a target."
"DOTA_BroadcastFact_AbilityMovie_earth_spirit_geomagnetic_grip"	"Magához húz egy stone remnantot, elhallgattatva a vele eltalált ellenségeket."
"[english]DOTA_BroadcastFact_AbilityMovie_earth_spirit_geomagnetic_grip"	"Pulls a stone remnant, silencing enemies hit."
"DOTA_BroadcastFact_AbilityMovie_earth_spirit_magnetize"	"Pulzáló sebzést okoz és felrobbantja a közeli remnantokat."
"[english]DOTA_BroadcastFact_AbilityMovie_earth_spirit_magnetize"	"Causes pulsing damage and detonates nearby remnants."
"DOTA_BroadcastFact_AbilityMovie_earthshaker_fissure"	"Egy kőfalat hoz létre, ami bénítja az ellenfeleket."
"[english]DOTA_BroadcastFact_AbilityMovie_earthshaker_fissure"	"Creates a wall of stone that stuns foes."
"DOTA_BroadcastFact_AbilityMovie_earthshaker_enchant_totem"	"Bónusz sebzéssel erősíti következő támadását."
"[english]DOTA_BroadcastFact_AbilityMovie_earthshaker_enchant_totem"	"Empowers his next attack with bonus damage."
"DOTA_BroadcastFact_AbilityMovie_earthshaker_aftershock"	"A képességek sebeznek és bénítják a közeli ellenséget."
"[english]DOTA_BroadcastFact_AbilityMovie_earthshaker_aftershock"	"Abilities do damage and stun nearby enemies."
"DOTA_BroadcastFact_AbilityMovie_earthshaker_echo_slam"	"Lecsap egy területre. A sebzés az ellenségek számával együtt nő."
"[english]DOTA_BroadcastFact_AbilityMovie_earthshaker_echo_slam"	"Slams and stuns an area. Damage increases with more enemies."
"DOTA_BroadcastFact_AbilityMovie_elder_titan_ancestral_spirit"	"Lélek, ami sebzi a megérintett egységeket. Képes Stompot használni."
"[english]DOTA_BroadcastFact_AbilityMovie_elder_titan_ancestral_spirit"	"Spirit that damages units touched. Can use Stomp."
"DOTA_BroadcastFact_AbilityMovie_elder_titan_natural_order"	"Csökkenti a közeli ellenfelek páncélját és mágiaellenállását."
"[english]DOTA_BroadcastFact_AbilityMovie_elder_titan_natural_order"	"Reduces armor and magic resistance of nearby foes."
"DOTA_BroadcastFact_AbilityMovie_ember_spirit_searing_chains"	"Bolákat dob el az ellenség csapdába ejtésére és sebzésére."
"[english]DOTA_BroadcastFact_AbilityMovie_ember_spirit_searing_chains"	"Unleashes bolas to trap and damage enemies."
"DOTA_BroadcastFact_AbilityMovie_ember_spirit_sleight_of_fist"	"Támadást hajt végre egy területen, majd visszatér a kiindulópontra."
"[english]DOTA_BroadcastFact_AbilityMovie_ember_spirit_sleight_of_fist"	"Attacks in an area and returns to starting spot."
"DOTA_BroadcastFact_AbilityMovie_ember_spirit_fire_remnant"	"Egy, a térképen elhelyezett remnanthoz teleportál."
"[english]DOTA_BroadcastFact_AbilityMovie_ember_spirit_fire_remnant"	"Teleport to a remnant placed on the map."
"DOTA_BroadcastFact_AbilityMovie_enchantress_untouchable"	"Lassítja az ellenségeket, akik megtámadják őt."
"[english]DOTA_BroadcastFact_AbilityMovie_enchantress_untouchable"	"Slows enemies who attack her."
"DOTA_BroadcastFact_AbilityMovie_enchantress_impetus"	"A támadások a célponthoz képesti távolság növekedtével egyre többet sebeznek."
"[english]DOTA_BroadcastFact_AbilityMovie_enchantress_impetus"	"Attacks deal more damage as the distance to target increases."
"DOTA_BroadcastFact_AbilityMovie_kunkka_ghost_ship"	"Megidéz egy hajót, ami sebzi és bénítja az ellenségeket egy területen."
"[english]DOTA_BroadcastFact_AbilityMovie_kunkka_ghost_ship"	"Summons a ship that damages and stuns enemies in an area."
"DOTA_BroadcastFact_AbilityMovie_lich_frost_armor"	"Létrehoz egy pajzsot, ami páncélt ad egy szövetségesnek."
"[english]DOTA_BroadcastFact_AbilityMovie_lich_frost_armor"	"Creates a shield that adds armor to an ally."
"DOTA_BroadcastFact_AbilityMovie_lion_earth_spike"	"Egyenes vonalban bénít egy vagy több egységet."
"[english]DOTA_BroadcastFact_AbilityMovie_lion_earth_spike"	"Stuns one or more enemies in a line."
"DOTA_BroadcastFact_AbilityMovie_lone_druid_summon_spirit_bear"	"Megidéz egy <ac>Spirit Bear</ac>t, ami használhat tárgyakat."
"[english]DOTA_BroadcastFact_AbilityMovie_lone_druid_summon_spirit_bear"	"Summons a <ac>Spirit Bear</ac> that can equip items and attack enemies."
"DOTA_BroadcastFact_AbilityMovie_luna_lunar_blessing"	"Megnöveli <hc>Luna</hc> és szövetségesei támadási sebzését."
"[english]DOTA_BroadcastFact_AbilityMovie_luna_lunar_blessing"	"Increases attack damage of <hc>Luna</hc> and her allies."
"DOTA_BroadcastFact_AbilityMovie_lycan_summon_wolves"	"Megidéz két farkast, hogy <hc>Lycan</hc>ért harcoljanak."
"[english]DOTA_BroadcastFact_AbilityMovie_lycan_summon_wolves"	"Summons two wolves to fight for <hc>Lycan</hc>."
"DOTA_BroadcastFact_AbilityMovie_meepo_poof"	"Egymáshoz teleportálja a <hc>Meepo</hc>kat. Területi sebzést okoz."
"[english]DOTA_BroadcastFact_AbilityMovie_meepo_poof"	"Teleports <hc>Meepos</hc> to each other. Deals area damage."
"DOTA_BroadcastFact_AbilityMovie_meepo_divided_we_stand"	"<hc>Meepo</hc> megidéz egy másolatot magából, ami tud aranyat és TP-t szerezni."
"[english]DOTA_BroadcastFact_AbilityMovie_meepo_divided_we_stand"	"<hc>Meepo</hc> summons a duplicate of himself which can gain gold and XP."
"DOTA_BroadcastFact_AbilityMovie_monkey_king_jingu_mastery"	"Négy találat ugyanazon a hősön sebzést és életlopást ad."
"[english]DOTA_BroadcastFact_AbilityMovie_monkey_king_jingu_mastery"	"Four hits to the same hero grants damage and lifesteal."
"DOTA_BroadcastFact_AbilityMovie_morphling_waveform"	"<hc>Morphling</hc> előreáramlik, ellenfeleket sebezve."
"[english]DOTA_BroadcastFact_AbilityMovie_morphling_waveform"	"<hc>Morphling</hc> surges forward, damaging enemies."
"DOTA_BroadcastFact_AbilityMovie_nature's_prophet_teleportation"	"A pálya bármelyik pontjára teleportál."
"[english]DOTA_BroadcastFact_AbilityMovie_nature's_prophet_teleportation"	"Teleports to any point on the map."
"DOTA_BroadcastFact_AbilityMovie_nyx_assassin_impale"	"Egyenes vonalban bénít ellenségeket."
"[english]DOTA_BroadcastFact_AbilityMovie_nyx_assassin_impale"	"Stuns enemies in a line."
"DOTA_BroadcastFact_AbilityMovie_phantom_assassin_stifling_dagger"	"Eldob egy tőrt, sebezve és lassítva a célpontot."
"[english]DOTA_BroadcastFact_AbilityMovie_phantom_assassin_stifling_dagger"	"Throws a dagger, damaging and slowing target."
"DOTA_BroadcastFact_AbilityMovie_queen_of_pain_blink"	"Egy közeli helyre teleportál."
"[english]DOTA_BroadcastFact_AbilityMovie_queen_of_pain_blink"	"Teleports to a nearby spot."
"DOTA_BroadcastFact_AbilityMovie_rubick_telekinesis"	"Felemel és leejt egy ellenséget, bénítva azt."
"[english]DOTA_BroadcastFact_AbilityMovie_rubick_telekinesis"	"Lifts and drops an enemy, stunning it."
"DOTA_BroadcastFact_AbilityMovie_shadow_demon_demonic_purge"	"Sebez, lassít, és eltávolítja az erősítéseket egy célpontról."
"[english]DOTA_BroadcastFact_AbilityMovie_shadow_demon_demonic_purge"	"Damages, slows, and removes buffs from a target."
"DOTA_BroadcastFact_AbilityMovie_terrorblade_reflection"	"Sötét másolatot hoz létre egy ellenséges hősből."
"[english]DOTA_BroadcastFact_AbilityMovie_terrorblade_reflection"	"Creates a dark copy of an enemy hero."
"DOTA_BroadcastFact_AbilityMovie_tidehunter_gush"	"Sebez, lassít és csökkenti az ellenség páncélját."
"[english]DOTA_BroadcastFact_AbilityMovie_tidehunter_gush"	"Damages, slows, and reduces enemy armor."
"DOTA_BroadcastFact_AbilityMovie_tidehunter_kraken_shell"	"Kivédi a fizikai sebzést és eltávolítja a gyengítéseket."
"[english]DOTA_BroadcastFact_AbilityMovie_tidehunter_kraken_shell"	"Blocks physical damage and removes debuffs."
"DOTA_BroadcastFact_AbilityMovie_treant_protector_nature's_guise"	"Treant láthatatlanná válik fák közelében."
"[english]DOTA_BroadcastFact_AbilityMovie_treant_protector_nature's_guise"	"Treant turns invisible when near trees."
"DOTA_BroadcastFact_AbilityMovie_viper_corrosive_skin"	"Sebzi és lassítja a <hc>Vipert</hc> támadó ellenségeket."
"[english]DOTA_BroadcastFact_AbilityMovie_viper_corrosive_skin"	"Damages and slows enemies that attack <hc>Viper</hc>."
"DOTA_BroadcastFact_AbilityMovie_warlock_shadow_word"	"Időarányosan gyógyít egy baráti egységet, vagy sebez egy ellenséget."
"[english]DOTA_BroadcastFact_AbilityMovie_warlock_shadow_word"	"Heal a friendly unit or damage an enemy over time."
"DOTA_BroadcastFact_AbilityMovie_weaver_the_swarm"	"Bogarakat bocsát ki, amelyek lassítják és sebzik az ellenségeket."
"[english]DOTA_BroadcastFact_AbilityMovie_weaver_the_swarm"	"Releases bugs that hurt enemies and reduce armor."
"DOTA_BroadcastFact_AbilityMovie_windranger_powershot"	"Kilő egy nyilat, ami egyenes vonalban sebzi az ellenségeket."
"[english]DOTA_BroadcastFact_AbilityMovie_windranger_powershot"	"Fire an arrow that damages enemies in a line."
"DOTA_BroadcastFact_AbilityMovie_winter_wyvern_winter's_curse"	"Lefagyaszt egy ellenséget, a közeli ellenségeket támadásra kényszerítve."
"[english]DOTA_BroadcastFact_AbilityMovie_winter_wyvern_winter's_curse"	"Freezes an enemy, forcing nearby enemy teammates to attack."
"DOTA_BroadcastFact_AbilityMovie_witch_doctor_paralyzing_cask"	"Ellenségek között pattog, bénítva őket."
"[english]DOTA_BroadcastFact_AbilityMovie_witch_doctor_paralyzing_cask"	"Bounces between enemies, stunning them."
"DOTA_BroadcastFact_AbilityMovie_witch_doctor_voodoo_restoration"	"Gyógyítja a közeli szövetségeseket."
"[english]DOTA_BroadcastFact_AbilityMovie_witch_doctor_voodoo_restoration"	"Heals nearby allies."
"DOTA_BroadcastFact_AbilityMovie_wraith_king_reincarnation"	"Halála után feltámasztja <hc>Wraith King</hc>et, lassítva a közeli egységeket."
"[english]DOTA_BroadcastFact_AbilityMovie_wraith_king_reincarnation"	"Resurrects <hc>Wraith King</hc> upon death, slowing nearby units."
}
}
