"hero_chat_wheel"
{
"dota_chatwheel_message_antimage_laugh"	"Ha ha ha ha ha ha ha ha ha ha ha ha!"
"[english]dota_chatwheel_message_antimage_laugh"	"Ha ha ha ha ha ha ha ha ha ha ha ha!"
"dota_chatwheel_message_axe_laugh"	"Ha ha ha ha ha ha!"
"[english]dota_chatwheel_message_axe_laugh"	"Ha ha ha ha ha ha!"
"dota_chatwheel_message_bane_laugh"	"Ha ha ha ha ha ha ha ha ha!"
"[english]dota_chatwheel_message_bane_laugh"	"Ha ha ha ha ha ha ha ha ha!"
"dota_chatwheel_message_bloodseeker_laugh"	"Hmm-heh-heh-heh-heh-ha!"
"[english]dota_chatwheel_message_bloodseeker_laugh"	"Hmm-heh-heh-heh-heh-ha!"
"dota_chatwheel_message_crystal_maiden_laugh"	"Ah ha ha ha ha ha."
"[english]dota_chatwheel_message_crystal_maiden_laugh"	"Ah ha ha ha ha ha."
"dota_chatwheel_message_drow_ranger_laugh"	"Ah ha ha ha ha ha ha ha ha ha ha ha ha ha!"
"[english]dota_chatwheel_message_drow_ranger_laugh"	"Ah ha ha ha ha ha ha ha ha ha ha ha ha ha!"
"dota_chatwheel_message_juggernaut_laugh"	"Ha ha ha ha ha!"
"[english]dota_chatwheel_message_juggernaut_laugh"	"Ha ha ha ha ha!"
"dota_chatwheel_message_mirana_laugh"	"Ha ha ha ha ha ha!"
"[english]dota_chatwheel_message_mirana_laugh"	"Ha ha ha ha ha ha!"
"dota_chatwheel_message_morphling_laugh"	"Ha ha ha ha ha ha ha ha ha ha!"
"[english]dota_chatwheel_message_morphling_laugh"	"Ha ha ha ha ha ha ha ha ha ha!"
"dota_chatwheel_message_nevermore_laugh"	"Ah ha ha ha ha ha!"
"[english]dota_chatwheel_message_nevermore_laugh"	"Ah ha ha ha ha ha!"
"dota_chatwheel_message_phantom_lancer_laugh"	"Ha ha ha ha ha ha ha ha ha ha ha ha ha!"
"[english]dota_chatwheel_message_phantom_lancer_laugh"	"Ha ha ha ha ha ha ha ha ha ha ha ha ha!"
"dota_chatwheel_message_puck_laugh"	"Ha ha!"
"[english]dota_chatwheel_message_puck_laugh"	"Ha ha!"
"dota_chatwheel_message_sand_king_laugh"	"Ha ha ha ha ha ha ha!"
"[english]dota_chatwheel_message_sand_king_laugh"	"Ha ha ha ha ha ha ha!"
"dota_chatwheel_message_sven_laugh"	"Ahh ha ha ha! Ha ha ha ha!"
"[english]dota_chatwheel_message_sven_laugh"	"Ahh ha ha ha! Ha ha ha ha!"
"dota_chatwheel_message_tiny_laugh"	"Hehehehehuhhehehe."
"[english]dota_chatwheel_message_tiny_laugh"	"Hehehehehuhhehehe."
"dota_chatwheel_message_vengefulspirit_laugh"	"Hm ha ha ha ha ha ha!"
"[english]dota_chatwheel_message_vengefulspirit_laugh"	"Hm ha ha ha ha ha ha!"
"dota_chatwheel_message_zuus_laugh"	"Ha ha ha ha ha ha ha ha ha!"
"[english]dota_chatwheel_message_zuus_laugh"	"Ha ha ha ha ha ha ha ha ha!"
"dota_chatwheel_message_lina_laugh"	"Ha ha ha ha ha ha ha!"
"[english]dota_chatwheel_message_lina_laugh"	"Ha ha ha ha ha ha ha!"
"dota_chatwheel_message_lion_laugh"	"Who-ha-ha-ha-ha-ha-ha-he-hawha!"
"[english]dota_chatwheel_message_lion_laugh"	"Who-ha-ha-ha-ha-ha-ha-he-hawha!"
"dota_chatwheel_message_shadow_shaman_laugh"	"Ha ha ha!"
"[english]dota_chatwheel_message_shadow_shaman_laugh"	"Ha ha ha!"
"dota_chatwheel_message_tidehunter_laugh"	"Ah ha ha ha!"
"[english]dota_chatwheel_message_tidehunter_laugh"	"Ah ha ha ha!"
"dota_chatwheel_message_witch_doctor_laugh"	"Hoo hah hoo hoo hah."
"[english]dota_chatwheel_message_witch_doctor_laugh"	"Hoo hah hoo hoo hah."
"dota_chatwheel_message_lich_laugh"	"Ha ha ha ha ha ha ha ha!"
"[english]dota_chatwheel_message_lich_laugh"	"Ha ha ha ha ha ha ha ha!"
"dota_chatwheel_message_tinker_laugh"	"Ah ha ha ha ha!"
"[english]dota_chatwheel_message_tinker_laugh"	"Ah ha ha ha ha!"
"dota_chatwheel_message_necrolyte_laugh"	"Ha ha ha ha ha ha ha ha ha ha ha ha!"
"[english]dota_chatwheel_message_necrolyte_laugh"	"Ha ha ha ha ha ha ha ha ha ha ha ha!"
"dota_chatwheel_message_warlock_laugh"	"Ho ha ha ha ha ha ha ha ha!"
"[english]dota_chatwheel_message_warlock_laugh"	"Ho ha ha ha ha ha ha ha ha!"
"dota_chatwheel_message_queenofpain_laugh"	"Uh ha ha ha ha ha ha ha ha ha ha ha!"
"[english]dota_chatwheel_message_queenofpain_laugh"	"Uh ha ha ha ha ha ha ha ha ha ha ha!"
"dota_chatwheel_message_skeleton_king_laugh"	"AH HA HA HA HA!"
"[english]dota_chatwheel_message_skeleton_king_laugh"	"AH HA HA HA HA!"
"dota_chatwheel_label_skeleton_king_laugh"	"AH HA HA HA HA!"
"[english]dota_chatwheel_label_skeleton_king_laugh"	"AH HA HA HA HA!"
"dota_chatwheel_message_death_prophet_laugh"	"Oh ah ha ha ha ha ha ho ho haa! Ha ha ha ha ha ha!"
"[english]dota_chatwheel_message_death_prophet_laugh"	"Oh ah ha ha ha ha ha ho ho haa! Ha ha ha ha ha ha!"
"dota_chatwheel_message_pugna_laugh"	"Ha ha ha ha ha ha."
"[english]dota_chatwheel_message_pugna_laugh"	"Ha ha ha ha ha ha."
"dota_chatwheel_message_templar_assassin_laugh"	"Ha ha ha ha ha ha ha!"
"[english]dota_chatwheel_message_templar_assassin_laugh"	"Ha ha ha ha ha ha ha!"
"dota_chatwheel_message_viper_laugh"	"Tehehehehar."
"[english]dota_chatwheel_message_viper_laugh"	"Tehehehehar."
"dota_chatwheel_message_luna_laugh"	"Ah ha ha ha ha ha ha!"
"[english]dota_chatwheel_message_luna_laugh"	"Ah ha ha ha ha ha ha!"
"dota_chatwheel_message_dazzle_laugh"	"Ha ha har ha ha ha!"
"[english]dota_chatwheel_message_dazzle_laugh"	"Ha ha har ha ha ha!"
"dota_chatwheel_message_rattletrap_laugh"	"Ha ha ha ha ha ha!"
"[english]dota_chatwheel_message_rattletrap_laugh"	"Ha ha ha ha ha ha!"
"dota_chatwheel_message_leshrac_laugh"	"Ha ha ha ha ha ha ha!"
"[english]dota_chatwheel_message_leshrac_laugh"	"Ha ha ha ha ha ha ha!"
"dota_chatwheel_message_furion_laugh"	"Ma ha ha ha ha ha ha ha ha ha!"
"[english]dota_chatwheel_message_furion_laugh"	"Ma ha ha ha ha ha ha ha ha ha!"
"dota_chatwheel_message_enchantress_laugh"	"Ha ha ha ha ha ha ha!"
"[english]dota_chatwheel_message_enchantress_laugh"	"Ha ha ha ha ha ha ha!"
"dota_chatwheel_message_enchantress_2"	"Hilarisch."
"[english]dota_chatwheel_message_enchantress_2"	"Hilarious."
"dota_chatwheel_label_enchantress_2"	"Hilarisch."
"[english]dota_chatwheel_label_enchantress_2"	"Hilarious."
"dota_chatwheel_message_jakiro_laugh"	"Ha ha ha ha ha ha ha ha ha ha ha!"
"[english]dota_chatwheel_message_jakiro_laugh"	"Ha ha ha ha ha ha ha ha ha ha ha!"
"dota_chatwheel_message_spectre_laugh"	"Ha ha ha ha ha ha ha ha ha ha ha ha ha ha ha ha ha ha ha ha!"
"[english]dota_chatwheel_message_spectre_laugh"	"Ha ha ha ha ha ha ha ha ha ha ha ha ha ha ha ha ha ha ha ha!"
"dota_chatwheel_message_ancient_apparition_laugh"	"Hm hm hm ha ha ha ha ha ha ha!"
"[english]dota_chatwheel_message_ancient_apparition_laugh"	"Hm hm hm ha ha ha ha ha ha ha!"
"dota_chatwheel_message_alchemist_laugh"	"Ha ha ha ha ha!"
"[english]dota_chatwheel_message_alchemist_laugh"	"Ha ha ha ha ha!"
"dota_chatwheel_message_invoker_laugh"	"Ha ha ha ha ha ha ha ha ha ha!"
"[english]dota_chatwheel_message_invoker_laugh"	"Ha ha ha ha ha ha ha ha ha ha!"
"dota_chatwheel_message_obsidian_destroyer_laugh"	"Ha ha ha ha ha ha ha ha ha!"
"[english]dota_chatwheel_message_obsidian_destroyer_laugh"	"Ha ha ha ha ha ha ha ha ha!"
"dota_chatwheel_message_chaos_knight_laugh"	"Oo ho ho ha ha ha ha ha ha ha ha ha ha ha!"
"[english]dota_chatwheel_message_chaos_knight_laugh"	"Oo ho ho ha ha ha ha ha ha ha ha ha ha ha!"
"dota_chatwheel_message_ogre_magi_2"	"Goed werk. Ik dacht dat jij dat was."
"[english]dota_chatwheel_message_ogre_magi_2"	"Good work. I thought that was you."
"dota_chatwheel_label_ogre_magi_2"	"Goed werk!"
"[english]dota_chatwheel_label_ogre_magi_2"	"Good work!"
"dota_chatwheel_message_ogre_magi_3"	"Je moet aan je vaardigheden werken. Net als wij."
"[english]dota_chatwheel_message_ogre_magi_3"	"You need to work on your skill. Like us."
"dota_chatwheel_label_ogre_magi_3"	"Je moet aan je vaardigheden werken."
"[english]dota_chatwheel_label_ogre_magi_3"	"You need to work on your skill."
"dota_chatwheel_message_ogre_magi_4"	"We hebben je een voorsprong gegeven!"
"[english]dota_chatwheel_message_ogre_magi_4"	"We gave you a head start!"
"dota_chatwheel_label_ogre_magi_4"	"We hebben je een voorsprong gegeven!"
"[english]dota_chatwheel_label_ogre_magi_4"	"We gave you a head start!"
"dota_chatwheel_label_ogre_magi_5"	"Dat deed vast pijn."
"[english]dota_chatwheel_label_ogre_magi_5"	"That had to hurt."
"dota_chatwheel_message_undying_laugh"	"Heh heh heh heh ha ha ha ha ha ha ha ha ha ha!"
"[english]dota_chatwheel_message_undying_laugh"	"Heh heh heh heh ha ha ha ha ha ha ha ha ha ha!"
"dota_chatwheel_label_undying_laugh"	"Lachen"
"[english]dota_chatwheel_label_undying_laugh"	"Laugh"
"dota_chatwheel_message_undying_deny"	"De maden zullen je schoonmaken."
"[english]dota_chatwheel_message_undying_deny"	"The maggots clean you."
"dota_chatwheel_label_undying_deny"	"De maden zullen je schoonmaken."
"[english]dota_chatwheel_label_undying_deny"	"The maggots clean you."
"dota_chatwheel_message_undying_1"	"Ik haat het leven."
"[english]dota_chatwheel_message_undying_1"	"I hate life."
"dota_chatwheel_label_undying_1"	"Ik haat het leven"
"[english]dota_chatwheel_label_undying_1"	"I hate life"
"dota_chatwheel_message_undying_2"	"Nu snap ik het."
"[english]dota_chatwheel_message_undying_2"	"Now I get it."
"dota_chatwheel_label_undying_2"	"Nu snap ik het"
"[english]dota_chatwheel_label_undying_2"	"Now I get it"
"dota_chatwheel_message_undying_3"	"Geen hel. Geen hemel. Alleen dit."
"[english]dota_chatwheel_message_undying_3"	"No hells. No heavens. Only this."
"dota_chatwheel_label_undying_3"	"Alleen dit."
"[english]dota_chatwheel_label_undying_3"	"Only this."
"dota_chatwheel_message_undying_4"	"Niet feeden."
"[english]dota_chatwheel_message_undying_4"	"Not feed."
"dota_chatwheel_label_undying_4"	"Niet feeden"
"[english]dota_chatwheel_label_undying_4"	"Not feed"
"dota_chatwheel_message_undying_5"	"Geen hersens."
"[english]dota_chatwheel_message_undying_5"	"No brains."
"dota_chatwheel_label_undying_5"	"Geen hersens."
"[english]dota_chatwheel_label_undying_5"	"No brains."
"dota_chatwheel_message_rubick_laugh"	"Ah ha ha! Eh he he he he he he he he he!"
"[english]dota_chatwheel_message_rubick_laugh"	"Ah ha ha! Eh he he he he he he he he he!"
"dota_chatwheel_label_rubick_laugh"	"Lachen"
"[english]dota_chatwheel_label_rubick_laugh"	"Laugh"
"dota_chatwheel_message_rubick_thank"	"Uitstekend idee!"
"[english]dota_chatwheel_message_rubick_thank"	"Excellent idea!"
"dota_chatwheel_label_rubick_thank"	"Uitstekend idee!"
"[english]dota_chatwheel_label_rubick_thank"	"Excellent idea!"
"dota_chatwheel_message_rubick_deny"	"Ik voel me bijna slecht."
"[english]dota_chatwheel_message_rubick_deny"	"I almost feel bad."
"dota_chatwheel_label_rubick_deny"	"Ik voel me bijna slecht."
"[english]dota_chatwheel_label_rubick_deny"	"I almost feel bad."
"dota_chatwheel_message_rubick_1"	"Dat deed me goed!"
"[english]dota_chatwheel_message_rubick_1"	"That perked me up a bit!"
"dota_chatwheel_label_rubick_1"	"Dat deed me goed!"
"[english]dota_chatwheel_label_rubick_1"	"That perked me up!"
"dota_chatwheel_message_rubick_2"	"Je naam beledigt me."
"[english]dota_chatwheel_message_rubick_2"	"Your name offends me."
"dota_chatwheel_label_rubick_2"	"Je naam beledigt me."
"[english]dota_chatwheel_label_rubick_2"	"Your name offends me."
"dota_chatwheel_message_rubick_3"	"Wat een verrassing!"
"[english]dota_chatwheel_message_rubick_3"	"What a surprise!"
"dota_chatwheel_label_rubick_3"	"Wat een verrassing!"
"[english]dota_chatwheel_label_rubick_3"	"What a surprise!"
"dota_chatwheel_message_rubick_4"	"Oeps!"
"[english]dota_chatwheel_message_rubick_4"	"Whoops!"
"dota_chatwheel_label_rubick_4"	"Oeps!"
"[english]dota_chatwheel_label_rubick_4"	"Whoops!"
"dota_chatwheel_message_rubick_5"	"Voortreffelijk! Absoluut voortreffelijk!"
"[english]dota_chatwheel_message_rubick_5"	"Exquisite! Absolutely exquisite!"
"dota_chatwheel_label_rubick_5"	"Voortreffelijk!"
"[english]dota_chatwheel_label_rubick_5"	"Exquisite!"
"dota_chatwheel_message_disruptor_laugh"	"Heheha."
"[english]dota_chatwheel_message_disruptor_laugh"	"Heheha."
"dota_chatwheel_label_disruptor_laugh"	"Lachen"
"[english]dota_chatwheel_label_disruptor_laugh"	"Laugh"
"dota_chatwheel_message_disruptor_thank"	"Dat lijkt er meer op."
"[english]dota_chatwheel_message_disruptor_thank"	"Now that's more like it."
"dota_chatwheel_label_disruptor_thank"	"Dat lijkt er meer op!"
"[english]dota_chatwheel_label_disruptor_thank"	"Now that's more like it!"
"dota_chatwheel_message_disruptor_deny"	"Ik ben extatisch!"
"[english]dota_chatwheel_message_disruptor_deny"	"I'm ecstatic!"
"dota_chatwheel_label_disruptor_deny"	"Ik ben extatisch!"
"[english]dota_chatwheel_label_disruptor_deny"	"I'm ecstatic!"
"dota_chatwheel_message_disruptor_1"	"Wat voor weertovenarij is dit?"
"[english]dota_chatwheel_message_disruptor_1"	"What weathermancery is this?"
"dota_chatwheel_label_disruptor_1"	"Wat voor weertovenarij is dit?"
"[english]dota_chatwheel_label_disruptor_1"	"What weathermancery is this?"
"dota_chatwheel_message_disruptor_2"	"Je bent verstoord."
"[english]dota_chatwheel_message_disruptor_2"	"You've been disrupted."
"dota_chatwheel_label_disruptor_2"	"Verstoord"
"[english]dota_chatwheel_label_disruptor_2"	"Disrupted"
"dota_chatwheel_message_disruptor_3"	"Ze proberen me te doden."
"[english]dota_chatwheel_message_disruptor_3"	"They're trying to kill me."
"dota_chatwheel_label_disruptor_3"	"Ze proberen me te doden!"
"[english]dota_chatwheel_label_disruptor_3"	"They're trying to kill me!"
"dota_chatwheel_message_disruptor_4"	"Heb ik je onderbroken?"
"[english]dota_chatwheel_message_disruptor_4"	"Did I interrupt you?"
"dota_chatwheel_label_disruptor_4"	"Onderbroken"
"[english]dota_chatwheel_label_disruptor_4"	"Interrupt"
"dota_chatwheel_message_disruptor_5"	"Nou, kijk eens aan."
"[english]dota_chatwheel_message_disruptor_5"	"Well, look at that."
"dota_chatwheel_label_disruptor_5"	"Kijk eens aan"
"[english]dota_chatwheel_label_disruptor_5"	"Look at that"
"dota_chatwheel_message_nyx_assassin_laugh"	"Heehehheh Nyx, Nyx."
"[english]dota_chatwheel_message_nyx_assassin_laugh"	"Heehehheh Nyx, Nyx."
"dota_chatwheel_label_nyx_assassin_laugh"	"Lachen"
"[english]dota_chatwheel_label_nyx_assassin_laugh"	"Laugh"
"dota_chatwheel_message_nyx_assassin_thank"	"Mooi."
"[english]dota_chatwheel_message_nyx_assassin_thank"	"Nice."
"dota_chatwheel_label_nyx_assassin_thank"	"Mooi."
"[english]dota_chatwheel_label_nyx_assassin_thank"	"Nice."
"dota_chatwheel_message_nyx_assassin_deny"	"Hoe is dit gebeurd?"
"[english]dota_chatwheel_message_nyx_assassin_deny"	"How did this happen?"
"dota_chatwheel_label_nyx_assassin_deny"	"Hoe is dit gebeurd?"
"[english]dota_chatwheel_label_nyx_assassin_deny"	"How did this happen?"
"dota_chatwheel_message_nyx_assassin_1"	"Talentloos."
"[english]dota_chatwheel_message_nyx_assassin_1"	"Talentless."
"dota_chatwheel_label_nyx_assassin_1"	"Talentloos"
"[english]dota_chatwheel_label_nyx_assassin_1"	"Talentless"
"dota_chatwheel_message_nyx_assassin_2"	"Nyx chichcichcihcihchi."
"[english]dota_chatwheel_message_nyx_assassin_2"	"Nyx chichcichcihcihchi."
"dota_chatwheel_label_nyx_assassin_2"	"Nyx chichcichcihcihchi."
"[english]dota_chatwheel_label_nyx_assassin_2"	"Nyx chichcichcihcihchi."
"dota_chatwheel_message_nyx_assassin_3"	"Ik wacht op je."
"[english]dota_chatwheel_message_nyx_assassin_3"	"I'm waiting for you."
"dota_chatwheel_label_nyx_assassin_3"	"Ik wacht op je."
"[english]dota_chatwheel_label_nyx_assassin_3"	"I'm waiting for you.	"
"dota_chatwheel_message_nyx_assassin_4"	"Vermoord."
"[english]dota_chatwheel_message_nyx_assassin_4"	"Assassinated."
"dota_chatwheel_label_nyx_assassin_4"	"Vermoord."
"[english]dota_chatwheel_label_nyx_assassin_4"	"Assassinated."
"dota_chatwheel_message_nyx_assassin_5"	"Nyx, Nyx, Nyx, Nyx."
"[english]dota_chatwheel_message_nyx_assassin_5"	"Nyx, Nyx, Nyx, Nyx."
"dota_chatwheel_label_nyx_assassin_5"	"Nyx, Nyx, Nyx, Nyx."
"[english]dota_chatwheel_label_nyx_assassin_5"	"Nyx, Nyx, Nyx, Nyx."
"dota_chatwheel_message_naga_siren_laugh"	"Ahehehaheh."
"[english]dota_chatwheel_message_naga_siren_laugh"	"Ahehehaheh."
"dota_chatwheel_label_naga_siren_laugh"	"Lachen"
"[english]dota_chatwheel_label_naga_siren_laugh"	"Laugh"
"dota_chatwheel_message_naga_siren_thank"	"Alles loopt gesmeerd."
"[english]dota_chatwheel_message_naga_siren_thank"	"That went swimmingly."
"dota_chatwheel_label_naga_siren_thank"	"Alles loopt gesmeerd."
"[english]dota_chatwheel_label_naga_siren_thank"	"That went swimmingly."
"dota_chatwheel_message_naga_siren_deny"	"Een triest einde."
"[english]dota_chatwheel_message_naga_siren_deny"	"A sour note."
"dota_chatwheel_label_naga_siren_deny"	"Een triest einde."
"[english]dota_chatwheel_label_naga_siren_deny"	"A sour note."
"dota_chatwheel_message_naga_siren_1"	"Je zit er nu diep in."
"[english]dota_chatwheel_message_naga_siren_1"	"You're in deep now."
"dota_chatwheel_label_naga_siren_1"	"Je zit er nu diep in."
"[english]dota_chatwheel_label_naga_siren_1"	"You're in deep now."
"dota_chatwheel_message_naga_siren_2"	"Zo is het wel genoeg."
"[english]dota_chatwheel_message_naga_siren_2"	"That's enough out of you."
"dota_chatwheel_label_naga_siren_2"	"Zo is het wel genoeg."
"[english]dota_chatwheel_label_naga_siren_2"	"That's enough out of you."
"dota_chatwheel_message_naga_siren_3"	"Dat moet vervelend zijn."
"[english]dota_chatwheel_message_naga_siren_3"	"That's got to suck."
"dota_chatwheel_label_naga_siren_3"	"Dat moet vervelend zijn."
"[english]dota_chatwheel_label_naga_siren_3"	"That's got to suck."
"dota_chatwheel_message_naga_siren_4"	"Het kon ook niet anders."
"[english]dota_chatwheel_message_naga_siren_4"	"It had to be."
"dota_chatwheel_label_naga_siren_4"	"Het kon ook niet anders."
"[english]dota_chatwheel_label_naga_siren_4"	"It had to be."
"dota_chatwheel_message_naga_siren_5"	"Mijn benen! Ik voel mijn benen niet."
"[english]dota_chatwheel_message_naga_siren_5"	"My legs! I can't feel my legs."
"dota_chatwheel_label_naga_siren_5"	"Mijn benen!"
"[english]dota_chatwheel_label_naga_siren_5"	"My legs!"
"dota_chatwheel_message_keeper_of_the_light_laugh"	"Eh hee hee hee hee hee."
"[english]dota_chatwheel_message_keeper_of_the_light_laugh"	"Eh hee hee hee hee hee."
"dota_chatwheel_label_keeper_of_the_light_laugh"	"Lachen"
"[english]dota_chatwheel_label_keeper_of_the_light_laugh"	"Laugh"
"dota_chatwheel_message_keeper_of_the_light_deny"	"Geen mana."
"[english]dota_chatwheel_message_keeper_of_the_light_deny"	"No mana."
"dota_chatwheel_label_keeper_of_the_light_deny"	"Geen mana!"
"[english]dota_chatwheel_label_keeper_of_the_light_deny"	"No mana!"
"dota_chatwheel_message_keeper_of_the_light_1"	"Echt, je had dat moeten zien aankomen."
"[english]dota_chatwheel_message_keeper_of_the_light_1"	"Really now, you should have seen that coming."
"dota_chatwheel_label_keeper_of_the_light_1"	"Had dat moeten zien aankomen!"
"[english]dota_chatwheel_label_keeper_of_the_light_1"	"Should have seen that coming!"
"dota_chatwheel_message_keeper_of_the_light_3"	"Mijn paard zegt nee, dus ik ook."
"[english]dota_chatwheel_message_keeper_of_the_light_3"	"My horse says nay and so do I."
"dota_chatwheel_label_keeper_of_the_light_3"	"Mijn paard zegt nee, dus ik ook."
"[english]dota_chatwheel_label_keeper_of_the_light_3"	"My horse says nay and so do I."
"dota_chatwheel_message_keeper_of_the_light_4"	"Je licht gaat uit."
"[english]dota_chatwheel_message_keeper_of_the_light_4"	"Lights out for you."
"dota_chatwheel_label_keeper_of_the_light_4"	"Je licht gaat uit."
"[english]dota_chatwheel_label_keeper_of_the_light_4"	"Lights out for you."
"dota_chatwheel_message_keeper_of_the_light_5"	"Ah hah, ah ha ha, eh wat?"
"[english]dota_chatwheel_message_keeper_of_the_light_5"	"Ah hah, ah ha ha, eh what?"
"dota_chatwheel_label_keeper_of_the_light_5"	"Ah hah, ah ha ha, eh wat?"
"[english]dota_chatwheel_label_keeper_of_the_light_5"	"Ah hah, ah ha ha, eh what?"
"dota_chatwheel_message_wisp_laugh"	"Lachende biepjes"
"[english]dota_chatwheel_message_wisp_laugh"	"Laughing Beeps"
"dota_chatwheel_label_wisp_laugh"	"Lachende biepjes"
"[english]dota_chatwheel_label_wisp_laugh"	"Laughing Beeps"
"dota_chatwheel_message_wisp_thank"	"Dankbare biepjes"
"[english]dota_chatwheel_message_wisp_thank"	"Thankful Beeps"
"dota_chatwheel_label_wisp_thank"	"Dankbare biepjes"
"[english]dota_chatwheel_label_wisp_thank"	"Thankful Beeps"
"dota_chatwheel_message_wisp_deny"	"Afwijzende biepjes"
"[english]dota_chatwheel_message_wisp_deny"	"Denying Beeps"
"dota_chatwheel_label_wisp_deny"	"Afwijzende biepjes"
"[english]dota_chatwheel_label_wisp_deny"	"Denying Beeps"
"dota_chatwheel_message_wisp_1"	"Vriendelijke biepjes"
"[english]dota_chatwheel_message_wisp_1"	"Friendly Beeps"
"dota_chatwheel_label_wisp_1"	"Vriendelijke biepjes"
"[english]dota_chatwheel_label_wisp_1"	"Friendly Beeps"
"dota_chatwheel_message_wisp_2"	"Triomfantelijke biepjes"
"[english]dota_chatwheel_message_wisp_2"	"Triumphant Beeps"
"dota_chatwheel_label_wisp_2"	"Triomfantelijke biepjes"
"[english]dota_chatwheel_label_wisp_2"	"Triumphant Beeps"
"dota_chatwheel_message_wisp_3"	"Treurige biepjes"
"[english]dota_chatwheel_message_wisp_3"	"Sorrowful Beeps"
"dota_chatwheel_label_wisp_3"	"Treurige biepjes"
"[english]dota_chatwheel_label_wisp_3"	"Sorrowful Beeps"
"dota_chatwheel_message_wisp_4"	"Boze biepjes"
"[english]dota_chatwheel_message_wisp_4"	"Angry Beeps"
"dota_chatwheel_label_wisp_4"	"Boze biepjes"
"[english]dota_chatwheel_label_wisp_4"	"Angry Beeps"
"dota_chatwheel_message_wisp_5"	"Bedachte biepjes"
"[english]dota_chatwheel_message_wisp_5"	"Meditative Beeps"
"dota_chatwheel_label_wisp_5"	"Bedachte biepjes"
"[english]dota_chatwheel_label_wisp_5"	"Meditative Beeps"
"dota_chatwheel_message_visage_laugh"	"Ah ha ha ha ha ha ha ha ha!"
"[english]dota_chatwheel_message_visage_laugh"	"Ah ha ha ha ha ha ha ha ha!"
"dota_chatwheel_label_visage_laugh"	"Lachen"
"[english]dota_chatwheel_label_visage_laugh"	"Laugh"
"dota_chatwheel_message_visage_deny"	"Jij weer?"
"[english]dota_chatwheel_message_visage_deny"	"You again?"
"dota_chatwheel_label_visage_deny"	"Jij weer?"
"[english]dota_chatwheel_label_visage_deny"	"You again?"
"dota_chatwheel_message_visage_1"	"En dus sterf je."
"[english]dota_chatwheel_message_visage_1"	"And so you die."
"dota_chatwheel_label_visage_1"	"En dus sterf je."
"[english]dota_chatwheel_label_visage_1"	"And so you die."
"dota_chatwheel_message_visage_2"	"Ik heb gefaald."
"[english]dota_chatwheel_message_visage_2"	"I have failed."
"dota_chatwheel_label_visage_2"	"Ik heb gefaald."
"[english]dota_chatwheel_label_visage_2"	"I have failed."
"dota_chatwheel_message_visage_4"	"Gezicht van de dood."
"[english]dota_chatwheel_message_visage_4"	"Face of death."
"dota_chatwheel_label_visage_4"	"Ik ben het onverzettelijke gezicht van de dood!"
"[english]dota_chatwheel_label_visage_4"	"I am the unyielding face of death!"
"dota_chatwheel_message_medusa_laugh"	"Hmm hmm hmm ha ha ha ha ha!"
"[english]dota_chatwheel_message_medusa_laugh"	"Hmm hmm hmm ha ha ha ha ha!"
"dota_chatwheel_message_medusa_thank"	"Briljant."
"[english]dota_chatwheel_message_medusa_thank"	"Brilliant."
"dota_chatwheel_label_medusa_thank"	"Briljant."
"[english]dota_chatwheel_label_medusa_thank"	"Brilliant."
"dota_chatwheel_message_medusa_deny"	"Pak aan."
"[english]dota_chatwheel_message_medusa_deny"	"In your face."
"dota_chatwheel_label_medusa_deny"	"Pak aan."
"[english]dota_chatwheel_label_medusa_deny"	"In your face."
"dota_chatwheel_message_medusa_1"	"Verzet je niet tegen de cobra, kleine vogel."
"[english]dota_chatwheel_message_medusa_1"	"Don't resist the cobra, little bird."
"dota_chatwheel_label_medusa_1"	"Verzet je niet tegen de cobra"
"[english]dota_chatwheel_label_medusa_1"	"Don't resist the cobra"
"dota_chatwheel_message_medusa_2"	"O, shit!"
"[english]dota_chatwheel_message_medusa_2"	"Oh, crap!"
"dota_chatwheel_label_medusa_2"	"O, shit."
"[english]dota_chatwheel_label_medusa_2"	"Oh, crap."
"dota_chatwheel_message_medusa_3"	"Je wist dat ik koelbloedig was."
"[english]dota_chatwheel_message_medusa_3"	"You knew I was cold-blooded."
"dota_chatwheel_label_medusa_3"	"Je wist dat ik koelbloedig was."
"[english]dota_chatwheel_label_medusa_3"	"You knew I was cold-blooded."
"dota_chatwheel_message_medusa_4"	"De slang slaat terug."
"[english]dota_chatwheel_message_medusa_4"	"The snake strikes back."
"dota_chatwheel_label_medusa_4"	"De slang slaat terug."
"[english]dota_chatwheel_label_medusa_4"	"The snake strikes back."
"dota_chatwheel_message_medusa_5"	"Niemand kijkt naar niemand!"
"[english]dota_chatwheel_message_medusa_5"	"Nobody look at anybody!"
"dota_chatwheel_label_medusa_5"	"Niemand kijkt naar niemand!"
"[english]dota_chatwheel_label_medusa_5"	"Nobody look at anybody!"
"dota_chatwheel_message_troll_warlord_laugh"	"Yaaahahahaahhah."
"[english]dota_chatwheel_message_troll_warlord_laugh"	"Yaaahahahaahhah."
"dota_chatwheel_label_troll_warlord_laugh"	"Lachen"
"[english]dota_chatwheel_label_troll_warlord_laugh"	"Laugh"
"dota_chatwheel_message_troll_warlord_thank"	"Ga los!"
"[english]dota_chatwheel_message_troll_warlord_thank"	"Go crazy!"
"dota_chatwheel_label_troll_warlord_thank"	"Ga los!"
"[english]dota_chatwheel_label_troll_warlord_thank"	"Go crazy!"
"dota_chatwheel_message_troll_warlord_deny"	"Onfortuinlijk."
"[english]dota_chatwheel_message_troll_warlord_deny"	"Unfortunate."
"dota_chatwheel_label_troll_warlord_deny"	"Onfortuinlijk."
"[english]dota_chatwheel_label_troll_warlord_deny"	"Unfortunate."
"dota_chatwheel_message_troll_warlord_1"	"Kom terug en ga nog een keer dood."
"[english]dota_chatwheel_message_troll_warlord_1"	"Come back and die again."
"dota_chatwheel_label_troll_warlord_1"	"Kom terug..."
"[english]dota_chatwheel_label_troll_warlord_1"	"Come back..."
"dota_chatwheel_message_troll_warlord_2"	"Je maakt een grapje."
"[english]dota_chatwheel_message_troll_warlord_2"	"You've got to be kidding."
"dota_chatwheel_label_troll_warlord_2"	"Je maakt een grapje."
"[english]dota_chatwheel_label_troll_warlord_2"	"You've gotta be kidding."
"dota_chatwheel_message_troll_warlord_3"	"Probeer niet te feeden."
"[english]dota_chatwheel_message_troll_warlord_3"	"Try not to feed."
"dota_chatwheel_label_troll_warlord_3"	"Probeer niet te feeden."
"[english]dota_chatwheel_label_troll_warlord_3"	"Try not to feed."
"dota_chatwheel_message_troll_warlord_4"	"Dit kan niet waar zijn."
"[english]dota_chatwheel_message_troll_warlord_4"	"This can't be happening."
"dota_chatwheel_label_troll_warlord_4"	"Dit kan niet waar zijn."
"[english]dota_chatwheel_label_troll_warlord_4"	"This can't be happening."
"dota_chatwheel_message_troll_warlord_5"	"Waarom houdt niemand van me?"
"[english]dota_chatwheel_message_troll_warlord_5"	"Why doesn't anybody like me?"
"dota_chatwheel_label_troll_warlord_5"	"Waarom houdt niemand van me?"
"[english]dota_chatwheel_label_troll_warlord_5"	"Why doesn't anybody like me?"
"dota_chatwheel_message_centaur_laugh"	"Heheeeh hahah ehha."
"[english]dota_chatwheel_message_centaur_laugh"	"Heheeeh hahah ehha."
"dota_chatwheel_label_centaur_laugh"	"Lachen"
"[english]dota_chatwheel_label_centaur_laugh"	"Laugh"
"dota_chatwheel_message_centaur_thank"	"Ik zal je naam eren."
"[english]dota_chatwheel_message_centaur_thank"	"I shall honor your name."
"dota_chatwheel_label_centaur_thank"	"Ik zal je naam eren."
"[english]dota_chatwheel_label_centaur_thank"	"I shall honor your name."
"dota_chatwheel_message_centaur_1"	"Mmmmm."
"[english]dota_chatwheel_message_centaur_1"	"Mmmmm."
"dota_chatwheel_label_centaur_1"	"Mmmmmm."
"[english]dota_chatwheel_label_centaur_1"	"Mmmmmm."
"dota_chatwheel_message_centaur_2"	"Wat een verspilling."
"[english]dota_chatwheel_message_centaur_2"	"What a waste."
"dota_chatwheel_label_centaur_2"	"Wat een verspilling."
"[english]dota_chatwheel_label_centaur_2"	"What a waste."
"dota_chatwheel_message_centaur_3"	"Terug naar de hel met jou."
"[english]dota_chatwheel_message_centaur_3"	"Back to hell with you."
"dota_chatwheel_label_centaur_3"	"Terug naar de hel met jou."
"[english]dota_chatwheel_label_centaur_3"	"Back to hell with you."
"dota_chatwheel_message_centaur_4"	"Je had geen schijn van kans."
"[english]dota_chatwheel_message_centaur_4"	"You had no chance."
"dota_chatwheel_label_centaur_4"	"Je had geen schijn van kans."
"[english]dota_chatwheel_label_centaur_4"	"You had no chance."
"dota_chatwheel_message_centaur_5"	"Doet jou meer pijn dan mij."
"[english]dota_chatwheel_message_centaur_5"	"Hurts you more than it hurts me."
"dota_chatwheel_label_centaur_5"	"Doet jou meer pijn dan mij."
"[english]dota_chatwheel_label_centaur_5"	"Hurts you more than it hurts me."
"dota_chatwheel_message_magnataur_laugh"	"Ah ha ha."
"[english]dota_chatwheel_message_magnataur_laugh"	"Ah ha ha."
"dota_chatwheel_label_magnataur_laugh"	"Lachen"
"[english]dota_chatwheel_label_magnataur_laugh"	"Laugh"
"dota_chatwheel_message_magnataur_thank"	"Ja, dit gaat prima."
"[english]dota_chatwheel_message_magnataur_thank"	"Yes, this will do just fine."
"dota_chatwheel_label_magnataur_thank"	"Dit gaat prima."
"[english]dota_chatwheel_label_magnataur_thank"	"This will do just fine."
"dota_chatwheel_message_magnataur_deny"	"Dit is bullshit!"
"[english]dota_chatwheel_message_magnataur_deny"	"This is bullshit!"
"dota_chatwheel_label_magnataur_deny"	"Dit is bullshit!"
"[english]dota_chatwheel_label_magnataur_deny"	"This is bullshit!"
"dota_chatwheel_message_magnataur_1"	"Ha ha ha ha! Wat had je dan verwacht?"
"[english]dota_chatwheel_message_magnataur_1"	"Ha ha ha ha! What did you expect?"
"dota_chatwheel_label_magnataur_1"	"Wat had je dan verwacht?"
"[english]dota_chatwheel_label_magnataur_1"	"What did you expect?"
"dota_chatwheel_message_magnataur_2"	"Je maakt een grapje?"
"[english]dota_chatwheel_message_magnataur_2"	"Are you kidding me?"
"dota_chatwheel_label_magnataur_2"	"Je maakt een grapje?"
"[english]dota_chatwheel_label_magnataur_2"	"Are you kidding me?"
"dota_chatwheel_message_magnataur_4"	"Schandelijk."
"[english]dota_chatwheel_message_magnataur_4"	"How shameful."
"dota_chatwheel_label_magnataur_4"	"Schandelijk."
"[english]dota_chatwheel_label_magnataur_4"	"How shameful."
"dota_chatwheel_message_magnataur_5"	"Ik zal je wat vertellen. Als je m'n hoorn aanraakt breek ik je gezicht."
"[english]dota_chatwheel_message_magnataur_5"	"I tell you what. You touch my horn, I break your face."
"dota_chatwheel_label_magnataur_5"	"Als je m'n hoorn aanraakt breek ik je gezicht."
"[english]dota_chatwheel_label_magnataur_5"	"Touch my horn, break your face."
"dota_chatwheel_message_shredder_laugh"	"He he he he he!"
"[english]dota_chatwheel_message_shredder_laugh"	"He he he he he!"
"dota_chatwheel_label_shredder_laugh"	"Lachen"
"[english]dota_chatwheel_label_shredder_laugh"	"Laugh"
"dota_chatwheel_message_shredder_thank"	"Ik vertrouw je bijna."
"[english]dota_chatwheel_message_shredder_thank"	"I almost trust you."
"dota_chatwheel_label_shredder_thank"	"Ik vertrouw je bijna."
"[english]dota_chatwheel_label_shredder_thank"	"I almost trust you."
"dota_chatwheel_message_shredder_deny"	"Ben je boos? Want ik wel!"
"[english]dota_chatwheel_message_shredder_deny"	"You mad? Cuz I am!"
"dota_chatwheel_label_shredder_deny"	"Ben je boos?"
"[english]dota_chatwheel_label_shredder_deny"	"You mad?"
"dota_chatwheel_message_shredder_1"	"O ja, ha ha."
"[english]dota_chatwheel_message_shredder_1"	"Oh yeah ha ha."
"dota_chatwheel_label_shredder_1"	"O ja, ha ha."
"[english]dota_chatwheel_label_shredder_1"	"Oh yeah ha ha."
"dota_chatwheel_message_shredder_2"	"O! O! O-o-zie je dit? Zie je? O, dit heb ik altijd al gewild! O, ik ben zo blij!"
"[english]dota_chatwheel_message_shredder_2"	"Oh! Oh! Oh-oh-you see this? You see? Oh this is what I've always wanted! Oh I'm so happy!"
"dota_chatwheel_label_shredder_2"	"Wat ik altijd heb gewild!"
"[english]dota_chatwheel_label_shredder_2"	"What I've always wanted!"
"dota_chatwheel_message_shredder_3"	"O god, ik denk dat ik misselijk word."
"[english]dota_chatwheel_message_shredder_3"	"Oh god I think I'm going to be sick."
"dota_chatwheel_label_shredder_3"	"O god, ik denk dat ik misselijk word."
"[english]dota_chatwheel_label_shredder_3"	"Oh god I think I'm going to be sick."
"dota_chatwheel_message_shredder_4"	"Die is afgezaagd. Ha! Snap je?"
"[english]dota_chatwheel_message_shredder_4"	"Saw that coming. Ha! Get it?"
"dota_chatwheel_label_shredder_4"	"Die is afgezaagd!"
"[english]dota_chatwheel_label_shredder_4"	"Saw that coming!"
"dota_chatwheel_message_shredder_5"	"Ren, ren, ren, ren, renrenrenrenrenrenrenrenrenrenrenrenrenrenrenrenrenren!"
"[english]dota_chatwheel_message_shredder_5"	"Run run run run runrunrunrunrunrunrunrunrunrunrunrunrunrunrunrunrunrun!"
"dota_chatwheel_label_shredder_5"	"Ren, ren, ren, renrenren!"
"[english]dota_chatwheel_label_shredder_5"	"Run run runrun runrunrun!"
"dota_chatwheel_message_bristleback_laugh"	"Hehé hahaha."
"[english]dota_chatwheel_message_bristleback_laugh"	"Hehey hahaha."
"dota_chatwheel_label_bristleback_laugh"	"Lachen"
"[english]dota_chatwheel_label_bristleback_laugh"	"Laugh"
"dota_chatwheel_message_bristleback_thank"	"Helder en luchtig."
"[english]dota_chatwheel_message_bristleback_thank"	"Bright and breezy."
"dota_chatwheel_label_bristleback_thank"	"Helder en luchtig."
"[english]dota_chatwheel_label_bristleback_thank"	"Bright and breezy."
"dota_chatwheel_message_bristleback_deny"	"Ah, nu voel ik me beter."
"[english]dota_chatwheel_message_bristleback_deny"	"Ah, now I feel better."
"dota_chatwheel_label_bristleback_deny"	"Nu voel ik me beter."
"[english]dota_chatwheel_label_bristleback_deny"	"Now I feel better."
"dota_chatwheel_message_bristleback_1"	"Ooo, dat is prettig."
"[english]dota_chatwheel_message_bristleback_1"	"Oooh, that's lovely days."
"dota_chatwheel_label_bristleback_1"	"Dat is prettig!"
"[english]dota_chatwheel_label_bristleback_1"	"That's lovely!"
"dota_chatwheel_message_bristleback_2"	"Echt niet."
"[english]dota_chatwheel_message_bristleback_2"	"No way."
"dota_chatwheel_label_bristleback_2"	"Echt niet."
"[english]dota_chatwheel_label_bristleback_2"	"No way."
"dota_chatwheel_message_bristleback_3"	"O, dus je wilt hier wat van... hè?"
"[english]dota_chatwheel_message_bristleback_3"	"Oh, you want some of this… eh?"
"dota_chatwheel_label_bristleback_3"	"Wil je hier wat van?"
"[english]dota_chatwheel_label_bristleback_3"	"You want some of this?"
"dota_chatwheel_message_bristleback_4"	"Eens horen hoe je gilt."
"[english]dota_chatwheel_message_bristleback_4"	"Let's hear ya squeal."
"dota_chatwheel_label_bristleback_4"	"Eens horen hoe je gilt."
"[english]dota_chatwheel_label_bristleback_4"	"Let's hear you squeal."
"dota_chatwheel_message_bristleback_5"	"Nou, wat hebben we hier."
"[english]dota_chatwheel_message_bristleback_5"	"Well, what have we here."
"dota_chatwheel_label_bristleback_5"	"Wat hebben we hier."
"[english]dota_chatwheel_label_bristleback_5"	"What have we here."
"dota_chatwheel_message_tusk_laugh"	"O jee! Ha ha ha ha ha!"
"[english]dota_chatwheel_message_tusk_laugh"	"Oh boy! Ha ha ha ha ha!"
"dota_chatwheel_label_tusk_laugh"	"Lachen"
"[english]dota_chatwheel_label_tusk_laugh"	"Laugh"
"dota_chatwheel_message_tusk_thank"	"Boks."
"[english]dota_chatwheel_message_tusk_thank"	"Fist Bump."
"dota_chatwheel_label_tusk_thank"	"Boks."
"[english]dota_chatwheel_label_tusk_thank"	"Fist Bump."
"dota_chatwheel_message_tusk_deny"	"Nou, ik heb het geprobeerd."
"[english]dota_chatwheel_message_tusk_deny"	"Well I tried."
"dota_chatwheel_label_tusk_deny"	"Nou, ik heb het geprobeerd."
"[english]dota_chatwheel_label_tusk_deny"	"Well I tried."
"dota_chatwheel_message_tusk_1"	"Gaat het?"
"[english]dota_chatwheel_message_tusk_1"	"Are you okay?"
"dota_chatwheel_label_tusk_1"	"Gaat het?"
"[english]dota_chatwheel_label_tusk_1"	"Are you ok?"
"dota_chatwheel_message_tusk_2"	"Dohmvzm!"
"[english]dota_chatwheel_message_tusk_2"	"Dohmvzm!"
"dota_chatwheel_label_tusk_2"	"Dohmvzm!"
"[english]dota_chatwheel_label_tusk_2"	"Dohmvzm!"
"dota_chatwheel_message_tusk_4"	"Oh, dat deed vast pijn!"
"[english]dota_chatwheel_message_tusk_4"	"Oh, that had to hurt!"
"dota_chatwheel_label_tusk_4"	"Oh, dat deed vast pijn!"
"[english]dota_chatwheel_label_tusk_4"	"Oh, that had to hurt!"
"dota_chatwheel_message_tusk_5"	"Dat was een grote bal met mislukking."
"[english]dota_chatwheel_message_tusk_5"	"That was a big ball of failure."
"dota_chatwheel_label_tusk_5"	"Grote bal met mislukking."
"[english]dota_chatwheel_label_tusk_5"	"Big ball of failure."
"dota_chatwheel_message_skywrath_mage_laugh"	"Ha ha!"
"[english]dota_chatwheel_message_skywrath_mage_laugh"	"Ha ha!"
"dota_chatwheel_label_skywrath_mage_laugh"	"Lachen"
"[english]dota_chatwheel_label_skywrath_mage_laugh"	"Laugh"
"dota_chatwheel_message_skywrath_mage_thank"	"Ik zal je niet rapporteren."
"[english]dota_chatwheel_message_skywrath_mage_thank"	"I shall not report you."
"dota_chatwheel_label_skywrath_mage_thank"	"Ik zal je niet rapporteren."
"[english]dota_chatwheel_label_skywrath_mage_thank"	"I shall not report you."
"dota_chatwheel_message_skywrath_mage_2"	"Dat, mijn vriend, was een fout."
"[english]dota_chatwheel_message_skywrath_mage_2"	"That my friend was a mistake."
"dota_chatwheel_label_skywrath_mage_2"	"Dat was een fout."
"[english]dota_chatwheel_label_skywrath_mage_2"	"That was a mistake."
"dota_chatwheel_message_skywrath_mage_3"	"'t Was eervol gedaan."
"[english]dota_chatwheel_message_skywrath_mage_3"	"Twas honorably done."
"dota_chatwheel_label_skywrath_mage_3"	"'t Was eervol gedaan!"
"[english]dota_chatwheel_label_skywrath_mage_3"	"Twas honorably done!"
"dota_chatwheel_message_skywrath_mage_4"	"Vanuit de Ghastly Eyrie kan ik de einden van de wereld zien, en vanuit deze uitkijkpositie verklaar ik met uiterste zekerheid dat deze binnen is!"
"[english]dota_chatwheel_message_skywrath_mage_4"	"From the Ghastly Eyrie I can see to the ends of the world, and from this vantage point I declare with utter certainty that this one is in the bag!"
"dota_chatwheel_label_skywrath_mage_4"	"Vanuit de Ghastly Eyrie..."
"[english]dota_chatwheel_label_skywrath_mage_4"	"From the Ghastly Eyrie..."
"dota_chatwheel_message_skywrath_mage_5"	"De hemel verduistert door Skywrath-kracht!"
"[english]dota_chatwheel_message_skywrath_mage_5"	"The skies are dark with Skywrath power!"
"dota_chatwheel_label_skywrath_mage_5"	"De hemel verduistert door Skywrath-kracht!"
"[english]dota_chatwheel_label_skywrath_mage_5"	"The skies are dark with Skywrath power!"
"dota_chatwheel_message_abaddon_laugh"	"Ha ha ha ha ha ha ha ha ha."
"[english]dota_chatwheel_message_abaddon_laugh"	"Ha ha ha ha ha ha ha ha ha."
"dota_chatwheel_label_abaddon_laugh"	"Lachen"
"[english]dota_chatwheel_label_abaddon_laugh"	"Laugh"
"dota_chatwheel_message_abaddon_thank"	"Het huis Avernus zal me daarvoor verstoten."
"[english]dota_chatwheel_message_abaddon_thank"	"The House Avernus will disown me for that."
"dota_chatwheel_label_abaddon_thank"	"Ik word verstoten."
"[english]dota_chatwheel_label_abaddon_thank"	"I will be disowned."
"dota_chatwheel_message_abaddon_deny"	"Nooit."
"[english]dota_chatwheel_message_abaddon_deny"	"Never."
"dota_chatwheel_label_abaddon_deny"	"Nooit."
"[english]dota_chatwheel_label_abaddon_deny"	"Never."
"dota_chatwheel_message_abaddon_1"	"Buig voor je meester."
"[english]dota_chatwheel_message_abaddon_1"	"Bow to your lord."
"dota_chatwheel_label_abaddon_1"	"Buig voor je meester."
"[english]dota_chatwheel_label_abaddon_1"	"Bow to your lord."
"dota_chatwheel_message_abaddon_2"	"Hoe is zoiets mogelijk?"
"[english]dota_chatwheel_message_abaddon_2"	"How can such a thing be?"
"dota_chatwheel_label_abaddon_2"	"Hoe is zoiets..."
"[english]dota_chatwheel_label_abaddon_2"	"How can such..."
"dota_chatwheel_message_abaddon_3"	"In de mist der tijd ben jij maar een vlek."
"[english]dota_chatwheel_message_abaddon_3"	"In the mists of time you are but a blur."
"dota_chatwheel_label_abaddon_3"	"In de mist der tijd..."
"[english]dota_chatwheel_label_abaddon_3"	"In the mists of time..."
"dota_chatwheel_message_abaddon_4"	"Met welk recht loop jij hier?"
"[english]dota_chatwheel_message_abaddon_4"	"By what right do you tread here?"
"dota_chatwheel_label_abaddon_4"	"Met welk recht..."
"[english]dota_chatwheel_label_abaddon_4"	"By what right..."
"dota_chatwheel_message_abaddon_5"	"De oorlogsmist maakt geen kans tegen het mist der lot."
"[english]dota_chatwheel_message_abaddon_5"	"The fog of war is no match for the mist of fate."
"dota_chatwheel_label_abaddon_5"	"De oorlogsmist..."
"[english]dota_chatwheel_label_abaddon_5"	"The fog of war..."
"dota_chatwheel_message_elder_titan_laugh"	"Eh ha ha ha ha ha."
"[english]dota_chatwheel_message_elder_titan_laugh"	"Eh ha ha ha ha ha."
"dota_chatwheel_label_elder_titan_laugh"	"Lachen"
"[english]dota_chatwheel_label_elder_titan_laugh"	"Laugh"
"dota_chatwheel_message_elder_titan_thank"	"Nu zal de strijd zich keren."
"[english]dota_chatwheel_message_elder_titan_thank"	"Now shall the battle turn."
"dota_chatwheel_label_elder_titan_thank"	"Nu zal de strijd zich keren."
"[english]dota_chatwheel_label_elder_titan_thank"	"Now shall the battle turn."
"dota_chatwheel_message_elder_titan_deny"	"De Titan zegt nee."
"[english]dota_chatwheel_message_elder_titan_deny"	"The Titan says no."
"dota_chatwheel_label_elder_titan_deny"	"De Titan zegt nee."
"[english]dota_chatwheel_label_elder_titan_deny"	"The Titan says no."
"dota_chatwheel_message_elder_titan_1"	"Van m'n gazon af!"
"[english]dota_chatwheel_message_elder_titan_1"	"Get off my lawn!"
"dota_chatwheel_label_elder_titan_1"	"Van m'n gazon af."
"[english]dota_chatwheel_label_elder_titan_1"	"Get off my lawn."
"dota_chatwheel_message_elder_titan_2"	"Wat heb ik nu weer gedaan?"
"[english]dota_chatwheel_message_elder_titan_2"	"What have I done now?"
"dota_chatwheel_label_elder_titan_2"	"Wat heb ik nu weer gedaan?"
"[english]dota_chatwheel_label_elder_titan_2"	"What have I done now?"
"dota_chatwheel_message_elder_titan_3"	"Dit voorspelt veel goeds."
"[english]dota_chatwheel_message_elder_titan_3"	"This bodes well."
"dota_chatwheel_label_elder_titan_3"	"Dit voorspelt veel goeds."
"[english]dota_chatwheel_label_elder_titan_3"	"This bodes well."
"dota_chatwheel_message_elder_titan_4"	"Een jammerlijke poging."
"[english]dota_chatwheel_message_elder_titan_4"	"A pitiable attempt."
"dota_chatwheel_label_elder_titan_4"	"Een jammerlijke poging."
"[english]dota_chatwheel_label_elder_titan_4"	"A pitiable attempt."
"dota_chatwheel_message_elder_titan_5"	"Je moet leren respect te hebben voor ouderen."
"[english]dota_chatwheel_message_elder_titan_5"	"You must learn respect for your elders."
"dota_chatwheel_label_elder_titan_5"	"Je moet leren respect te hebben..."
"[english]dota_chatwheel_label_elder_titan_5"	"You must learn respect..."
"dota_chatwheel_message_legion_commander_laugh"	"Ah ha ha ha ha ha ha!"
"[english]dota_chatwheel_message_legion_commander_laugh"	"Ah ha ha ha ha ha ha!"
"dota_chatwheel_label_legion_commander_laugh"	"Lachen"
"[english]dota_chatwheel_label_legion_commander_laugh"	"Laugh"
"dota_chatwheel_message_legion_commander_thank"	"Helemaal niet slecht!"
"[english]dota_chatwheel_message_legion_commander_thank"	"Not bad at all!"
"dota_chatwheel_label_legion_commander_thank"	"Helemaal niet slecht!"
"[english]dota_chatwheel_label_legion_commander_thank"	"Not bad at all!"
"dota_chatwheel_message_legion_commander_deny"	"Doe eens beter je best."
"[english]dota_chatwheel_message_legion_commander_deny"	"Try harder."
"dota_chatwheel_label_legion_commander_deny"	"Doe eens beter je best."
"[english]dota_chatwheel_label_legion_commander_deny"	"Try Harder."
"dota_chatwheel_message_legion_commander_1"	"Goede strategie."
"[english]dota_chatwheel_message_legion_commander_1"	"Sound strategy."
"dota_chatwheel_label_legion_commander_1"	"Goede strategie."
"[english]dota_chatwheel_label_legion_commander_1"	"Sound strategy."
"dota_chatwheel_message_legion_commander_2"	"Mooie snor."
"[english]dota_chatwheel_message_legion_commander_2"	"Nice mustache."
"dota_chatwheel_label_legion_commander_2"	"Mooie snor."
"[english]dota_chatwheel_label_legion_commander_2"	"Nice mustache."
"dota_chatwheel_message_legion_commander_3"	"Ik zal je aan stukken scheuren!"
"[english]dota_chatwheel_message_legion_commander_3"	"I will tear you apart!"
"dota_chatwheel_label_legion_commander_3"	"Ik zal je aan stukken scheuren."
"[english]dota_chatwheel_label_legion_commander_3"	"I will tear you apart."
"dota_chatwheel_message_legion_commander_4"	"Kloot...!"
"[english]dota_chatwheel_message_legion_commander_4"	"Son of a...!"
"dota_chatwheel_label_legion_commander_4"	"Kloot..."
"[english]dota_chatwheel_label_legion_commander_4"	"Son of a..."
"dota_chatwheel_message_legion_commander_5"	"Dat liep snel uit de hand!"
"[english]dota_chatwheel_message_legion_commander_5"	"That escalated quickly!"
"dota_chatwheel_label_legion_commander_5"	"Dat liep snel uit de hand."
"[english]dota_chatwheel_label_legion_commander_5"	"That escalated quickly."
"dota_chatwheel_message_techies_laugh"	"He he he, hehe ah ha! Oh ho ho oh oh ha ha ha!"
"[english]dota_chatwheel_message_techies_laugh"	"He he he, hehe ah ha! Oh ho ho oh oh ha ha ha!"
"dota_chatwheel_label_techies_laugh"	"Lachen"
"[english]dota_chatwheel_label_techies_laugh"	"Laugh"
"dota_chatwheel_message_techies_thank"	"Leuk! Huhuhu!"
"[english]dota_chatwheel_message_techies_thank"	"Fun! Huhuhu!"
"dota_chatwheel_label_techies_thank"	"Leuk!"
"[english]dota_chatwheel_label_techies_thank"	"Fun!"
"dota_chatwheel_message_techies_deny"	"Ze zeiden dat hier een paddenstoelwolk zou zijn!"
"[english]dota_chatwheel_message_techies_deny"	"I was told there'd be a mushroom cloud!"
"dota_chatwheel_label_techies_deny"	"Paddenstoelwolk."
"[english]dota_chatwheel_label_techies_deny"	"Mushroom cloud."
"dota_chatwheel_message_techies_1"	"O shit!"
"[english]dota_chatwheel_message_techies_1"	"Oh crap!"
"dota_chatwheel_label_techies_1"	"O shit!"
"[english]dota_chatwheel_label_techies_1"	"Oh crap!"
"dota_chatwheel_message_techies_2"	"Waar is ie nou? Overal!"
"[english]dota_chatwheel_message_techies_2"	"Where'd he go? Everywhere!"
"dota_chatwheel_label_techies_2"	"Waar is ie nou? Overal!"
"[english]dota_chatwheel_label_techies_2"	"Where'd he go? Everywhere!"
"dota_chatwheel_message_techies_3"	"Hebbes!"
"[english]dota_chatwheel_message_techies_3"	"Gotcha!"
"dota_chatwheel_label_techies_3"	"Hebbes!"
"[english]dota_chatwheel_label_techies_3"	"Gotcha!"
"dota_chatwheel_message_techies_4"	"Ga daar maar zitten. Laat de slimme mensen het werk maar doen."
"[english]dota_chatwheel_message_techies_4"	"Just have a seat right over there. And let the smart people work."
"dota_chatwheel_label_techies_4"	"Ga maar zitten."
"[english]dota_chatwheel_label_techies_4"	"Have a seat."
"dota_chatwheel_message_techies_5"	"Geloof haast niet dat dat werkte."
"[english]dota_chatwheel_message_techies_5"	"I can't believe that worked."
"dota_chatwheel_label_techies_5"	"Geloof haast niet dat dat werkte."
"[english]dota_chatwheel_label_techies_5"	"I can't believe that worked."
"dota_chatwheel_message_ember_spirit_laugh"	"Eh he he he he he!"
"[english]dota_chatwheel_message_ember_spirit_laugh"	"Eh he he he he he!"
"dota_chatwheel_label_ember_spirit_laugh"	"Lachen"
"[english]dota_chatwheel_label_ember_spirit_laugh"	"Laugh"
"dota_chatwheel_message_ember_spirit_thank"	"Een flits van inspiratie!"
"[english]dota_chatwheel_message_ember_spirit_thank"	"A flash of inspiration!"
"dota_chatwheel_label_ember_spirit_thank"	"Een flits van inspiratie!"
"[english]dota_chatwheel_label_ember_spirit_thank"	"A flash of inspiration!"
"dota_chatwheel_message_ember_spirit_deny"	"Deze beloning gaat m'n verwachtingen te boven!"
"[english]dota_chatwheel_message_ember_spirit_deny"	"This reward transcends expectation!"
"dota_chatwheel_label_ember_spirit_deny"	"Deze beloning gaat m'n verwachtingen te boven!"
"[english]dota_chatwheel_label_ember_spirit_deny"	"This reward transcends expectation!"
"dota_chatwheel_message_ember_spirit_1"	"Bereid je voor op een les."
"[english]dota_chatwheel_message_ember_spirit_1"	"Prepare for a lesson."
"dota_chatwheel_label_ember_spirit_1"	"Bereid je voor op een les."
"[english]dota_chatwheel_label_ember_spirit_1"	"Prepare for a lesson."
"dota_chatwheel_message_ember_spirit_2"	"Wat heb je geleerd?"
"[english]dota_chatwheel_message_ember_spirit_2"	"What did you learn?"
"dota_chatwheel_label_ember_spirit_2"	"Wat heb je geleerd?"
"[english]dota_chatwheel_label_ember_spirit_2"	"What did you learn?"
"dota_chatwheel_message_ember_spirit_3"	"'t Is is een moeilijke les."
"[english]dota_chatwheel_message_ember_spirit_3"	"Tis a hard lesson."
"dota_chatwheel_label_ember_spirit_3"	"'t Is een moeilijke les."
"[english]dota_chatwheel_label_ember_spirit_3"	"'Tis a hard lesson."
"dota_chatwheel_message_ember_spirit_4"	"Niks meer om je te leren."
"[english]dota_chatwheel_message_ember_spirit_4"	"Nothing more to teach."
"dota_chatwheel_label_ember_spirit_4"	"Niks meer om je te leren"
"[english]dota_chatwheel_label_ember_spirit_4"	"Nothing more to teach"
"dota_chatwheel_message_ember_spirit_5"	"Zelfs een meester maakt fouten."
"[english]dota_chatwheel_message_ember_spirit_5"	"Even a master falters."
"dota_chatwheel_label_ember_spirit_5"	"Zelfs een meester maakt fouten."
"[english]dota_chatwheel_label_ember_spirit_5"	"Even a master falters."
"dota_chatwheel_message_earth_spirit_laugh"	"Oh ho ho ha ha ha ha ha ha!"
"[english]dota_chatwheel_message_earth_spirit_laugh"	"Oh ho ho ha ha ha ha ha ha!"
"dota_chatwheel_label_earth_spirit_laugh"	"Lachen"
"[english]dota_chatwheel_label_earth_spirit_laugh"	"Laugh"
"dota_chatwheel_message_earth_spirit_deny"	"Ja, dat deed ik net."
"[english]dota_chatwheel_message_earth_spirit_deny"	"Yes, I just did that."
"dota_chatwheel_label_earth_spirit_deny"	"Ja, dat deed ik net."
"[english]dota_chatwheel_label_earth_spirit_deny"	"Yes, I just did that."
"dota_chatwheel_message_earth_spirit_1"	"Wat?"
"[english]dota_chatwheel_message_earth_spirit_1"	"What?"
"dota_chatwheel_label_earth_spirit_1"	"Wat?"
"[english]dota_chatwheel_label_earth_spirit_1"	"What?"
"dota_chatwheel_message_earth_spirit_3"	"Perfecte timing."
"[english]dota_chatwheel_message_earth_spirit_3"	"Perfect timing."
"dota_chatwheel_label_earth_spirit_3"	"Perfecte timing"
"[english]dota_chatwheel_label_earth_spirit_3"	"Perfect Timing"
"dota_chatwheel_message_earth_spirit_4"	"Echt? Echt?"
"[english]dota_chatwheel_message_earth_spirit_4"	"Really? Really?"
"dota_chatwheel_label_earth_spirit_4"	"Echt? Echt?"
"[english]dota_chatwheel_label_earth_spirit_4"	"Really? Really?"
"dota_chatwheel_message_earth_spirit_5"	"Doelwit gemist."
"[english]dota_chatwheel_message_earth_spirit_5"	"Missed the mark."
"dota_chatwheel_label_earth_spirit_5"	"Doelwit gemist."
"[english]dota_chatwheel_label_earth_spirit_5"	"Missed the mark."
"dota_chatwheel_message_abyssal_underlord_laugh"	"Ah ha ha ha ha ha ha ha ha!"
"[english]dota_chatwheel_message_abyssal_underlord_laugh"	"Ah ha ha ha ha ha ha ha ha!"
"dota_chatwheel_label_abyssal_underlord_laugh"	"Lachen"
"[english]dota_chatwheel_label_abyssal_underlord_laugh"	"Laugh"
"dota_chatwheel_message_abyssal_underlord_thank"	"Ik bedank niet."
"[english]dota_chatwheel_message_abyssal_underlord_thank"	"I do not thank."
"dota_chatwheel_label_abyssal_underlord_thank"	"Ik bedank niet."
"[english]dota_chatwheel_label_abyssal_underlord_thank"	"I do not thank."
"dota_chatwheel_message_abyssal_underlord_deny"	"Vervloekt!"
"[english]dota_chatwheel_message_abyssal_underlord_deny"	"Curses!"
"dota_chatwheel_label_abyssal_underlord_deny"	"Vervloekt!"
"[english]dota_chatwheel_label_abyssal_underlord_deny"	"Curses!"
"dota_chatwheel_message_abyssal_underlord_1"	"O ja."
"[english]dota_chatwheel_message_abyssal_underlord_1"	"Oh yes."
"dota_chatwheel_label_abyssal_underlord_1"	"O ja."
"[english]dota_chatwheel_label_abyssal_underlord_1"	"Oh yes."
"dota_chatwheel_message_abyssal_underlord_2"	"Onbelangrijk."
"[english]dota_chatwheel_message_abyssal_underlord_2"	"Insignificant."
"dota_chatwheel_label_abyssal_underlord_2"	"Onbelangrijk!"
"[english]dota_chatwheel_label_abyssal_underlord_2"	"Insignificant!"
"dota_chatwheel_message_abyssal_underlord_3"	"Buig voor je nieuwe meester."
"[english]dota_chatwheel_message_abyssal_underlord_3"	"Bow to your new lord."
"dota_chatwheel_label_abyssal_underlord_3"	"Buig voor je nieuwe meester."
"[english]dota_chatwheel_label_abyssal_underlord_3"	"Bow to your new lord."
"dota_chatwheel_message_abyssal_underlord_4"	"Er is geen hoop."
"[english]dota_chatwheel_message_abyssal_underlord_4"	"There is no hope."
"dota_chatwheel_label_abyssal_underlord_4"	"Er is geen hoop."
"[english]dota_chatwheel_label_abyssal_underlord_4"	"There is no hope."
"dota_chatwheel_message_abyssal_underlord_5"	"Houd je goed vast."
"[english]dota_chatwheel_message_abyssal_underlord_5"	"Hold on to your butts."
"dota_chatwheel_label_abyssal_underlord_5"	"Houd je vast!"
"[english]dota_chatwheel_label_abyssal_underlord_5"	"Hold on!"
"dota_chatwheel_message_terrorblade_laugh"	"Hehahahahahh."
"[english]dota_chatwheel_message_terrorblade_laugh"	"Hehahahahahh."
"dota_chatwheel_label_terrorblade_laugh"	"Lachen"
"[english]dota_chatwheel_label_terrorblade_laugh"	"Laugh"
"dota_chatwheel_message_terrorblade_deny"	"O, ze zullen me hierom haten."
"[english]dota_chatwheel_message_terrorblade_deny"	"Oh, they're gonna hate me for this."
"dota_chatwheel_label_terrorblade_deny"	"Ze zullen me hierom haten."
"[english]dota_chatwheel_label_terrorblade_deny"	"They're gonna hate me for this."
"dota_chatwheel_message_terrorblade_1"	"Kneepje van het vak."
"[english]dota_chatwheel_message_terrorblade_1"	"Trick of the trade."
"dota_chatwheel_label_terrorblade_1"	"Kneepje van het vak."
"[english]dota_chatwheel_label_terrorblade_1"	"Trick of the trade."
"dota_chatwheel_message_terrorblade_2"	"Je eigen ergste vijand."
"[english]dota_chatwheel_message_terrorblade_2"	"Your own worst enemy."
"dota_chatwheel_label_terrorblade_2"	"Je eigen ergste vijand."
"[english]dota_chatwheel_label_terrorblade_2"	"Your own worst enemy."
"dota_chatwheel_message_terrorblade_3"	"Dat was misschien niet slim."
"[english]dota_chatwheel_message_terrorblade_3"	"Perhaps that wasn't wise."
"dota_chatwheel_label_terrorblade_3"	"Dat was misschien niet slim."
"[english]dota_chatwheel_label_terrorblade_3"	"Perhaps that wasn't wise."
"dota_chatwheel_message_terrorblade_4"	"Een wijs wapen ontneemt het leven van een dwaas."
"[english]dota_chatwheel_message_terrorblade_4"	"A wise blade takes a fool's life."
"dota_chatwheel_label_terrorblade_4"	"Wijs wapen."
"[english]dota_chatwheel_label_terrorblade_4"	"Wise blade."
"dota_chatwheel_message_terrorblade_5"	"Vecht met me, lafaards!"
"[english]dota_chatwheel_message_terrorblade_5"	"Fight me, cowards!"
"dota_chatwheel_label_terrorblade_5"	"Vecht met me!"
"[english]dota_chatwheel_label_terrorblade_5"	"Fight me!"
"dota_chatwheel_message_phoenix_laugh"	"Lachende tjilp"
"[english]dota_chatwheel_message_phoenix_laugh"	"Laughing Squawk"
"dota_chatwheel_label_phoenix_laugh"	"Lachende tjilp"
"[english]dota_chatwheel_label_phoenix_laugh"	"Laughing Squawk"
"dota_chatwheel_message_phoenix_thank"	"Dankbare tjilp"
"[english]dota_chatwheel_message_phoenix_thank"	"Thankful Squawk"
"dota_chatwheel_label_phoenix_thank"	"Dankbare tjilp"
"[english]dota_chatwheel_label_phoenix_thank"	"Thankful Squawk"
"dota_chatwheel_message_phoenix_deny"	"Afwijzende tjilp"
"[english]dota_chatwheel_message_phoenix_deny"	"Denying Squawk"
"dota_chatwheel_label_phoenix_deny"	"Afwijzende tjilp"
"[english]dota_chatwheel_label_phoenix_deny"	"Denying Squawk"
"dota_chatwheel_message_phoenix_1"	"Triomfantelijke tjilp"
"[english]dota_chatwheel_message_phoenix_1"	"Triumphant Squawk"
"dota_chatwheel_label_phoenix_1"	"Triomfantelijke tjilp"
"[english]dota_chatwheel_label_phoenix_1"	"Triumphant Squawk"
"dota_chatwheel_message_phoenix_2"	"Treurige tjilp"
"[english]dota_chatwheel_message_phoenix_2"	"Sorrowful Squawk"
"dota_chatwheel_label_phoenix_2"	"Treurige tjilp"
"[english]dota_chatwheel_label_phoenix_2"	"Sorrowful Squawk"
"dota_chatwheel_message_phoenix_3"	"Bespottende tjilp"
"[english]dota_chatwheel_message_phoenix_3"	"Taunting Squawk"
"dota_chatwheel_label_phoenix_3"	"Bespottende tjilp"
"[english]dota_chatwheel_label_phoenix_3"	"Taunting Squawk"
"dota_chatwheel_message_phoenix_4"	"Boze tjilp"
"[english]dota_chatwheel_message_phoenix_4"	"Angry Squawk"
"dota_chatwheel_label_phoenix_4"	"Boze tjilp"
"[english]dota_chatwheel_label_phoenix_4"	"Angry Squawk"
"dota_chatwheel_message_phoenix_5"	"Tevreden tjilp"
"[english]dota_chatwheel_message_phoenix_5"	"Contented Squawk"
"dota_chatwheel_label_phoenix_5"	"Tevreden tjilp"
"[english]dota_chatwheel_label_phoenix_5"	"Contented Squawk"
"dota_chatwheel_message_oracle_laugh"	"He ha ha he ha ha!"
"[english]dota_chatwheel_message_oracle_laugh"	"He ha ha he ha ha!"
"dota_chatwheel_label_oracle_laugh"	"Lachen"
"[english]dota_chatwheel_label_oracle_laugh"	"Laugh"
"dota_chatwheel_message_oracle_thank"	"Geloof in het lot hersteld."
"[english]dota_chatwheel_message_oracle_thank"	"Faith in fate restored."
"dota_chatwheel_label_oracle_thank"	"Geloof in het lot hersteld."
"[english]dota_chatwheel_label_oracle_thank"	"Faith in fate restored."
"dota_chatwheel_message_oracle_deny"	"Ik wil sterven."
"[english]dota_chatwheel_message_oracle_deny"	"I want to die."
"dota_chatwheel_label_oracle_deny"	"Ik wil sterven."
"[english]dota_chatwheel_label_oracle_deny"	"I want to die."
"dota_chatwheel_message_oracle_1"	"Dat zag ik."
"[english]dota_chatwheel_message_oracle_1"	"I saw that."
"dota_chatwheel_label_oracle_1"	"Dat zag ik."
"[english]dota_chatwheel_label_oracle_1"	"I saw that."
"dota_chatwheel_message_oracle_2"	"Ik ben geschokt. Geschokt!"
"[english]dota_chatwheel_message_oracle_2"	"I am shocked. Shocked!"
"dota_chatwheel_label_oracle_2"	"Ik ben geschokt."
"[english]dota_chatwheel_label_oracle_2"	"I am shocked."
"dota_chatwheel_message_oracle_3"	"Dat was inderdaad vreemd!"
"[english]dota_chatwheel_message_oracle_3"	"That was odd indeed!"
"dota_chatwheel_label_oracle_3"	"Dat was inderdaad vreemd!"
"[english]dota_chatwheel_label_oracle_3"	"That was odd indeed!"
"dota_chatwheel_message_oracle_4"	"Zelfs jij had dat moeten zien aankomen. Maar je zag het niet."
"[english]dota_chatwheel_message_oracle_4"	"Even you should've seen that coming. But you didn't."
"dota_chatwheel_label_oracle_4"	"Jij had dat moeten zien aankomen."
"[english]dota_chatwheel_label_oracle_4"	"You should've seen that coming."
"dota_chatwheel_message_oracle_5"	"Je zult sterven in een huisbrand."
"[english]dota_chatwheel_message_oracle_5"	"You will die in a house fire."
"dota_chatwheel_label_oracle_5"	"Je zult sterven in een huisbrand."
"[english]dota_chatwheel_label_oracle_5"	"You will die in a house fire."
"dota_chatwheel_message_arc_warden_laugh"	"Hm hm hm hm hm hm hm hm hm hm hm hm hm hm hm."
"[english]dota_chatwheel_message_arc_warden_laugh"	"Hm hm hm hm hm hm hm hm hm hm hm hm hm hm hm."
"dota_chatwheel_label_arc_warden_laugh"	"Lachen"
"[english]dota_chatwheel_label_arc_warden_laugh"	"Laugh"
"dota_chatwheel_message_arc_warden_thank"	"Je genade wordt genoteerd."
"[english]dota_chatwheel_message_arc_warden_thank"	"Your grace is noted."
"dota_chatwheel_label_arc_warden_thank"	"Je genade wordt genoteerd."
"[english]dota_chatwheel_label_arc_warden_thank"	"Your grace is noted."
"dota_chatwheel_message_arc_warden_deny"	"Wees niet egoïstisch."
"[english]dota_chatwheel_message_arc_warden_deny"	"Do not be selfish."
"dota_chatwheel_label_arc_warden_deny"	"Wees niet egoïstisch."
"[english]dota_chatwheel_label_arc_warden_deny"	"Do not be selfish."
"dota_chatwheel_message_arc_warden_1"	"Betrapt."
"[english]dota_chatwheel_message_arc_warden_1"	"Busted."
"dota_chatwheel_label_arc_warden_1"	"Betrapt."
"[english]dota_chatwheel_label_arc_warden_1"	"Busted."
"dota_chatwheel_message_arc_warden_2"	"Wat heb je gedaan?"
"[english]dota_chatwheel_message_arc_warden_2"	"What have you done?"
"dota_chatwheel_label_arc_warden_2"	"Wat heb je gedaan?"
"[english]dota_chatwheel_label_arc_warden_2"	"What have you done?"
"dota_chatwheel_message_arc_warden_3"	"Slechts een afleiding."
"[english]dota_chatwheel_message_arc_warden_3"	"A mere diversion."
"dota_chatwheel_label_arc_warden_3"	"Slechts een afleiding."
"[english]dota_chatwheel_label_arc_warden_3"	"A mere diversion."
"dota_chatwheel_message_arc_warden_4"	"Fronsend gezicht."
"[english]dota_chatwheel_message_arc_warden_4"	"Frowny face."
"dota_chatwheel_label_arc_warden_4"	"Fronsend gezicht."
"[english]dota_chatwheel_label_arc_warden_4"	"Frowny face."
"dota_chatwheel_message_arc_warden_5"	"Je hoeft niet boos te zijn."
"[english]dota_chatwheel_message_arc_warden_5"	"You do not have to be mad."
"dota_chatwheel_label_arc_warden_5"	"Je hoeft niet boos te zijn."
"[english]dota_chatwheel_label_arc_warden_5"	"You do not have to be mad."
"dota_chatwheel_message_winter_wyvern_laugh"	"Ah ha ha ha ha ha ha ha ha ha ha!"
"[english]dota_chatwheel_message_winter_wyvern_laugh"	"Ah ha ha ha ha ha ha ha ha ha ha!"
"dota_chatwheel_label_winter_wyvern_laugh"	"Lachen"
"[english]dota_chatwheel_label_winter_wyvern_laugh"	"Laugh"
"dota_chatwheel_message_winter_wyvern_thank"	"Schitterend!"
"[english]dota_chatwheel_message_winter_wyvern_thank"	"Wonderful!"
"dota_chatwheel_label_winter_wyvern_thank"	"Schitterend."
"[english]dota_chatwheel_label_winter_wyvern_thank"	"Wonderful."
"dota_chatwheel_message_winter_wyvern_deny"	"Chill, baby."
"[english]dota_chatwheel_message_winter_wyvern_deny"	"Chill, baby."
"dota_chatwheel_label_winter_wyvern_deny"	"Chill, baby."
"[english]dota_chatwheel_label_winter_wyvern_deny"	"Chill, baby."
"dota_chatwheel_message_winter_wyvern_1"	"Dat was niet slim!"
"[english]dota_chatwheel_message_winter_wyvern_1"	"That was not wise!"
"dota_chatwheel_label_winter_wyvern_1"	"Dat was niet slim."
"[english]dota_chatwheel_label_winter_wyvern_1"	"That was not wise."
"dota_chatwheel_message_winter_wyvern_2"	"Arme schat."
"[english]dota_chatwheel_message_winter_wyvern_2"	"Poor dear."
"dota_chatwheel_label_winter_wyvern_2"	"Arme schat."
"[english]dota_chatwheel_label_winter_wyvern_2"	"Poor dear."
"dota_chatwheel_message_winter_wyvern_3"	"Vraag een wyvern nooit waarom."
"[english]dota_chatwheel_message_winter_wyvern_3"	"Never ask a wyvern why."
"dota_chatwheel_label_winter_wyvern_3"	"Vraag een wyvern nooit waarom."
"[english]dota_chatwheel_label_winter_wyvern_3"	"Never ask a wyvern why."
"dota_chatwheel_message_winter_wyvern_4"	"Welverdiend!"
"[english]dota_chatwheel_message_winter_wyvern_4"	"Well deserved!"
"dota_chatwheel_label_winter_wyvern_4"	"Welverdiend."
"[english]dota_chatwheel_label_winter_wyvern_4"	"Well deserved."
"dota_chatwheel_message_winter_wyvern_5"	"Ah, ik heb me nog nooit zo goed gevoeld! Ah ha ha ha ha!"
"[english]dota_chatwheel_message_winter_wyvern_5"	"Ah, I've never felt this good! Ah ha ha ha ha!"
"dota_chatwheel_label_winter_wyvern_5"	"Heb me nog nooit zo goed gevoeld!"
"[english]dota_chatwheel_label_winter_wyvern_5"	"Never felt this good!"
"dota_chatwheel_message_monkey_king_laugh"	"Ah ha ha ha ha ha. Woehoehoehoe. Ohhh heee."
"[english]dota_chatwheel_message_monkey_king_laugh"	"Ah ha ha ha ha ha. Woohoohoohoo. Ohhh heee."
"dota_chatwheel_label_monkey_king_laugh"	"Lachen"
"[english]dota_chatwheel_label_monkey_king_laugh"	"Laugh"
"dota_chatwheel_message_monkey_king_thank"	"Dit zal volstaan."
"[english]dota_chatwheel_message_monkey_king_thank"	"This'll work."
"dota_chatwheel_label_monkey_king_thank"	"Dit zal volstaan."
"[english]dota_chatwheel_label_monkey_king_thank"	"This'll work."
"dota_chatwheel_message_monkey_king_deny"	"Ik voel me al beter."
"[english]dota_chatwheel_message_monkey_king_deny"	"I feel better already."
"dota_chatwheel_label_monkey_king_deny"	"Ik voel me al beter."
"[english]dota_chatwheel_label_monkey_king_deny"	"I feel better already."
"dota_chatwheel_message_monkey_king_1"	"Ohh, ik zal bij de vooringang handtekeningen uitdelen."
"[english]dota_chatwheel_message_monkey_king_1"	"Ohh, I'll be signing autographs out front."
"dota_chatwheel_label_monkey_king_1"	"Handtekeningen uitdelen"
"[english]dota_chatwheel_label_monkey_king_1"	"Signing autographs"
"dota_chatwheel_message_monkey_king_2"	"Oké, dat was onverwacht."
"[english]dota_chatwheel_message_monkey_king_2"	"Ok, that was unexpected."
"dota_chatwheel_label_monkey_king_2"	"Oké, dat was onverwacht."
"[english]dota_chatwheel_label_monkey_king_2"	"Ok, that was unexpected.."
"dota_chatwheel_message_monkey_king_3"	"Oké."
"[english]dota_chatwheel_message_monkey_king_3"	"Alright."
"dota_chatwheel_label_monkey_king_3"	"Oké."
"[english]dota_chatwheel_label_monkey_king_3"	"Alright."
"dota_chatwheel_message_monkey_king_4"	"Ik doe maar alsof ik hier niet van genoot."
"[english]dota_chatwheel_message_monkey_king_4"	"I'll pretend I didn't enjoy this."
"dota_chatwheel_label_monkey_king_4"	"Ik doe maar alsof ik hier niet van genoot."
"[english]dota_chatwheel_label_monkey_king_4"	"I'll pretend I didn't enjoy this."
"dota_chatwheel_message_monkey_king_5"	"Dit was al over voordat het begon."
"[english]dota_chatwheel_message_monkey_king_5"	"This was over before it started."
"dota_chatwheel_label_monkey_king_5"	"Over voordat het begon."
"[english]dota_chatwheel_label_monkey_king_5"	"Over before it started."
"dota_chatwheel_message_dark_willow_laugh"	"Hahaha ahaha ahaha ahhahahahahaa!"
"[english]dota_chatwheel_message_dark_willow_laugh"	"Hahaha ahaha ahaha ahhahahahahaa!"
"dota_chatwheel_label_dark_willow_laugh"	"Lachen"
"[english]dota_chatwheel_label_dark_willow_laugh"	"Laugh"
"dota_chatwheel_message_dark_willow_thank"	"Precies waar ik op wachtte."
"[english]dota_chatwheel_message_dark_willow_thank"	"Just what I was waiting for."
"dota_chatwheel_label_dark_willow_thank"	"Precies waar ik op wachtte."
"[english]dota_chatwheel_label_dark_willow_thank"	"Just what I was waiting for."
"dota_chatwheel_message_dark_willow_deny"	"Ik zal niet liegen, dat was onverwacht..."
"[english]dota_chatwheel_message_dark_willow_deny"	"I won't lie, that was unexpected..."
"dota_chatwheel_label_dark_willow_deny"	"Dat was onverwacht"
"[english]dota_chatwheel_label_dark_willow_deny"	"That was unexpected"
"dota_chatwheel_message_dark_willow_1"	"Nee. Gewoon... nee."
"[english]dota_chatwheel_message_dark_willow_1"	"No. Just... no."
"dota_chatwheel_label_dark_willow_1"	"Nee. Gewoon... nee."
"[english]dota_chatwheel_label_dark_willow_1"	"No. Just... no."
"dota_chatwheel_message_dark_willow_2"	"Maakte geen kans..."
"[english]dota_chatwheel_message_dark_willow_2"	"Never had a chance..."
"dota_chatwheel_label_dark_willow_2"	"Maakte geen kans."
"[english]dota_chatwheel_label_dark_willow_2"	"Never had a chance."
"dota_chatwheel_message_dark_willow_3"	"O-ho. Let maar niet op mij. Gewoon een feetje dat haar werk doet."
"[english]dota_chatwheel_message_dark_willow_3"	"Oh-ho. Don't mind me. Just a wee fairy going about her business."
"dota_chatwheel_label_dark_willow_3"	"Let maar niet op mij."
"[english]dota_chatwheel_label_dark_willow_3"	"Don't mind me."
"dota_chatwheel_message_dark_willow_4"	"Ik weet niet wat ik verwachtte."
"[english]dota_chatwheel_message_dark_willow_4"	"I don't know what I was expecting."
"dota_chatwheel_label_dark_willow_4"	"Weet niet wat ik verwachtte."
"[english]dota_chatwheel_label_dark_willow_4"	"Don't know what I was expecting."
"dota_chatwheel_message_dark_willow_5"	"Dit slaat helemaal nergens op."
"[english]dota_chatwheel_message_dark_willow_5"	"This makes absolutely no sense."
"dota_chatwheel_label_dark_willow_5"	"Slaat nergens op."
"[english]dota_chatwheel_label_dark_willow_5"	"Makes no sense."
"dota_chatwheel_message_pangolier_laugh"	"Aaaah ha hahahaha hahahaaa huu."
"[english]dota_chatwheel_message_pangolier_laugh"	"Aaaah ha hahahaha hahahaaa huu."
"dota_chatwheel_label_pangolier_laugh"	"Lachen"
"[english]dota_chatwheel_label_pangolier_laugh"	"Laugh"
"dota_chatwheel_message_pangolier_thank"	"Was dat opzettelijk? Het zag er opzettelijk uit."
"[english]dota_chatwheel_message_pangolier_thank"	"Was that intentional? It looked intentional."
"dota_chatwheel_label_pangolier_thank"	"Was dat opzettelijk?"
"[english]dota_chatwheel_label_pangolier_thank"	"Was that intentional?"
"dota_chatwheel_message_pangolier_deny"	"Keek je? Zo hoort het."
"[english]dota_chatwheel_message_pangolier_deny"	"Were you watching? That's how it's done."
"dota_chatwheel_label_pangolier_deny"	"Zo hoort het."
"[english]dota_chatwheel_label_pangolier_deny"	"How it's done."
"dota_chatwheel_message_pangolier_1"	"Doe de volgende keer beter je best..."
"[english]dota_chatwheel_message_pangolier_1"	"Try a bit harder next time..."
"dota_chatwheel_label_pangolier_1"	"Doe beter je best"
"[english]dota_chatwheel_label_pangolier_1"	"Try Harder"
"dota_chatwheel_message_pangolier_2"	"Dat ziet er niet goed uit."
"[english]dota_chatwheel_message_pangolier_2"	"That does not look good."
"dota_chatwheel_label_pangolier_2"	"Ziet er niet goed uit"
"[english]dota_chatwheel_label_pangolier_2"	"Not look good"
"dota_chatwheel_message_pangolier_3"	"Biep biep!"
"[english]dota_chatwheel_message_pangolier_3"	"Beep Beep!"
"dota_chatwheel_label_pangolier_3"	"Biep biep!"
"[english]dota_chatwheel_label_pangolier_3"	"Beep Beep!"
"dota_chatwheel_message_pangolier_4"	"Nu is het gewoon oneerlijk."
"[english]dota_chatwheel_message_pangolier_4"	"Now it's just unfair."
"dota_chatwheel_label_pangolier_4"	"Nu is het gewoon oneerlijk."
"[english]dota_chatwheel_label_pangolier_4"	"Now it's just unfair."
"dota_chatwheel_message_pangolier_5"	"Dus deze puinhoop is jouw schuld?"
"[english]dota_chatwheel_message_pangolier_5"	"So this whole mess is all your fault?"
"dota_chatwheel_label_pangolier_5"	"Jouw schuld?"
"[english]dota_chatwheel_label_pangolier_5"	"All your fault?"
}
