"hero_chat_wheel"
{
"dota_chatwheel_message_antimage_laugh"	"Ха-ха-ха-ха-ха-ха-ха-ха-ха-ха-ха-ха!"
"[english]dota_chatwheel_message_antimage_laugh"	"Ha ha ha ha ha ha ha ha ha ha ha ha!"
"dota_chatwheel_label_antimage_laugh"	"Смях"
"[english]dota_chatwheel_label_antimage_laugh"	"Laugh"
"dota_chatwheel_message_antimage_thank"	"Ще им дам такъв пердах, който няма да забравят скоро!"
"[english]dota_chatwheel_message_antimage_thank"	"I'll give them a drubbing they'll not soon forget!"
"dota_chatwheel_label_antimage_thank"	"Ще им дам такъв пердах…"
"[english]dota_chatwheel_label_antimage_thank"	"I'll give them a drubbing..."
"dota_chatwheel_message_antimage_deny"	"Стараете ли се изобщо?"
"[english]dota_chatwheel_message_antimage_deny"	"Are you even trying?"
"dota_chatwheel_label_antimage_deny"	"Стараете ли се изобщо?"
"[english]dota_chatwheel_label_antimage_deny"	"Are you even trying?"
"dota_chatwheel_message_antimage_1"	"Магията е нещо отвратително."
"[english]dota_chatwheel_message_antimage_1"	"Magic is an abomination."
"dota_chatwheel_label_antimage_1"	"Магията е нещо отвратително."
"[english]dota_chatwheel_label_antimage_1"	"Magic is an abomination."
"dota_chatwheel_message_antimage_2"	"Какво разочарование."
"[english]dota_chatwheel_message_antimage_2"	"A disappointment."
"dota_chatwheel_label_antimage_2"	"Какво разочарование."
"[english]dota_chatwheel_label_antimage_2"	"A disappointment."
"dota_chatwheel_message_antimage_3"	"'Що не се измъкнете с магия от това."
"[english]dota_chatwheel_message_antimage_3"	"Magic thyself out of that."
"dota_chatwheel_label_antimage_3"	"'Що не се измъкнете с магия от това."
"[english]dota_chatwheel_label_antimage_3"	"Magic thyself out of that."
"dota_chatwheel_message_antimage_4"	"Прокълнати сте Вий!"
"[english]dota_chatwheel_message_antimage_4"	"Thou art damned!"
"dota_chatwheel_label_antimage_4"	"Прокълнати сте Вий."
"[english]dota_chatwheel_label_antimage_4"	"Thou art damned."
"dota_chatwheel_message_antimage_5"	"Изпратете легионите на своя мъртъв бог, а аз ще избия всинца от тях."
"[english]dota_chatwheel_message_antimage_5"	"Send thy Dead God's legions, I will put them all to death."
"dota_chatwheel_label_antimage_5"	"Изпратете легионите на своя мъртъв бог…"
"[english]dota_chatwheel_label_antimage_5"	"Send thy Dead God's legions..."
"dota_chatwheel_message_axe_laugh"	"Ха-ха-ха-ха-ха-ха!"
"[english]dota_chatwheel_message_axe_laugh"	"Ha ha ha ha ha ha!"
"dota_chatwheel_label_axe_laugh"	"Смях"
"[english]dota_chatwheel_label_axe_laugh"	"Laugh"
"dota_chatwheel_message_axe_thank"	"Axe много харесва това."
"[english]dota_chatwheel_message_axe_thank"	"Axe likes this very much."
"dota_chatwheel_label_axe_thank"	"Axe много харесва това."
"[english]dota_chatwheel_label_axe_thank"	"Axe likes this very much."
"dota_chatwheel_message_axe_deny"	"Нищо не заслужавате!"
"[english]dota_chatwheel_message_axe_deny"	"You deserve nothing!"
"dota_chatwheel_label_axe_deny"	"Нищо не заслужавате!"
"[english]dota_chatwheel_label_axe_deny"	"You deserve nothing!"
"dota_chatwheel_message_axe_1"	"Сражавахте се лошо… умряхте още по-зле."
"[english]dota_chatwheel_message_axe_1"	"You fought badly--died worse."
"dota_chatwheel_label_axe_1"	"Сражавахте се лошо…"
"[english]dota_chatwheel_label_axe_1"	"You fought badly"
"dota_chatwheel_message_axe_2"	"Казах хубав ден, сър!"
"[english]dota_chatwheel_message_axe_2"	"I said good day, sir!"
"dota_chatwheel_label_axe_2"	"Казах хубав ден, сър!"
"[english]dota_chatwheel_label_axe_2"	"I said good day, sir!"
"dota_chatwheel_message_axe_3"	"Axe е преценил погрешно?"
"[english]dota_chatwheel_message_axe_3"	"Axe misjudged?"
"dota_chatwheel_label_axe_3"	"Axe е преценил погрешно?"
"[english]dota_chatwheel_label_axe_3"	"Axe misjudged?"
"dota_chatwheel_message_axe_4"	"Axe няма време за всички тия врели-некипели."
"[english]dota_chatwheel_message_axe_4"	"Axe has no time for all this jibber-jabber."
"dota_chatwheel_label_axe_4"	"Axe няма време за всички тия врели-некипели."
"[english]dota_chatwheel_label_axe_4"	"Axe has no time for all this jibber-jabber."
"dota_chatwheel_message_axe_5"	"Какво Ви сполетя ли? Axe Ви сполетя!"
"[english]dota_chatwheel_message_axe_5"	"What happened? Axe happened!"
"dota_chatwheel_label_axe_5"	"Какво Ви сполетя ли? Axe Ви сполетя!"
"[english]dota_chatwheel_label_axe_5"	"What happened? Axe happened!"
"dota_chatwheel_message_bane_laugh"	"Ха-ха-ха-ха-ха-ха-ха-ха-ха!"
"[english]dota_chatwheel_message_bane_laugh"	"Ha ha ha ha ha ha ha ha ha!"
"dota_chatwheel_label_bane_laugh"	"Смях"
"[english]dota_chatwheel_label_bane_laugh"	"Laugh"
"dota_chatwheel_message_bane_thank"	"Токова сте мили."
"[english]dota_chatwheel_message_bane_thank"	"You're so nice."
"dota_chatwheel_label_bane_thank"	"Токова сте мили."
"[english]dota_chatwheel_label_bane_thank"	"You're so nice."
"dota_chatwheel_message_bane_deny"	"Повече късмет следващият път."
"[english]dota_chatwheel_message_bane_deny"	"Better luck next time."
"dota_chatwheel_label_bane_deny"	"Повече късмет следващият път."
"[english]dota_chatwheel_label_bane_deny"	"Better luck next time."
"dota_chatwheel_message_bane_1"	"Проклятието на съществуванието Ви."
"[english]dota_chatwheel_message_bane_1"	"Bane of your existence."
"dota_chatwheel_label_bane_1"	"Проклятието на съществуванието Ви."
"[english]dota_chatwheel_label_bane_1"	"Bane of your existence."
"dota_chatwheel_message_bane_2"	"Мечтаех си за този миг."
"[english]dota_chatwheel_message_bane_2"	"I've been dreaming of this moment."
"dota_chatwheel_label_bane_2"	"Мечтаех си за този миг."
"[english]dota_chatwheel_label_bane_2"	"I've been dreaming of this moment."
"dota_chatwheel_message_bane_3"	"Справедлива размяна."
"[english]dota_chatwheel_message_bane_3"	"Fair exchange."
"dota_chatwheel_label_bane_3"	"Справедлива размяна."
"[english]dota_chatwheel_label_bane_3"	"Fair exchange."
"dota_chatwheel_message_bane_4"	"Сега кошмарът Ви ще трае навеки."
"[english]dota_chatwheel_message_bane_4"	"Now your nightmare lasts forever."
"dota_chatwheel_label_bane_4"	"Сега кошмарът Ви ще трае навеки."
"[english]dota_chatwheel_label_bane_4"	"Now your nightmare lasts forever."
"dota_chatwheel_message_bane_5"	"Ах, да, да, да, да, да, даа, даааа!"
"[english]dota_chatwheel_message_bane_5"	"Ah ya ya ya ya ya yai eeyas!"
"dota_chatwheel_label_bane_5"	"Ах, да, да, да, да, да, даа, даааа!"
"[english]dota_chatwheel_label_bane_5"	"Ah ya ya ya ya ya yai eeyas!"
"dota_chatwheel_message_bloodseeker_laugh"	"Хмм-хех-хех-хех-хех-ха!"
"[english]dota_chatwheel_message_bloodseeker_laugh"	"Hmm-heh-heh-heh-heh-ha!"
"dota_chatwheel_label_bloodseeker_laugh"	"Смях"
"[english]dota_chatwheel_label_bloodseeker_laugh"	"Laugh"
"dota_chatwheel_message_bloodseeker_thank"	"Толкова много кръв."
"[english]dota_chatwheel_message_bloodseeker_thank"	"So much blood."
"dota_chatwheel_label_bloodseeker_thank"	"Толкова много кръв."
"[english]dota_chatwheel_label_bloodseeker_thank"	"So much blood."
"dota_chatwheel_message_bloodseeker_deny"	"За Вас няма кръв."
"[english]dota_chatwheel_message_bloodseeker_deny"	"No blood for you."
"dota_chatwheel_label_bloodseeker_deny"	"За Вас няма кръв."
"[english]dota_chatwheel_label_bloodseeker_deny"	"No blood for you."
"dota_chatwheel_message_bloodseeker_1"	"Привижда ми се червено… и това е невероятно!"
"[english]dota_chatwheel_message_bloodseeker_1"	"I'm seeing red...and it's amazing!"
"dota_chatwheel_label_bloodseeker_1"	"Привижда ми се червено… и това е невероятно!"
"[english]dota_chatwheel_label_bloodseeker_1"	"I'm seeing red...and it's amazing!"
"dota_chatwheel_message_bloodseeker_2"	"Не бъдете песимисти… Бъдете оптимисти."
"[english]dota_chatwheel_message_bloodseeker_2"	"Don't be negative...be positive."
"dota_chatwheel_label_bloodseeker_2"	"Не бъдете песимисти…"
"[english]dota_chatwheel_label_bloodseeker_2"	"Don't be negative..."
"dota_chatwheel_message_bloodseeker_3"	"Хайде… побегнете."
"[english]dota_chatwheel_message_bloodseeker_3"	"Go ahead...run."
"dota_chatwheel_label_bloodseeker_3"	"Хайде… побегнете."
"[english]dota_chatwheel_label_bloodseeker_3"	"Go ahead...run."
"dota_chatwheel_message_bloodseeker_4"	"Полегнете… вземете си курабийка."
"[english]dota_chatwheel_message_bloodseeker_4"	"Lie down...have a cookie."
"dota_chatwheel_label_bloodseeker_4"	"Полегнете… вземете си курабийка."
"[english]dota_chatwheel_label_bloodseeker_4"	"Lie down...have a cookie."
"dota_chatwheel_message_bloodseeker_5"	"Връз бойното поле, миризмата на кръв се възнася като обещание."
"[english]dota_chatwheel_message_bloodseeker_5"	"Over the field of battle, the smell of blood rises like a promise."
"dota_chatwheel_label_bloodseeker_5"	"Връз бойното поле…"
"[english]dota_chatwheel_label_bloodseeker_5"	"Over the field of battle..."
"dota_chatwheel_message_crystal_maiden_laugh"	"Ах-ха-ха-ха-ха-ха."
"[english]dota_chatwheel_message_crystal_maiden_laugh"	"Ah ha ha ha ha ha."
"dota_chatwheel_label_crystal_maiden_laugh"	"Смях"
"[english]dota_chatwheel_label_crystal_maiden_laugh"	"Laugh"
"dota_chatwheel_message_crystal_maiden_thank"	"Много хладнокръвно от Ваша страна!"
"[english]dota_chatwheel_message_crystal_maiden_thank"	"Very cool of you!"
"dota_chatwheel_label_crystal_maiden_thank"	"Много хладнокръвно от Ваша страна!"
"[english]dota_chatwheel_label_crystal_maiden_thank"	"Very cool of you!"
"dota_chatwheel_message_crystal_maiden_deny"	"Сега, никой не печели!"
"[english]dota_chatwheel_message_crystal_maiden_deny"	"Now nobody wins!"
"dota_chatwheel_label_crystal_maiden_deny"	"Сега, никой не печели!"
"[english]dota_chatwheel_label_crystal_maiden_deny"	"Now nobody wins!"
"dota_chatwheel_message_crystal_maiden_1"	"От Вас ще стане хубав снежен ангел."
"[english]dota_chatwheel_message_crystal_maiden_1"	"You'll make a nice snow angel."
"dota_chatwheel_label_crystal_maiden_1"	"От Вас ще стане хубав снежен ангел."
"[english]dota_chatwheel_label_crystal_maiden_1"	"You'll make a nice snow angel."
"dota_chatwheel_message_crystal_maiden_2"	"Тръпките ме побиха!"
"[english]dota_chatwheel_message_crystal_maiden_2"	"I've got goosebumps!"
"dota_chatwheel_label_crystal_maiden_2"	"Тръпките ме побиха!"
"[english]dota_chatwheel_label_crystal_maiden_2"	"I've got goosebumps!"
"dota_chatwheel_message_crystal_maiden_3"	"Това беше неочаквано."
"[english]dota_chatwheel_message_crystal_maiden_3"	"I didn't see that coming."
"dota_chatwheel_label_crystal_maiden_3"	"Това беше неочаквано."
"[english]dota_chatwheel_label_crystal_maiden_3"	"I didn't see that coming."
"dota_chatwheel_message_crystal_maiden_4"	"Просто става все по-добре."
"[english]dota_chatwheel_message_crystal_maiden_4"	"It just keeps getting better."
"dota_chatwheel_label_crystal_maiden_4"	"Просто става все по-добре."
"[english]dota_chatwheel_label_crystal_maiden_4"	"It just keeps getting better."
"dota_chatwheel_message_crystal_maiden_5"	"Студено ли е тук или само на мен така ми се струва?"
"[english]dota_chatwheel_message_crystal_maiden_5"	"Is it cold in here or is it just me?"
"dota_chatwheel_label_crystal_maiden_5"	"Студено ли е тук или…"
"[english]dota_chatwheel_label_crystal_maiden_5"	"Is it cold in here or..."
"dota_chatwheel_message_drow_ranger_laugh"	"Ах-ха-ха-ха-ха-ха-ха-ха-ха-ха-ха-ха-ха-ха!"
"[english]dota_chatwheel_message_drow_ranger_laugh"	"Ah ha ha ha ha ha ha ha ha ha ha ha ha ha!"
"dota_chatwheel_label_drow_ranger_laugh"	"Смях"
"[english]dota_chatwheel_label_drow_ranger_laugh"	"Laugh"
"dota_chatwheel_message_drow_ranger_thank"	"Пореден триумф!"
"[english]dota_chatwheel_message_drow_ranger_thank"	"Another triumph!"
"dota_chatwheel_label_drow_ranger_thank"	"Пореден триумф!"
"[english]dota_chatwheel_label_drow_ranger_thank"	"Another triumph!"
"dota_chatwheel_message_drow_ranger_deny"	"Ще трябва да се справите по-добре от това!"
"[english]dota_chatwheel_message_drow_ranger_deny"	"You'll have to do better than that!"
"dota_chatwheel_label_drow_ranger_deny"	"Ще трябва да се справите по-добре от това!"
"[english]dota_chatwheel_label_drow_ranger_deny"	"You'll have to do better than that!"
"dota_chatwheel_message_drow_ranger_1"	"Бяхте прекалено шумни, за да оживеете."
"[english]dota_chatwheel_message_drow_ranger_1"	"You were too noisy to live."
"dota_chatwheel_label_drow_ranger_1"	"Бяхте прекалено шумни, за да оживеете."
"[english]dota_chatwheel_label_drow_ranger_1"	"You were too noisy to live."
"dota_chatwheel_message_drow_ranger_2"	"Аматьори."
"[english]dota_chatwheel_message_drow_ranger_2"	"Amateur."
"dota_chatwheel_label_drow_ranger_2"	"Аматьори."
"[english]dota_chatwheel_label_drow_ranger_2"	"Amateur."
"dota_chatwheel_message_drow_ranger_3"	"Умирате сами."
"[english]dota_chatwheel_message_drow_ranger_3"	"You die alone."
"dota_chatwheel_label_drow_ranger_3"	"Умирате сами."
"[english]dota_chatwheel_label_drow_ranger_3"	"You die alone."
"dota_chatwheel_message_drow_ranger_4"	"Това нямаше как да свърши другояче."
"[english]dota_chatwheel_message_drow_ranger_4"	"This couldn't have ended any other way."
"dota_chatwheel_label_drow_ranger_4"	"Това нямаше как да свърши…"
"[english]dota_chatwheel_label_drow_ranger_4"	"This couldn't have ended..."
"dota_chatwheel_message_drow_ranger_5"	"След като вече сте мъртви, ми е по-лесно да Ви уважавам."
"[english]dota_chatwheel_message_drow_ranger_5"	"Now that you're dead, I find it easy to respect you."
"dota_chatwheel_label_drow_ranger_5"	"След като вече сте мъртви…"
"[english]dota_chatwheel_label_drow_ranger_5"	"Now that you're dead..."
"dota_chatwheel_message_earthshaker_laugh"	"Ха-ха-ха-ха-ха-ха-ха-ха-ха."
"[english]dota_chatwheel_message_earthshaker_laugh"	"Ha ha ha ha ha ha ha ha ha."
"dota_chatwheel_label_earthshaker_laugh"	"Смях"
"[english]dota_chatwheel_label_earthshaker_laugh"	"Laugh"
"dota_chatwheel_message_earthshaker_thank"	"Нека да поразтърсим ситуацията!"
"[english]dota_chatwheel_message_earthshaker_thank"	"Let's shake things up!"
"dota_chatwheel_label_earthshaker_thank"	"Нека да поразтърсим ситуацията!"
"[english]dota_chatwheel_label_earthshaker_thank"	"Let's shake things up!"
"dota_chatwheel_message_earthshaker_deny"	"Шокиращо…"
"[english]dota_chatwheel_message_earthshaker_deny"	"Shocking..."
"dota_chatwheel_label_earthshaker_deny"	"Шокиращо…"
"[english]dota_chatwheel_label_earthshaker_deny"	"Shocking..."
"dota_chatwheel_message_earthshaker_1"	"Сами си бяхте виновни за тая проклетия."
"[english]dota_chatwheel_message_earthshaker_1"	"It was your own damn fault."
"dota_chatwheel_label_earthshaker_1"	"Сами си бяхте виновни за тая проклетия."
"[english]dota_chatwheel_label_earthshaker_1"	"It was your own damn fault."
"dota_chatwheel_message_earthshaker_2"	"Еха… Вторични трусове…"
"[english]dota_chatwheel_message_earthshaker_2"	"Whoa... Aftershocks..."
"dota_chatwheel_label_earthshaker_2"	"Еха… Вторични трусове…"
"[english]dota_chatwheel_label_earthshaker_2"	"Whoa... Aftershocks..."
"dota_chatwheel_message_earthshaker_3"	"Забиване…?"
"[english]dota_chatwheel_message_earthshaker_3"	"Slammin'...?"
"dota_chatwheel_label_earthshaker_3"	"Забиване…?"
"[english]dota_chatwheel_label_earthshaker_3"	"Slammin'...?"
"dota_chatwheel_message_earthshaker_4"	"Ставаше твърде пренаселено."
"[english]dota_chatwheel_message_earthshaker_4"	"It was getting far too crowded."
"dota_chatwheel_label_earthshaker_4"	"Ставаше твърде пренаселено."
"[english]dota_chatwheel_label_earthshaker_4"	"It was getting far too crowded."
"dota_chatwheel_message_earthshaker_5"	"Вероятно има много земи, но Earthshaker е само един."
"[english]dota_chatwheel_message_earthshaker_5"	"There may be many earths, but there's only one Earthshaker."
"dota_chatwheel_label_earthshaker_5"	"Вероятно има много земи…"
"[english]dota_chatwheel_label_earthshaker_5"	"There may be many earths..."
"dota_chatwheel_message_juggernaut_laugh"	"Ха-ха-ха-ха-ха!"
"[english]dota_chatwheel_message_juggernaut_laugh"	"Ha ha ha ha ha!"
"dota_chatwheel_label_juggernaut_laugh"	"Смях"
"[english]dota_chatwheel_label_juggernaut_laugh"	"Laugh"
"dota_chatwheel_message_juggernaut_thank"	"О, това е хубаво."
"[english]dota_chatwheel_message_juggernaut_thank"	"Oh that's nice."
"dota_chatwheel_label_juggernaut_thank"	"О, това е хубаво."
"[english]dota_chatwheel_label_juggernaut_thank"	"Oh that's nice."
"dota_chatwheel_message_juggernaut_deny"	"Хм, това изглежда добре."
"[english]dota_chatwheel_message_juggernaut_deny"	"Hm, looking good."
"dota_chatwheel_label_juggernaut_deny"	"Хм, това изглежда добре."
"[english]dota_chatwheel_label_juggernaut_deny"	"Hm, looking good."
"dota_chatwheel_message_juggernaut_1"	"Ще бъдете навеки сами."
"[english]dota_chatwheel_message_juggernaut_1"	"You will be forever alone."
"dota_chatwheel_label_juggernaut_1"	"Ще бъдете навеки сами."
"[english]dota_chatwheel_label_juggernaut_1"	"You will be forever alone."
"dota_chatwheel_message_juggernaut_2"	"Всичко си идва на мястото."
"[english]dota_chatwheel_message_juggernaut_2"	"It's all falling into place."
"dota_chatwheel_label_juggernaut_2"	"Всичко си идва на мястото."
"[english]dota_chatwheel_label_juggernaut_2"	"It's all falling into place."
"dota_chatwheel_message_juggernaut_3"	"Ще се върна да довърша това по-късно."
"[english]dota_chatwheel_message_juggernaut_3"	"I'll be back to finish this later."
"dota_chatwheel_label_juggernaut_3"	"Ще се върна да довърша това по-късно."
"[english]dota_chatwheel_label_juggernaut_3"	"I'll be back to finish this later."
"dota_chatwheel_message_juggernaut_4"	"Има много фин предел между храбростта и глупостта."
"[english]dota_chatwheel_message_juggernaut_4"	"There's a fine line between bravery and stupidity."
"dota_chatwheel_label_juggernaut_4"	"Има много фин предел…"
"[english]dota_chatwheel_label_juggernaut_4"	"There's a fine line..."
"dota_chatwheel_message_juggernaut_5"	"Мм, шикозно."
"[english]dota_chatwheel_message_juggernaut_5"	"Mm, snazzy."
"dota_chatwheel_label_juggernaut_5"	"Мм, шикозно."
"[english]dota_chatwheel_label_juggernaut_5"	"Mm, snazzy."
"dota_chatwheel_message_mirana_laugh"	"Ха-ха-ха-ха-ха-ха!"
"[english]dota_chatwheel_message_mirana_laugh"	"Ha ha ha ha ha ha!"
"dota_chatwheel_label_mirana_laugh"	"Смях"
"[english]dota_chatwheel_label_mirana_laugh"	"Laugh"
"dota_chatwheel_message_mirana_thank"	"Подарък от нощта!"
"[english]dota_chatwheel_message_mirana_thank"	"A gift from the night!"
"dota_chatwheel_label_mirana_thank"	"Подарък от нощта!"
"[english]dota_chatwheel_label_mirana_thank"	"A gift from the night!"
"dota_chatwheel_message_mirana_deny"	"Хванете ни, ако можете!"
"[english]dota_chatwheel_message_mirana_deny"	"Catch us if you can!"
"dota_chatwheel_label_mirana_deny"	"Хванете ни, ако можете!"
"[english]dota_chatwheel_label_mirana_deny"	"Catch us if you can!"
"dota_chatwheel_message_mirana_1"	"Нищо не сте научили."
"[english]dota_chatwheel_message_mirana_1"	"You have learned nothing."
"dota_chatwheel_label_mirana_1"	"Нищо не сте научили."
"[english]dota_chatwheel_label_mirana_1"	"You have learned nothing."
"dota_chatwheel_message_mirana_2"	"Добре сторено!"
"[english]dota_chatwheel_message_mirana_2"	"Nicely done!"
"dota_chatwheel_label_mirana_2"	"Добре сторено!"
"[english]dota_chatwheel_label_mirana_2"	"Nicely done!"
"dota_chatwheel_message_mirana_3"	"Бягайте като псетата, които сте!"
"[english]dota_chatwheel_message_mirana_3"	"Run like the dogs you are!"
"dota_chatwheel_label_mirana_3"	"Бягайте като псетата, които сте!"
"[english]dota_chatwheel_label_mirana_3"	"Run like the dogs you are!"
"dota_chatwheel_message_mirana_4"	"Ела тук, пис-пис-пис…"
"[english]dota_chatwheel_message_mirana_4"	"Here, kitty-kitty-kitty...."
"dota_chatwheel_label_mirana_4"	"Ела тук, пис-пис-пис…"
"[english]dota_chatwheel_label_mirana_4"	"Here, kitty-kitty-kitty...."
"dota_chatwheel_message_mirana_5"	"Не беше късмет, а умение!"
"[english]dota_chatwheel_message_mirana_5"	"It was not luck but skill!"
"dota_chatwheel_label_mirana_5"	"Не беше късмет, а умение!"
"[english]dota_chatwheel_label_mirana_5"	"It was not luck but skill!"
"dota_chatwheel_message_morphling_laugh"	"Ха-ха-ха-ха-ха-ха-ха-ха-ха-ха!"
"[english]dota_chatwheel_message_morphling_laugh"	"Ha ha ha ha ha ha ha ha ha ha!"
"dota_chatwheel_label_morphling_laugh"	"Смях"
"[english]dota_chatwheel_label_morphling_laugh"	"Laugh"
"dota_chatwheel_message_morphling_thank"	"Харесва ми това, което виждам."
"[english]dota_chatwheel_message_morphling_thank"	"I like what I see."
"dota_chatwheel_label_morphling_thank"	"Харесва ми това, което виждам."
"[english]dota_chatwheel_label_morphling_thank"	"I like what I see."
"dota_chatwheel_message_morphling_deny"	"Самозабравяте се."
"[english]dota_chatwheel_message_morphling_deny"	"You're in over your head."
"dota_chatwheel_label_morphling_deny"	"Самозабравяте се."
"[english]dota_chatwheel_label_morphling_deny"	"You're in over your head."
"dota_chatwheel_message_morphling_1"	"Кипяща ярост!"
"[english]dota_chatwheel_message_morphling_1"	"Boiling rage!"
"dota_chatwheel_label_morphling_1"	"Кипяща ярост!"
"[english]dota_chatwheel_label_morphling_1"	"Boiling rage!"
"dota_chatwheel_message_morphling_2"	"Винаги ободряващо."
"[english]dota_chatwheel_message_morphling_2"	"Always refreshing."
"dota_chatwheel_label_morphling_2"	"Винаги ободряващо."
"[english]dota_chatwheel_label_morphling_2"	"Always refreshing."
"dota_chatwheel_message_morphling_3"	"Течението се променя!"
"[english]dota_chatwheel_message_morphling_3"	"The tide has turned!"
"dota_chatwheel_label_morphling_3"	"Течението се променя!"
"[english]dota_chatwheel_label_morphling_3"	"The tide has turned!"
"dota_chatwheel_message_morphling_4"	"Не видяхте, че помахвам?"
"[english]dota_chatwheel_message_morphling_4"	"Didn't you see me waving?"
"dota_chatwheel_label_morphling_4"	"Не видяхте, че помахвам?"
"[english]dota_chatwheel_label_morphling_4"	"Didn't you see me waving?"
"dota_chatwheel_message_morphling_5"	"Гола вода сте!"
"[english]dota_chatwheel_message_morphling_5"	"You're washed up!"
"dota_chatwheel_label_morphling_5"	"Гола вода сте!"
"[english]dota_chatwheel_label_morphling_5"	"You're washed up!"
"dota_chatwheel_message_nevermore_laugh"	"Ах-ха-ха-ха-ха-ха!"
"[english]dota_chatwheel_message_nevermore_laugh"	"Ah ha ha ha ha ha!"
"dota_chatwheel_label_nevermore_laugh"	"Смях"
"[english]dota_chatwheel_label_nevermore_laugh"	"Laugh"
"dota_chatwheel_message_nevermore_thank"	"Е, нека душата Ви бъде благословена."
"[english]dota_chatwheel_message_nevermore_thank"	"Well bless your soul."
"dota_chatwheel_label_nevermore_thank"	"Е, нека душата Ви бъде благословена."
"[english]dota_chatwheel_label_nevermore_thank"	"Well bless your soul."
"dota_chatwheel_message_nevermore_deny"	"Надиграни."
"[english]dota_chatwheel_message_nevermore_deny"	"Outplayed."
"dota_chatwheel_label_nevermore_deny"	"Надиграни."
"[english]dota_chatwheel_label_nevermore_deny"	"Outplayed."
"dota_chatwheel_message_nevermore_1"	"Красива душа за моята колекция."
"[english]dota_chatwheel_message_nevermore_1"	"A beautiful soul for my collection."
"dota_chatwheel_label_nevermore_1"	"Красива душа за моята колекция."
"[english]dota_chatwheel_label_nevermore_1"	"A beautiful soul for my collection."
"dota_chatwheel_message_nevermore_2"	"Страхувайте се от моето присъствие."
"[english]dota_chatwheel_message_nevermore_2"	"Fear my presence."
"dota_chatwheel_label_nevermore_2"	"Страхувайте се от моето присъствие."
"[english]dota_chatwheel_label_nevermore_2"	"Fear my presence."
"dota_chatwheel_message_nevermore_3"	"Аз ще го взема."
"[english]dota_chatwheel_message_nevermore_3"	"I'll take it."
"dota_chatwheel_label_nevermore_3"	"Аз ще го взема."
"[english]dota_chatwheel_label_nevermore_3"	"I'll take it."
"dota_chatwheel_message_nevermore_4"	"Нивга не ще можете да се скриете!"
"[english]dota_chatwheel_message_nevermore_4"	"You can never hide!"
"dota_chatwheel_label_nevermore_4"	"Нивга не ще можете да се скриете!"
"[english]dota_chatwheel_label_nevermore_4"	"You can never hide!"
"dota_chatwheel_message_nevermore_5"	"Уж ича глутх иж сол."
"[english]dota_chatwheel_message_nevermore_5"	"Ozh icha gluth izh sol."
"dota_chatwheel_label_nevermore_5"	"Уж ича глутх иж сол."
"[english]dota_chatwheel_label_nevermore_5"	"Ozh icha gluth izh sol."
"dota_chatwheel_message_phantom_lancer_laugh"	"Ха-ха-ха-ха-ха-ха-ха-ха-ха-ха-ха-ха-ха!"
"[english]dota_chatwheel_message_phantom_lancer_laugh"	"Ha ha ha ha ha ha ha ha ha ha ha ha ha!"
"dota_chatwheel_label_phantom_lancer_laugh"	"Смях"
"[english]dota_chatwheel_label_phantom_lancer_laugh"	"Laugh"
"dota_chatwheel_message_phantom_lancer_thank"	"Какво изумително нещо."
"[english]dota_chatwheel_message_phantom_lancer_thank"	"What an amazing thing."
"dota_chatwheel_label_phantom_lancer_thank"	"Какво изумително нещо."
"[english]dota_chatwheel_label_phantom_lancer_thank"	"What an amazing thing."
"dota_chatwheel_message_phantom_lancer_deny"	"Такива простовати умове."
"[english]dota_chatwheel_message_phantom_lancer_deny"	"Such simple minds."
"dota_chatwheel_label_phantom_lancer_deny"	"Такива простовати умове."
"[english]dota_chatwheel_label_phantom_lancer_deny"	"Such simple minds."
"dota_chatwheel_message_phantom_lancer_1"	"Идваме за Вас!"
"[english]dota_chatwheel_message_phantom_lancer_1"	"We come for you!"
"dota_chatwheel_label_phantom_lancer_1"	"Идваме за Вас!"
"[english]dota_chatwheel_label_phantom_lancer_1"	"We come for you!"
"dota_chatwheel_message_phantom_lancer_2"	"Това вече е просто глуповато."
"[english]dota_chatwheel_message_phantom_lancer_2"	"Now this is just silly."
"dota_chatwheel_label_phantom_lancer_2"	"Това вече е просто глуповато."
"[english]dota_chatwheel_label_phantom_lancer_2"	"Now this is just silly."
"dota_chatwheel_message_phantom_lancer_3"	"Разполагаме с още много там, откъдето дойде това."
"[english]dota_chatwheel_message_phantom_lancer_3"	"We have more where that came from."
"dota_chatwheel_label_phantom_lancer_3"	"Разполагаме с още много там, откъдето дойде това."
"[english]dota_chatwheel_label_phantom_lancer_3"	"We have more where that came from."
"dota_chatwheel_message_phantom_lancer_4"	"Численото превъзходство постигна това, което стратегията сама по себе си не можа."
"[english]dota_chatwheel_message_phantom_lancer_4"	"Numbers have accomplished what strategy alone could not."
"dota_chatwheel_label_phantom_lancer_4"	"Численото превъзходство постигна…"
"[english]dota_chatwheel_label_phantom_lancer_4"	"Numbers have accomplished..."
"dota_chatwheel_message_phantom_lancer_5"	"Превъзхождаме Ви. Превъзхождаме всички тях!"
"[english]dota_chatwheel_message_phantom_lancer_5"	"We outnumbered you. We outnumber them all!"
"dota_chatwheel_label_phantom_lancer_5"	"Превъзхождаме Ви…"
"[english]dota_chatwheel_label_phantom_lancer_5"	"We outnumbered you..."
"dota_chatwheel_message_puck_laugh"	"Ха-ха!"
"[english]dota_chatwheel_message_puck_laugh"	"Ha ha!"
"dota_chatwheel_label_puck_laugh"	"Смях"
"[english]dota_chatwheel_label_puck_laugh"	"Laugh"
"dota_chatwheel_message_puck_thank"	"Интересно."
"[english]dota_chatwheel_message_puck_thank"	"Interesting."
"dota_chatwheel_label_puck_thank"	"Интересно."
"[english]dota_chatwheel_label_puck_thank"	"Interesting."
"dota_chatwheel_message_puck_deny"	"Вероятно ще Ви се иска да оттеглите последния си ход."
"[english]dota_chatwheel_message_puck_deny"	"You might wish to retract your last move."
"dota_chatwheel_label_puck_deny"	"Вероятно ще Ви се иска да оттеглите…"
"[english]dota_chatwheel_label_puck_deny"	"You might wish to retract..."
"dota_chatwheel_message_puck_1"	"Поздрави!"
"[english]dota_chatwheel_message_puck_1"	"Greetings!"
"dota_chatwheel_label_puck_1"	"Поздрави!"
"[english]dota_chatwheel_label_puck_1"	"Greetings!"
"dota_chatwheel_message_puck_2"	"Какво е това, някакъв вид игра ли?"
"[english]dota_chatwheel_message_puck_2"	"What is this, a game of some sort?"
"dota_chatwheel_label_puck_2"	"Какво е това, някакъв вид игра ли?"
"[english]dota_chatwheel_label_puck_2"	"What is this, a game of some sort?"
"dota_chatwheel_message_puck_3"	"Най-великата трагедия на нашата епоха."
"[english]dota_chatwheel_message_puck_3"	"The greatest tragedy of our eon."
"dota_chatwheel_label_puck_3"	"Най-великата трагедия на нашата епоха."
"[english]dota_chatwheel_label_puck_3"	"The greatest tragedy of our eon."
"dota_chatwheel_message_puck_4"	"Това умно ли беше?"
"[english]dota_chatwheel_message_puck_4"	"Was that smart?"
"dota_chatwheel_label_puck_4"	"Това умно ли беше?"
"[english]dota_chatwheel_label_puck_4"	"Was that smart?"
"dota_chatwheel_message_puck_5"	"Това чувство ми е непознато. Нима е радост?"
"[english]dota_chatwheel_message_puck_5"	"I am unfamiliar with this feeling. Is it joy?"
"dota_chatwheel_label_puck_5"	"Това чувство ми е непознато…"
"[english]dota_chatwheel_label_puck_5"	"I am unfamiliar with this feeling..."
"dota_chatwheel_message_pudge_laugh"	"Хм-хм-хм-хм-ха-ха-ха."
"[english]dota_chatwheel_message_pudge_laugh"	"Hm hm hm hm ha ha ha."
"dota_chatwheel_label_pudge_laugh"	"Смях"
"[english]dota_chatwheel_label_pudge_laugh"	"Laugh"
"dota_chatwheel_message_pudge_thank"	"Това е някак си добре."
"[english]dota_chatwheel_message_pudge_thank"	"That's a bit of all right."
"dota_chatwheel_label_pudge_thank"	"Това е някак си добре."
"[english]dota_chatwheel_label_pudge_thank"	"That's a bit of all right."
"dota_chatwheel_message_pudge_deny"	"Опа. Това аз ли бях?"
"[english]dota_chatwheel_message_pudge_deny"	"Oops. Was that me?"
"dota_chatwheel_label_pudge_deny"	"Опа. Това аз ли бях?"
"[english]dota_chatwheel_label_pudge_deny"	"Oops. Was that me?"
"dota_chatwheel_message_pudge_1"	"Време е за малко клане!"
"[english]dota_chatwheel_message_pudge_1"	"Time for a little butchery!"
"dota_chatwheel_label_pudge_1"	"Време е за малко клане!"
"[english]dota_chatwheel_label_pudge_1"	"Time for a little butchery!"
"dota_chatwheel_message_pudge_2"	"Няма нищо по-добро от малко хубав суров черен дроб."
"[english]dota_chatwheel_message_pudge_2"	"Nothing better than a nice raw liver."
"dota_chatwheel_label_pudge_2"	"Няма нищо по-добро от малко хубав суров черен дроб."
"[english]dota_chatwheel_label_pudge_2"	"Nothing better than a nice raw liver."
"dota_chatwheel_message_pudge_3"	"'Се тая."
"[english]dota_chatwheel_message_pudge_3"	"Whateva."
"dota_chatwheel_label_pudge_3"	"'Се тая."
"[english]dota_chatwheel_label_pudge_3"	"Whateva."
"dota_chatwheel_message_pudge_4"	"Вкусно…"
"[english]dota_chatwheel_message_pudge_4"	"Delicious..."
"dota_chatwheel_label_pudge_4"	"Вкусно…"
"[english]dota_chatwheel_label_pudge_4"	"Delicious..."
"dota_chatwheel_message_pudge_5"	"Ще изглеждате добре с ябълка в устата!"
"[english]dota_chatwheel_message_pudge_5"	"You'll look good with an apple in yer mouth!"
"dota_chatwheel_label_pudge_5"	"Ще изглеждате добре с…"
"[english]dota_chatwheel_label_pudge_5"	"You'll look good with..."
"dota_chatwheel_message_razor_laugh"	"Ах-ха-ха-ха-ха-ха-ха-ха-ха."
"[english]dota_chatwheel_message_razor_laugh"	"Ah ha ha ha ha ha ha ha ha."
"dota_chatwheel_label_razor_laugh"	"Смях"
"[english]dota_chatwheel_label_razor_laugh"	"Laugh"
"dota_chatwheel_message_razor_thank"	"Усещам, че между нас има връзка!"
"[english]dota_chatwheel_message_razor_thank"	"I sense a connection between us!"
"dota_chatwheel_label_razor_thank"	"Усещам, че между нас има връзка!"
"[english]dota_chatwheel_label_razor_thank"	"I sense a connection between us!"
"dota_chatwheel_message_razor_deny"	"Можете да бягате. Би трябвало да бягате."
"[english]dota_chatwheel_message_razor_deny"	"You can run. You should run."
"dota_chatwheel_label_razor_deny"	"Можете да бягате. Би трябвало да бягате."
"[english]dota_chatwheel_label_razor_deny"	"You can run. You should run."
"dota_chatwheel_message_razor_1"	"Мъртви сте. Мъртви."
"[english]dota_chatwheel_message_razor_1"	"You are dead. Dead."
"dota_chatwheel_label_razor_1"	"Мъртви сте. Мъртви."
"[english]dota_chatwheel_label_razor_1"	"You are dead. Dead."
"dota_chatwheel_message_razor_2"	"Пепелта Ви ще се сипе като дъжд."
"[english]dota_chatwheel_message_razor_2"	"Your ashes will fall like rain."
"dota_chatwheel_label_razor_2"	"Пепелта Ви ще се сипе като дъжд."
"[english]dota_chatwheel_label_razor_2"	"Your ashes will fall like rain."
"dota_chatwheel_message_razor_3"	"Шокиращо."
"[english]dota_chatwheel_message_razor_3"	"Shocking."
"dota_chatwheel_label_razor_3"	"Шокиращо."
"[english]dota_chatwheel_label_razor_3"	"Shocking."
"dota_chatwheel_message_razor_4"	"Това ще боли само… навеки."
"[english]dota_chatwheel_message_razor_4"	"This will only hurt forever."
"dota_chatwheel_label_razor_4"	"Това ще боли само… навеки."
"[english]dota_chatwheel_label_razor_4"	"This will only hurt forever."
"dota_chatwheel_message_razor_5"	"Изпържих Ви задника!"
"[english]dota_chatwheel_message_razor_5"	"Zapped your ass!"
"dota_chatwheel_label_razor_5"	"Изпържих Ви задника!"
"[english]dota_chatwheel_label_razor_5"	"Zapped your ass!"
"dota_chatwheel_message_sand_king_laugh"	"Ха-ха-ха-ха-ха-ха-ха!"
"[english]dota_chatwheel_message_sand_king_laugh"	"Ha ha ha ha ha ha ha!"
"dota_chatwheel_label_sand_king_laugh"	"Смях"
"[english]dota_chatwheel_label_sand_king_laugh"	"Laugh"
"dota_chatwheel_message_sand_king_thank"	"Сторихте велика услуга."
"[english]dota_chatwheel_message_sand_king_thank"	"You have done a great service."
"dota_chatwheel_label_sand_king_thank"	"Сторихте велика услуга."
"[english]dota_chatwheel_label_sand_king_thank"	"You have done a great service."
"dota_chatwheel_message_sand_king_deny"	"Смъди, нали?"
"[english]dota_chatwheel_message_sand_king_deny"	"Stings, don't it?"
"dota_chatwheel_label_sand_king_deny"	"Смъди, нали?"
"[english]dota_chatwheel_label_sand_king_deny"	"Stings, don't it?"
"dota_chatwheel_message_sand_king_1"	"Преклонете се пред своя васал."
"[english]dota_chatwheel_message_sand_king_1"	"Bow to your liege."
"dota_chatwheel_label_sand_king_1"	"Преклонете се пред своя васал."
"[english]dota_chatwheel_label_sand_king_1"	"Bow to your liege."
"dota_chatwheel_message_sand_king_2"	"Песъчлива п-п-победа!"
"[english]dota_chatwheel_message_sand_king_2"	"A Sandy V-V-Victory!"
"dota_chatwheel_label_sand_king_2"	"Песъчлива п-п-победа!"
"[english]dota_chatwheel_label_sand_king_2"	"A Sandy V-V-Victory!"
"dota_chatwheel_message_sand_king_3"	"Къде си мислите, че отивате?"
"[english]dota_chatwheel_message_sand_king_3"	"Where do you think you're going?"
"dota_chatwheel_label_sand_king_3"	"Къде си мислите, че отивате?"
"[english]dota_chatwheel_label_sand_king_3"	"Where do you think you're going?"
"dota_chatwheel_message_sand_king_4"	"Нима очаквахте… Пясъчния човек?"
"[english]dota_chatwheel_message_sand_king_4"	"You were expecting...Sandy Claws?"
"dota_chatwheel_label_sand_king_4"	"Нима очаквахте, Пясъчния човек?"
"[english]dota_chatwheel_label_sand_king_4"	"You were expecting Sandy Claws?"
"dota_chatwheel_message_sand_king_5"	"Добре е да си крал!"
"[english]dota_chatwheel_message_sand_king_5"	"It's good to be King!"
"dota_chatwheel_label_sand_king_5"	"Добре е да си крал"
"[english]dota_chatwheel_label_sand_king_5"	"It's good to be King"
"dota_chatwheel_message_storm_spirit_laugh"	"Хм-хм-хм-хм-хее-хее-хее-ха-ха."
"[english]dota_chatwheel_message_storm_spirit_laugh"	"Hm hm hm hm hee hee hee ha ha."
"dota_chatwheel_label_storm_spirit_laugh"	"Смях"
"[english]dota_chatwheel_label_storm_spirit_laugh"	"Laugh"
"dota_chatwheel_message_storm_spirit_thank"	"Само в този дух!"
"[english]dota_chatwheel_message_storm_spirit_thank"	"That's the spirit!"
"dota_chatwheel_label_storm_spirit_thank"	"Само в този дух!"
"[english]dota_chatwheel_label_storm_spirit_thank"	"That's the spirit!"
"dota_chatwheel_message_storm_spirit_deny"	"Профукахте си шанса!"
"[english]dota_chatwheel_message_storm_spirit_deny"	"You blew it!"
"dota_chatwheel_label_storm_spirit_deny"	"Профукахте си шанса!"
"[english]dota_chatwheel_label_storm_spirit_deny"	"You blew it!"
"dota_chatwheel_message_storm_spirit_1"	"Обичам тази част!"
"[english]dota_chatwheel_message_storm_spirit_1"	"I love this part!"
"dota_chatwheel_label_storm_spirit_1"	"Обичам тази част!"
"[english]dota_chatwheel_label_storm_spirit_1"	"I love this part!"
"dota_chatwheel_message_storm_spirit_2"	"Мен ли търсите?"
"[english]dota_chatwheel_message_storm_spirit_2"	"Lookin for me?"
"dota_chatwheel_label_storm_spirit_2"	"Мен ли търсите?"
"[english]dota_chatwheel_label_storm_spirit_2"	"Lookin for me?"
"dota_chatwheel_message_storm_spirit_3"	"Казах Ви, че се задава буря!"
"[english]dota_chatwheel_message_storm_spirit_3"	"Told you a storm was coming!"
"dota_chatwheel_label_storm_spirit_3"	"Казах Ви, че се задава буря!"
"[english]dota_chatwheel_label_storm_spirit_3"	"Told you a storm was coming!"
"dota_chatwheel_message_storm_spirit_4"	"Добре изглежда!"
"[english]dota_chatwheel_message_storm_spirit_4"	"Looking good!"
"dota_chatwheel_label_storm_spirit_4"	"Добре изглежда!"
"[english]dota_chatwheel_label_storm_spirit_4"	"Looking good!"
"dota_chatwheel_message_storm_spirit_5"	"Великолепно!"
"[english]dota_chatwheel_message_storm_spirit_5"	"Glorious!"
"dota_chatwheel_label_storm_spirit_5"	"Великолепно!"
"[english]dota_chatwheel_label_storm_spirit_5"	"Glorious!"
"dota_chatwheel_message_sven_laugh"	"Ахх-ха-ха-ха! Ха-ха-ха-ха!"
"[english]dota_chatwheel_message_sven_laugh"	"Ahh ha ha ha! Ha ha ha ha!"
"dota_chatwheel_label_sven_laugh"	"Смях"
"[english]dota_chatwheel_label_sven_laugh"	"Laugh"
"dota_chatwheel_message_sven_thank"	"Вие сте истински приятели."
"[english]dota_chatwheel_message_sven_thank"	"You are a true friend."
"dota_chatwheel_label_sven_thank"	"Вие сте истински приятели."
"[english]dota_chatwheel_label_sven_thank"	"You are a true friend."
"dota_chatwheel_message_sven_deny"	"Изглеждате зашеметени."
"[english]dota_chatwheel_message_sven_deny"	"You look stunned."
"dota_chatwheel_label_sven_deny"	"Изглеждате зашеметени."
"[english]dota_chatwheel_label_sven_deny"	"You look stunned."
"dota_chatwheel_message_sven_1"	"Подивелият рицар отнема пореден живот."
"[english]dota_chatwheel_message_sven_1"	"Rogue Knight claims another."
"dota_chatwheel_label_sven_1"	"Подивелият рицар отнема пореден живот."
"[english]dota_chatwheel_label_sven_1"	"Rogue Knight claims another."
"dota_chatwheel_message_sven_2"	"Заслужихте си го."
"[english]dota_chatwheel_message_sven_2"	"You deserved it."
"dota_chatwheel_label_sven_2"	"Заслужихте си го."
"[english]dota_chatwheel_label_sven_2"	"You deserved it."
"dota_chatwheel_message_sven_3"	"Честта ми ме заставя… да злорадствам."
"[english]dota_chatwheel_message_sven_3"	"My honor compels me...to gloat."
"dota_chatwheel_label_sven_3"	"Честта ми ме заставя… да злорадствам."
"[english]dota_chatwheel_label_sven_3"	"My honor compels me...to gloat."
"dota_chatwheel_message_sven_4"	"Очаквано последствие."
"[english]dota_chatwheel_message_sven_4"	"An expected outcome."
"dota_chatwheel_label_sven_4"	"Очаквано последствие."
"[english]dota_chatwheel_label_sven_4"	"An expected outcome."
"dota_chatwheel_message_sven_5"	"Хм… И така, сега както научихме от това."
"[english]dota_chatwheel_message_sven_5"	"Hm...now what do we learn from this."
"dota_chatwheel_label_sven_5"	"Хм… И така, сега както научихме от това."
"[english]dota_chatwheel_label_sven_5"	"Hm...now what do we learn from this."
"dota_chatwheel_message_tiny_laugh"	"Хе-хе-хе-хе-хух-хе-хе-хе."
"[english]dota_chatwheel_message_tiny_laugh"	"Hehehehehuhhehehe."
"dota_chatwheel_label_tiny_laugh"	"Смях"
"[english]dota_chatwheel_label_tiny_laugh"	"Laugh"
"dota_chatwheel_message_tiny_thank"	"Готови ли сте за чакъла?"
"[english]dota_chatwheel_message_tiny_thank"	"Are you ready to rubble?"
"dota_chatwheel_label_tiny_thank"	"Готови ли сте за чакъла?"
"[english]dota_chatwheel_label_tiny_thank"	"Are you ready to rubble?"
"dota_chatwheel_message_tiny_deny"	"Е, я виж ти."
"[english]dota_chatwheel_message_tiny_deny"	"Well, look at that."
"dota_chatwheel_label_tiny_deny"	"Е, я виж ти."
"[english]dota_chatwheel_label_tiny_deny"	"Well, look at that."
"dota_chatwheel_message_tiny_1"	"Канарите се запращат!"
"[english]dota_chatwheel_message_tiny_1"	"Rock em, sock em!"
"dota_chatwheel_label_tiny_1"	"Канарите се запращат!"
"[english]dota_chatwheel_label_tiny_1"	"Rock em, sock em!"
"dota_chatwheel_message_tiny_2"	"Имате камъни в главата."
"[english]dota_chatwheel_message_tiny_2"	"You got rocks in your head."
"dota_chatwheel_label_tiny_2"	"Имате камъни в главата."
"[english]dota_chatwheel_label_tiny_2"	"You got rocks in your head."
"dota_chatwheel_message_tiny_3"	"Извинете ме."
"[english]dota_chatwheel_message_tiny_3"	"My apologies."
"dota_chatwheel_label_tiny_3"	"Извинете ме."
"[english]dota_chatwheel_label_tiny_3"	"My apologies."
"dota_chatwheel_message_tiny_4"	"Не Ви стиска да пробвате камъните."
"[english]dota_chatwheel_message_tiny_4"	"You haven't got the stones."
"dota_chatwheel_label_tiny_4"	"Не Ви стиска да пробвате камъните."
"[english]dota_chatwheel_label_tiny_4"	"You haven't got the stones."
"dota_chatwheel_message_tiny_5"	"Трудно е да си толкова добър."
"[english]dota_chatwheel_message_tiny_5"	"It's hard to be this good."
"dota_chatwheel_label_tiny_5"	"Трудно е да си толкова добър."
"[english]dota_chatwheel_label_tiny_5"	"It's hard to be this good."
"dota_chatwheel_message_vengefulspirit_laugh"	"Хм-ха-ха-ха-ха-ха-ха!"
"[english]dota_chatwheel_message_vengefulspirit_laugh"	"Hm ha ha ha ha ha ha!"
"dota_chatwheel_label_vengefulspirit_laugh"	"Смях"
"[english]dota_chatwheel_label_vengefulspirit_laugh"	"Laugh"
"dota_chatwheel_message_vengefulspirit_thank"	"Толкова сладко…"
"[english]dota_chatwheel_message_vengefulspirit_thank"	"So sweet..."
"dota_chatwheel_label_vengefulspirit_thank"	"Толкова сладко…"
"[english]dota_chatwheel_label_vengefulspirit_thank"	"So sweet..."
"dota_chatwheel_message_vengefulspirit_deny"	"Какво…?"
"[english]dota_chatwheel_message_vengefulspirit_deny"	"What...?"
"dota_chatwheel_label_vengefulspirit_deny"	"Какво…?"
"[english]dota_chatwheel_label_vengefulspirit_deny"	"What...?"
"dota_chatwheel_message_vengefulspirit_1"	"Вече се чувствам по-добре."
"[english]dota_chatwheel_message_vengefulspirit_1"	"I feel better already."
"dota_chatwheel_label_vengefulspirit_1"	"Вече се чувствам по-добре."
"[english]dota_chatwheel_label_vengefulspirit_1"	"I feel better already."
"dota_chatwheel_message_vengefulspirit_2"	"Менкане!"
"[english]dota_chatwheel_message_vengefulspirit_2"	"Swapsies!"
"dota_chatwheel_label_vengefulspirit_2"	"Менкане!"
"[english]dota_chatwheel_label_vengefulspirit_2"	"Swapsies!"
"dota_chatwheel_message_vengefulspirit_3"	"Муа-хах-ха-ха-ха-ха-ха-ха-ха!"
"[english]dota_chatwheel_message_vengefulspirit_3"	"Mwahahhahahahahahaha!"
"dota_chatwheel_label_vengefulspirit_3"	"Муа-хах-ха-ха-ха-ха-ха-ха-ха!"
"[english]dota_chatwheel_label_vengefulspirit_3"	"Mwahahhahahahahahaha!"
"dota_chatwheel_message_vengefulspirit_4"	"Подгответе се за вълната от терор… бу!"
"[english]dota_chatwheel_message_vengefulspirit_4"	"Prepare for the wave of terror: boo!"
"dota_chatwheel_label_vengefulspirit_4"	"Подгответе се за вълната от терор… бу!"
"[english]dota_chatwheel_label_vengefulspirit_4"	"Prepare for the wave of terror: boo!"
"dota_chatwheel_message_vengefulspirit_5"	"Болката на моите враговете е единството удоволствие, което ми е останало."
"[english]dota_chatwheel_message_vengefulspirit_5"	"The pain of my enemies is the only pleasure left to me."
"dota_chatwheel_label_vengefulspirit_5"	"Болката на моите враговете…"
"[english]dota_chatwheel_label_vengefulspirit_5"	"The pain of my enemies..."
"dota_chatwheel_message_windrunner_laugh"	"Хах-ха-ха-ха-ха!"
"[english]dota_chatwheel_message_windrunner_laugh"	"Hah-ha-ha-ha-ha!"
"dota_chatwheel_label_windrunner_laugh"	"Смях"
"[english]dota_chatwheel_label_windrunner_laugh"	"Laugh"
"dota_chatwheel_message_windrunner_thank"	"Леко и безгрижно"
"[english]dota_chatwheel_message_windrunner_thank"	"Easy breezy"
"dota_chatwheel_label_windrunner_thank"	"Леко и безгрижно"
"[english]dota_chatwheel_label_windrunner_thank"	"Easy breezy"
"dota_chatwheel_message_windrunner_deny"	"Не мисля така."
"[english]dota_chatwheel_message_windrunner_deny"	"I don't think so."
"dota_chatwheel_label_windrunner_deny"	"Не мисля така."
"[english]dota_chatwheel_label_windrunner_deny"	"I don't think so."
"dota_chatwheel_message_windrunner_1"	"Би могло да е по-зле. О, я почакайте, не би могло да е."
"[english]dota_chatwheel_message_windrunner_1"	"Could be worse. Oh, wait, no it couldn't."
"dota_chatwheel_label_windrunner_1"	"Би могло да е по-зле…"
"[english]dota_chatwheel_label_windrunner_1"	"Could be worse..."
"dota_chatwheel_message_windrunner_2"	"Никъде няма да ходите."
"[english]dota_chatwheel_message_windrunner_2"	"You're not going anywhere."
"dota_chatwheel_label_windrunner_2"	"Никъде няма да ходите."
"[english]dota_chatwheel_label_windrunner_2"	"You're not going anywhere."
"dota_chatwheel_message_windrunner_3"	"Проклятие, ако не бяхте толкова мъртви, бих Ви простреляла отново."
"[english]dota_chatwheel_message_windrunner_3"	"If you weren't so damned dead, I'd shoot you again."
"dota_chatwheel_label_windrunner_3"	"Проклятие, ако не бяхте толкова мъртви…"
"[english]dota_chatwheel_label_windrunner_3"	"If you weren't so damned dead..."
"dota_chatwheel_message_windrunner_4"	"Кажете ми, че това не се случи току-що."
"[english]dota_chatwheel_message_windrunner_4"	"Tell me this did not just happen."
"dota_chatwheel_label_windrunner_4"	"Кажете ми, че това не се случи току-що."
"[english]dota_chatwheel_label_windrunner_4"	"Tell me this did not just happen."
"dota_chatwheel_message_windrunner_5"	"Ще Ви пратя въздушна целувка."
"[english]dota_chatwheel_message_windrunner_5"	"I blow you a kiss."
"dota_chatwheel_label_windrunner_5"	"Ще Ви пратя въздушна целувка."
"[english]dota_chatwheel_label_windrunner_5"	"I blow you a kiss."
"dota_chatwheel_message_zuus_laugh"	"Ха-ха-ха-ха-ха-ха-ха-ха-ха!"
"[english]dota_chatwheel_message_zuus_laugh"	"Ha ha ha ha ha ha ha ha ha!"
"dota_chatwheel_label_zuus_laugh"	"Смях"
"[english]dota_chatwheel_label_zuus_laugh"	"Laugh"
"dota_chatwheel_message_zuus_thank"	"Мустаците ми се накъдриха, това е нещо хубаво!"
"[english]dota_chatwheel_message_zuus_thank"	"By my whiskers, that's good stuff!"
"dota_chatwheel_label_zuus_thank"	"Това е нещо хубаво!"
"[english]dota_chatwheel_label_zuus_thank"	"That's good stuff!"
"dota_chatwheel_message_zuus_deny"	"Ха-ха-ха-ха-ха. Е, какво очаквахте?"
"[english]dota_chatwheel_message_zuus_deny"	"Ha ha ha ha ha. Well what did you expect?"
"dota_chatwheel_label_zuus_deny"	"Е, какво очаквахте?"
"[english]dota_chatwheel_label_zuus_deny"	"Well what did you expect?"
"dota_chatwheel_message_zuus_1"	"Изчакайте!"
"[english]dota_chatwheel_message_zuus_1"	"Wait for it!"
"dota_chatwheel_label_zuus_1"	"Изчакайте!"
"[english]dota_chatwheel_label_zuus_1"	"Wait for it!"
"dota_chatwheel_message_zuus_2"	"Само това ли е нужно, за да бъдете убити?"
"[english]dota_chatwheel_message_zuus_2"	"That's all it takes to kill you?"
"dota_chatwheel_label_zuus_2"	"Само това ли е нужно…?"
"[english]dota_chatwheel_label_zuus_2"	"That's all it takes..?"
"dota_chatwheel_message_zuus_3"	"О… Това не може да е добре."
"[english]dota_chatwheel_message_zuus_3"	"Oh...this can't be good."
"dota_chatwheel_label_zuus_3"	"Това не може да е добре"
"[english]dota_chatwheel_label_zuus_3"	"This can't be good"
"dota_chatwheel_message_zuus_4"	"Гръмки аплодисменти!"
"[english]dota_chatwheel_message_zuus_4"	"Thund'rous applause!"
"dota_chatwheel_label_zuus_4"	"Гръмки аплодисменти!"
"[english]dota_chatwheel_label_zuus_4"	"Thund'rous applause!"
"dota_chatwheel_message_zuus_5"	"Нима си помислихте, че можете да скриете от бог?"
"[english]dota_chatwheel_message_zuus_5"	"Did you think you could hide from a god?"
"dota_chatwheel_label_zuus_5"	"Нима си помислихте, че можете да скриете?"
"[english]dota_chatwheel_label_zuus_5"	"Did you think you could hide?"
"dota_chatwheel_message_kunkka_laugh"	"Хе-ху-ху-ху-ху-хух-ху-ха!"
"[english]dota_chatwheel_message_kunkka_laugh"	"He-hu-hu-hu-hu-huhhuha!"
"dota_chatwheel_label_kunkka_laugh"	"Смях"
"[english]dota_chatwheel_label_kunkka_laugh"	"Laugh"
"dota_chatwheel_message_kunkka_thank"	"Вие сте надеждни другари!"
"[english]dota_chatwheel_message_kunkka_thank"	"You're a trusty mate!"
"dota_chatwheel_label_kunkka_thank"	"Вие сте надеждни другари!"
"[english]dota_chatwheel_label_kunkka_thank"	"You're a trusty mate!"
"dota_chatwheel_message_kunkka_deny"	"Отправяйте се директно към дъното!"
"[english]dota_chatwheel_message_kunkka_deny"	"Straight to the bottom with ya!"
"dota_chatwheel_label_kunkka_deny"	"Отправяйте се директно към дъното!"
"[english]dota_chatwheel_label_kunkka_deny"	"Straight to the bottom with ya!"
"dota_chatwheel_message_kunkka_1"	"Не Ви стиска."
"[english]dota_chatwheel_message_kunkka_1"	"You don't have the sand."
"dota_chatwheel_label_kunkka_1"	"Не Ви стиска."
"[english]dota_chatwheel_label_kunkka_1"	"You don't have the sand."
"dota_chatwheel_message_kunkka_2"	"Хех! Човек зад борда!"
"[english]dota_chatwheel_message_kunkka_2"	"Heh! Man overboard!"
"dota_chatwheel_label_kunkka_2"	"Хех! Човек зад борда!"
"[english]dota_chatwheel_label_kunkka_2"	"Heh! Man overboard!"
"dota_chatwheel_message_kunkka_3"	"Всички сте гола вода!"
"[english]dota_chatwheel_message_kunkka_3"	"You're all washed up!"
"dota_chatwheel_label_kunkka_3"	"Всички сте гола вода!"
"[english]dota_chatwheel_label_kunkka_3"	"You're all washed up!"
"dota_chatwheel_message_kunkka_4"	"Просто за да сме наясно, ако Ви нарека друже, не го казвам буквално."
"[english]dota_chatwheel_message_kunkka_4"	"Just to be clear, if I call you mate, I don't mean it literally."
"dota_chatwheel_label_kunkka_4"	"Просто за да сме наясно…"
"[english]dota_chatwheel_label_kunkka_4"	"Just to be clear..."
"dota_chatwheel_message_kunkka_5"	"Бяхте отплавали към провала."
"[english]dota_chatwheel_message_kunkka_5"	"You set sail for fail."
"dota_chatwheel_label_kunkka_5"	"Бяхте отплавали към провала."
"[english]dota_chatwheel_label_kunkka_5"	"You set sail for fail."
"dota_chatwheel_message_lina_laugh"	"Ха-ха-ха-ха-ха-ха-ха!"
"[english]dota_chatwheel_message_lina_laugh"	"Ha ha ha ha ha ha ha!"
"dota_chatwheel_label_lina_laugh"	"Смях"
"[english]dota_chatwheel_label_lina_laugh"	"Laugh"
"dota_chatwheel_message_lina_thank"	"Това беше пламенно!"
"[english]dota_chatwheel_message_lina_thank"	"That was hot!"
"dota_chatwheel_label_lina_thank"	"Това беше пламенно!"
"[english]dota_chatwheel_label_lina_thank"	"That was hot!"
"dota_chatwheel_message_lina_deny"	"Пари, нали?"
"[english]dota_chatwheel_message_lina_deny"	"Burns, doesn't it?"
"dota_chatwheel_label_lina_deny"	"Пари, нали?"
"[english]dota_chatwheel_label_lina_deny"	"Burns, doesn't it?"
"dota_chatwheel_message_lina_1"	"Това не беше особено блестящо."
"[english]dota_chatwheel_message_lina_1"	"That wasn't too bright."
"dota_chatwheel_label_lina_1"	"Това не беше особено блестящо."
"[english]dota_chatwheel_label_lina_1"	"That wasn't too bright."
"dota_chatwheel_message_lina_2"	"Искате ли да си поиграете с огъня?"
"[english]dota_chatwheel_message_lina_2"	"Wanna play with fire?"
"dota_chatwheel_label_lina_2"	"Искате ли да си поиграете с огъня?"
"[english]dota_chatwheel_label_lina_2"	"Wanna play with fire?"
"dota_chatwheel_message_lina_3"	"Що за балама."
"[english]dota_chatwheel_message_lina_3"	"What a punk."
"dota_chatwheel_label_lina_3"	"Що за балама."
"[english]dota_chatwheel_label_lina_3"	"What a punk."
"dota_chatwheel_message_lina_4"	"Мътните да ме вземат?"
"[english]dota_chatwheel_message_lina_4"	"What in the blazes?"
"dota_chatwheel_label_lina_4"	"Мътните да ме вземат?"
"[english]dota_chatwheel_label_lina_4"	"What in the blazes?"
"dota_chatwheel_message_lina_5"	"Елате при мама!"
"[english]dota_chatwheel_message_lina_5"	"Come to mama!"
"dota_chatwheel_label_lina_5"	"Елате при мама!"
"[english]dota_chatwheel_label_lina_5"	"Come to mama!"
"dota_chatwheel_message_lion_laugh"	"Уха-ха-ха-ха-ха-ха-ха-хе-хаа-ха!"
"[english]dota_chatwheel_message_lion_laugh"	"Who-ha-ha-ha-ha-ha-ha-he-hawha!"
"dota_chatwheel_label_lion_laugh"	"Смях"
"[english]dota_chatwheel_label_lion_laugh"	"Laugh"
"dota_chatwheel_message_lion_thank"	"О, да, по дяволите."
"[english]dota_chatwheel_message_lion_thank"	"Oh, hell yes."
"dota_chatwheel_label_lion_thank"	"О, да, по дяволите."
"[english]dota_chatwheel_label_lion_thank"	"Oh, hell yes."
"dota_chatwheel_message_lion_deny"	"Ах, съжалявам, че Ви разочаровам."
"[english]dota_chatwheel_message_lion_deny"	"Ah, sorry to disappoint you."
"dota_chatwheel_label_lion_deny"	"Ах, съжалявам, че Ви разочаровам."
"[english]dota_chatwheel_label_lion_deny"	"Ah, sorry to disappoint you."
"dota_chatwheel_message_lion_1"	"Помислихте си, че ще опитомите лъва?"
"[english]dota_chatwheel_message_lion_1"	"You thought to tame the lion?"
"dota_chatwheel_label_lion_1"	"Помислихте си, че ще опитомите лъва?"
"[english]dota_chatwheel_label_lion_1"	"You thought to tame the lion?"
"dota_chatwheel_message_lion_2"	"Почувствайте яростта на магьосника!"
"[english]dota_chatwheel_message_lion_2"	"Feel the rage of a mage!"
"dota_chatwheel_label_lion_2"	"Почувствайте яростта на магьосника!"
"[english]dota_chatwheel_label_lion_2"	"Feel the rage of a mage!"
"dota_chatwheel_message_lion_3"	"Дяволите да Ви вземат!"
"[english]dota_chatwheel_message_lion_3"	"To hell with you!"
"dota_chatwheel_label_lion_3"	"Дяволите да Ви вземат!"
"[english]dota_chatwheel_label_lion_3"	"To hell with you!"
"dota_chatwheel_message_lion_4"	"Имам магическия допир."
"[english]dota_chatwheel_message_lion_4"	"I've got the magic touch."
"dota_chatwheel_label_lion_4"	"Имам магическия допир."
"[english]dota_chatwheel_label_lion_4"	"I've got the magic touch."
"dota_chatwheel_message_lion_5"	"Бил съм до ада и обратно… А след това пак в ада… и отново обратно."
"[english]dota_chatwheel_message_lion_5"	"I've been to hell and back, and back to hell...and back."
"dota_chatwheel_label_lion_5"	"Бил съм до ада и обратно…"
"[english]dota_chatwheel_label_lion_5"	"I've been to hell and back..."
"dota_chatwheel_message_shadow_shaman_laugh"	"Ха-ха-ха!"
"[english]dota_chatwheel_message_shadow_shaman_laugh"	"Ha ha ha!"
"dota_chatwheel_label_shadow_shaman_laugh"	"Смях"
"[english]dota_chatwheel_label_shadow_shaman_laugh"	"Laugh"
"dota_chatwheel_message_shadow_shaman_thank"	"Молитвите ми получиха отговор."
"[english]dota_chatwheel_message_shadow_shaman_thank"	"My prayers are answered."
"dota_chatwheel_label_shadow_shaman_thank"	"Молитвите ми получиха отговор."
"[english]dota_chatwheel_label_shadow_shaman_thank"	"My prayers are answered."
"dota_chatwheel_message_shadow_shaman_deny"	"Кудкудяк, кудкудяк!"
"[english]dota_chatwheel_message_shadow_shaman_deny"	"Bukaw, bukaw!"
"dota_chatwheel_label_shadow_shaman_deny"	"Кудкудяк, кудкудяк!"
"[english]dota_chatwheel_label_shadow_shaman_deny"	"Bukaw, bukaw!"
"dota_chatwheel_message_shadow_shaman_1"	"За Вас виждам бъдеще, изпълнено със смърт!"
"[english]dota_chatwheel_message_shadow_shaman_1"	"I see for you a future full of death!"
"dota_chatwheel_label_shadow_shaman_1"	"За Вас виждам бъдеще…"
"[english]dota_chatwheel_label_shadow_shaman_1"	"I see for you a future..."
"dota_chatwheel_message_shadow_shaman_2"	"Никъде няма да ходите."
"[english]dota_chatwheel_message_shadow_shaman_2"	"You're not going anywhere."
"dota_chatwheel_label_shadow_shaman_2"	"Никъде няма да ходите."
"[english]dota_chatwheel_label_shadow_shaman_2"	"You're not going anywhere."
"dota_chatwheel_message_shadow_shaman_3"	"Хех-ха-ха-хах, колко ободрително!"
"[english]dota_chatwheel_message_shadow_shaman_3"	"Heh ha ha hah, how refreshing!"
"dota_chatwheel_label_shadow_shaman_3"	"Хех-ха-ха-хах, колко ободрително!"
"[english]dota_chatwheel_label_shadow_shaman_3"	"Heh ha ha hah, how refreshing!"
"dota_chatwheel_message_shadow_shaman_4"	"Има вкус на пилешко!"
"[english]dota_chatwheel_message_shadow_shaman_4"	"Tastes like chicken!"
"dota_chatwheel_label_shadow_shaman_4"	"Има вкус на пилешко!"
"[english]dota_chatwheel_label_shadow_shaman_4"	"Tastes like chicken!"
"dota_chatwheel_message_shadow_shaman_5"	"Ау-мосу-атикану!"
"[english]dota_chatwheel_message_shadow_shaman_5"	"Au-mosu-atikanu!"
"dota_chatwheel_label_shadow_shaman_5"	"Ау-мосу-атикану!"
"[english]dota_chatwheel_label_shadow_shaman_5"	"Au-mosu-atikanu!"
"dota_chatwheel_message_slardar_laugh"	"Хех-хеех-хех-хах-хах-ха-хах-хах!"
"[english]dota_chatwheel_message_slardar_laugh"	"Heh heeh heh hah hah ha hah hah!"
"dota_chatwheel_label_slardar_laugh"	"Смях"
"[english]dota_chatwheel_label_slardar_laugh"	"Laugh"
"dota_chatwheel_message_slardar_thank"	"Пълен погром."
"[english]dota_chatwheel_message_slardar_thank"	"Total spawnage."
"dota_chatwheel_label_slardar_thank"	"Пълен погром."
"[english]dota_chatwheel_label_slardar_thank"	"Total spawnage."
"dota_chatwheel_message_slardar_deny"	"Дълбоко Ви съчувствам."
"[english]dota_chatwheel_message_slardar_deny"	"My deepest sympathies."
"dota_chatwheel_label_slardar_deny"	"Дълбоко Ви съчувствам."
"[english]dota_chatwheel_label_slardar_deny"	"My deepest sympathies."
"dota_chatwheel_message_slardar_1"	"Изминал съм дълъг път, за да видя как умирате."
"[english]dota_chatwheel_message_slardar_1"	"I came a long way to see you die."
"dota_chatwheel_label_slardar_1"	"Изминал съм дълъг път…"
"[english]dota_chatwheel_label_slardar_1"	"I came a long way..."
"dota_chatwheel_message_slardar_2"	"Няма да избягате."
"[english]dota_chatwheel_message_slardar_2"	"You won't escape."
"dota_chatwheel_label_slardar_2"	"Няма да избягате."
"[english]dota_chatwheel_label_slardar_2"	"You won't escape."
"dota_chatwheel_message_slardar_3"	"Спипах Ви."
"[english]dota_chatwheel_message_slardar_3"	"Jig's up."
"dota_chatwheel_label_slardar_3"	"Спипах Ви."
"[english]dota_chatwheel_label_slardar_3"	"Jig's up."
"dota_chatwheel_message_slardar_4"	"Не бяхте в свои води."
"[english]dota_chatwheel_message_slardar_4"	"You were out of your depth."
"dota_chatwheel_label_slardar_4"	"Не бяхте в свои води."
"[english]dota_chatwheel_label_slardar_4"	"You were out of your depth."
"dota_chatwheel_message_slardar_5"	"О, как ще се гощават дълбоките!"
"[english]dota_chatwheel_message_slardar_5"	"Oh, how the deep ones will feast!"
"dota_chatwheel_label_slardar_5"	"О, как ще се гощават дълбоките!"
"[english]dota_chatwheel_label_slardar_5"	"Oh, how the deep ones will feast!"
"dota_chatwheel_message_tidehunter_laugh"	"Ах-ха-ха-ха!"
"[english]dota_chatwheel_message_tidehunter_laugh"	"Ah ha ha ha!"
"dota_chatwheel_label_tidehunter_laugh"	"Смях"
"[english]dota_chatwheel_label_tidehunter_laugh"	"Laugh"
"dota_chatwheel_message_tidehunter_thank"	"Ще обърнем този прилив в наша полза."
"[english]dota_chatwheel_message_tidehunter_thank"	"We'll turn this tide to our advantage."
"dota_chatwheel_label_tidehunter_thank"	"Ще обърнем този прилив в наша полза."
"[english]dota_chatwheel_label_tidehunter_thank"	"We'll turn this tide to our advantage."
"dota_chatwheel_message_tidehunter_deny"	"Изглеждате опустошени."
"[english]dota_chatwheel_message_tidehunter_deny"	"You look ravaged."
"dota_chatwheel_label_tidehunter_deny"	"Изглеждате опустошени."
"[english]dota_chatwheel_label_tidehunter_deny"	"You look ravaged."
"dota_chatwheel_message_tidehunter_1"	"Ха-ха-ха-ха-ха-ха. Вече сте храна за рибите."
"[english]dota_chatwheel_message_tidehunter_1"	"Ha ha ha ha ha ha, Now you're fish food."
"dota_chatwheel_label_tidehunter_1"	"Вече сте храна за рибите."
"[english]dota_chatwheel_label_tidehunter_1"	"Now you're fish food."
"dota_chatwheel_message_tidehunter_2"	"Ха-ха, бих могъл да изям морж."
"[english]dota_chatwheel_message_tidehunter_2"	"Ha ha I could eat a walrus."
"dota_chatwheel_label_tidehunter_2"	"Ха-ха, бих могъл да изям морж."
"[english]dota_chatwheel_label_tidehunter_2"	"Ha ha I could eat a walrus."
"dota_chatwheel_message_tidehunter_3"	"Затапете това."
"[english]dota_chatwheel_message_tidehunter_3"	"Put a cork in it."
"dota_chatwheel_label_tidehunter_3"	"Затапете това."
"[english]dota_chatwheel_label_tidehunter_3"	"Put a cork in it."
"dota_chatwheel_message_tidehunter_4"	"Нима си помислихте, че ще допусна груба грешка? Сигурно погрешно сте ме взели за Kunkka."
"[english]dota_chatwheel_message_tidehunter_4"	"Did you think I'd blunder? You must have mistaken me for Kunkka."
"dota_chatwheel_label_tidehunter_4"	"Нима си помислихте, че ще допусна груба грешка…?"
"[english]dota_chatwheel_label_tidehunter_4"	"Did you think I'd blunder?..."
"dota_chatwheel_message_tidehunter_5"	"Кому е нужен голям мозък, когато имате зъби като моите?"
"[english]dota_chatwheel_message_tidehunter_5"	"Who needs a big brain when you've got teeth like mine?"
"dota_chatwheel_label_tidehunter_5"	"Кому е нужен голям мозък…?"
"[english]dota_chatwheel_label_tidehunter_5"	"Who needs a big brain...?"
"dota_chatwheel_message_witch_doctor_laugh"	"Хоо-хах-хоо-хоо-хах."
"[english]dota_chatwheel_message_witch_doctor_laugh"	"Hoo hah hoo hoo hah."
"dota_chatwheel_label_witch_doctor_laugh"	"Смях"
"[english]dota_chatwheel_label_witch_doctor_laugh"	"Laugh"
"dota_chatwheel_message_witch_doctor_thank"	"Чувствам се добре, човече."
"[english]dota_chatwheel_message_witch_doctor_thank"	"Feeling good, man."
"dota_chatwheel_label_witch_doctor_thank"	"Чувствам се добре, човече."
"[english]dota_chatwheel_label_witch_doctor_thank"	"Feeling good, man."
"dota_chatwheel_message_witch_doctor_deny"	"Изчакайте… изчакайте…"
"[english]dota_chatwheel_message_witch_doctor_deny"	"Wait for it...wait for it..."
"dota_chatwheel_label_witch_doctor_deny"	"Изчакайте… изчакайте…"
"[english]dota_chatwheel_label_witch_doctor_deny"	"Wait for it...wait for it..."
"dota_chatwheel_message_witch_doctor_1"	"Т'ва ще направи голяма бъркотия."
"[english]dota_chatwheel_message_witch_doctor_1"	"Dat make a big mess."
"dota_chatwheel_label_witch_doctor_1"	"Т'ва ще направи голяма бъркотия."
"[english]dota_chatwheel_label_witch_doctor_1"	"Dat make a big mess."
"dota_chatwheel_message_witch_doctor_2"	"Някой повика ли доктора?"
"[english]dota_chatwheel_message_witch_doctor_2"	"Someone call de doctor?"
"dota_chatwheel_label_witch_doctor_2"	"Някой повика ли доктора?"
"[english]dota_chatwheel_label_witch_doctor_2"	"Someone call de doctor?"
"dota_chatwheel_message_witch_doctor_3"	"О, я виж ти."
"[english]dota_chatwheel_message_witch_doctor_3"	"Oh, look at it go."
"dota_chatwheel_label_witch_doctor_3"	"О, я виж ти."
"[english]dota_chatwheel_label_witch_doctor_3"	"Oh, look at it go."
"dota_chatwheel_message_witch_doctor_4"	"Само кокали останаха. Това е то, дотук сте."
"[english]dota_chatwheel_message_witch_doctor_4"	"Stick a bone in it. You're done."
"dota_chatwheel_label_witch_doctor_4"	"Само кокали останаха. Това е то, дотук сте."
"[english]dota_chatwheel_label_witch_doctor_4"	"Stick a bone in it. You're done."
"dota_chatwheel_message_witch_doctor_5"	"О, дааааааа."
"[english]dota_chatwheel_message_witch_doctor_5"	"Oyeaaaaah."
"dota_chatwheel_label_witch_doctor_5"	"О, дааааааа."
"[english]dota_chatwheel_label_witch_doctor_5"	"Oyeaaaaah."
"dota_chatwheel_message_lich_laugh"	"Ха-ха-ха-ха-ха-ха-ха-ха!"
"[english]dota_chatwheel_message_lich_laugh"	"Ha ha ha ha ha ha ha ha!"
"dota_chatwheel_label_lich_laugh"	"Смях"
"[english]dota_chatwheel_label_lich_laugh"	"Laugh"
"dota_chatwheel_message_lich_thank"	"Бъдете хладнокръвни!"
"[english]dota_chatwheel_message_lich_thank"	"Stay frosty!"
"dota_chatwheel_label_lich_thank"	"Бъдете хладнокръвни!"
"[english]dota_chatwheel_label_lich_thank"	"Stay frosty!"
"dota_chatwheel_message_lich_deny"	"Внимавайте къде ходите, следващото стъпало е на два метра дълбочина."
"[english]dota_chatwheel_message_lich_deny"	"Watch your step, it's six feet down."
"dota_chatwheel_label_lich_deny"	"Внимавайте къде ходите…"
"[english]dota_chatwheel_label_lich_deny"	"Watch your step..."
"dota_chatwheel_message_lich_1"	"Не можете да убиете мъртвите."
"[english]dota_chatwheel_message_lich_1"	"Can't kill the dead."
"dota_chatwheel_label_lich_1"	"Не можете да убиете мъртвите."
"[english]dota_chatwheel_label_lich_1"	"Can't kill the dead."
"dota_chatwheel_message_lich_2"	"Изтръпвате ли?"
"[english]dota_chatwheel_message_lich_2"	"Does it tingle?"
"dota_chatwheel_label_lich_2"	"Изтръпвате ли?"
"[english]dota_chatwheel_label_lich_2"	"Does it tingle?"
"dota_chatwheel_message_lich_3"	"Почувствайте хладната ми прегръдка!"
"[english]dota_chatwheel_message_lich_3"	"Feel my cold embrace!"
"dota_chatwheel_label_lich_3"	"Почувствайте хладната ми прегръдка!"
"[english]dota_chatwheel_label_lich_3"	"Feel my cold embrace!"
"dota_chatwheel_message_lich_4"	"Кой сега е номер едно?"
"[english]dota_chatwheel_message_lich_4"	"Who's the number one now?"
"dota_chatwheel_label_lich_4"	"Кой сега е номер едно?"
"[english]dota_chatwheel_label_lich_4"	"Who's the number one now?"
"dota_chatwheel_message_lich_5"	"A, Ice Frog!"
"[english]dota_chatwheel_message_lich_5"	"Ah, Ice Frog!"
"dota_chatwheel_label_lich_5"	"A, Ice Frog!"
"[english]dota_chatwheel_label_lich_5"	"Ah, Ice Frog!"
"dota_chatwheel_message_riki_laugh"	"Хоо-хоо-хоо-хоо-хоо-хоо-хоо."
"[english]dota_chatwheel_message_riki_laugh"	"hoo hoo hoo hoo hoo hoo hoo."
"dota_chatwheel_label_riki_laugh"	"Смях"
"[english]dota_chatwheel_label_riki_laugh"	"Laugh"
"dota_chatwheel_message_riki_thank"	"Договорът е завършен."
"[english]dota_chatwheel_message_riki_thank"	"Contract complete."
"dota_chatwheel_label_riki_thank"	"Договорът е завършен."
"[english]dota_chatwheel_label_riki_thank"	"Contract complete."
"dota_chatwheel_message_riki_deny"	"Хех-хо, това не го очаквахте."
"[english]dota_chatwheel_message_riki_deny"	"Heh-ho, you didn't see that coming."
"dota_chatwheel_label_riki_deny"	"Това не го очаквахте."
"[english]dota_chatwheel_label_riki_deny"	"You didn't see that coming."
"dota_chatwheel_message_riki_1"	"Защо удължавате неизбежното?"
"[english]dota_chatwheel_message_riki_1"	"Why prolong the inevitable?"
"dota_chatwheel_label_riki_1"	"Защо удължавате неизбежното?"
"[english]dota_chatwheel_label_riki_1"	"Why prolong the inevitable?"
"dota_chatwheel_message_riki_2"	"Куку."
"[english]dota_chatwheel_message_riki_2"	"Peek-a-boo."
"dota_chatwheel_label_riki_2"	"Куку."
"[english]dota_chatwheel_label_riki_2"	"Peek-aboo."
"dota_chatwheel_message_riki_3"	"Ако ме виждате, значи вече сте мъртви."
"[english]dota_chatwheel_message_riki_3"	"If you can see me, you're already dead."
"dota_chatwheel_label_riki_3"	"Ако ме виждате…"
"[english]dota_chatwheel_label_riki_3"	"If you can see me..."
"dota_chatwheel_message_riki_4"	"Бях тук през цялото време."
"[english]dota_chatwheel_message_riki_4"	"I've been here the whole time."
"dota_chatwheel_label_riki_4"	"Бях тук през цялото време."
"[english]dota_chatwheel_label_riki_4"	"I've been here the whole time."
"dota_chatwheel_message_riki_5"	"О, мъртви сте. Каква изненада."
"[english]dota_chatwheel_message_riki_5"	"Oh you're dead. What a surprise."
"dota_chatwheel_label_riki_5"	"О, мъртви сте. Каква изненада."
"[english]dota_chatwheel_label_riki_5"	"Oh you're dead. What a surprise."
"dota_chatwheel_message_enigma_laugh"	"Хе-хе-хъх-хех-хех."
"[english]dota_chatwheel_message_enigma_laugh"	"He-he-huh-heh-heh."
"dota_chatwheel_label_enigma_laugh"	"Смях"
"[english]dota_chatwheel_label_enigma_laugh"	"Laugh"
"dota_chatwheel_message_enigma_thank"	"Е, това е парадокс."
"[english]dota_chatwheel_message_enigma_thank"	"Well, this is a paradox."
"dota_chatwheel_label_enigma_thank"	"Е, това е парадокс."
"[english]dota_chatwheel_label_enigma_thank"	"Well, this is a paradox."
"dota_chatwheel_message_enigma_deny"	"Астрономическа цена."
"[english]dota_chatwheel_message_enigma_deny"	"An astronomical price."
"dota_chatwheel_label_enigma_deny"	"Астрономическа цена."
"[english]dota_chatwheel_label_enigma_deny"	"An astronomical price."
"dota_chatwheel_message_enigma_1"	"Взрете се в бездната."
"[english]dota_chatwheel_message_enigma_1"	"Stare into the abyss."
"dota_chatwheel_label_enigma_1"	"Взрете се в бездната."
"[english]dota_chatwheel_label_enigma_1"	"Stare into the abyss."
"dota_chatwheel_message_enigma_2"	"Мълчанието е златно."
"[english]dota_chatwheel_message_enigma_2"	"Silence is golden."
"dota_chatwheel_label_enigma_2"	"Мълчанието е златно."
"[english]dota_chatwheel_label_enigma_2"	"Silence is golden."
"dota_chatwheel_message_enigma_3"	"Не можете да се сравнявате с мен."
"[english]dota_chatwheel_message_enigma_3"	"You are beneath me."
"dota_chatwheel_label_enigma_3"	"Не можете да се сравнявате с мен."
"[english]dota_chatwheel_label_enigma_3"	"You are beneath me."
"dota_chatwheel_message_enigma_4"	"Приветствана манифестация на произволността."
"[english]dota_chatwheel_message_enigma_4"	"A welcome manifestation of randomness."
"dota_chatwheel_label_enigma_4"	"Приветствана манифестация на произволността."
"[english]dota_chatwheel_label_enigma_4"	"A welcome manifestation of randomness."
"dota_chatwheel_message_enigma_5"	"Ако светлината не може да ми убегне, на какво се надявате Вие?"
"[english]dota_chatwheel_message_enigma_5"	"If light cannot escape me, what hope have you?"
"dota_chatwheel_label_enigma_5"	"Ако светлината не може да ми убегне…"
"[english]dota_chatwheel_label_enigma_5"	"If light cannot escape me..."
"dota_chatwheel_message_tinker_laugh"	"Ах-ха-ха-ха-ха!"
"[english]dota_chatwheel_message_tinker_laugh"	"Ah ha ha ha ha!"
"dota_chatwheel_label_tinker_laugh"	"Смях"
"[english]dota_chatwheel_label_tinker_laugh"	"Laugh"
"dota_chatwheel_message_tinker_thank"	"Талантливостта Ви надминава Вашия чар."
"[english]dota_chatwheel_message_tinker_thank"	"Your talents surpass your loveliness."
"dota_chatwheel_label_tinker_thank"	"Талантливостта Ви надминава Вашия чар."
"[english]dota_chatwheel_label_tinker_thank"	"Your talents surpass your loveliness."
"dota_chatwheel_message_tinker_deny"	"Е, ако и това не е нещо!"
"[english]dota_chatwheel_message_tinker_deny"	"Well isn't that something!"
"dota_chatwheel_label_tinker_deny"	"Е, ако и това не е нещо!"
"[english]dota_chatwheel_label_tinker_deny"	"Well isn't that something!"
"dota_chatwheel_message_tinker_1"	"Пиу, пиу, пиу, пиу, пиу!"
"[english]dota_chatwheel_message_tinker_1"	"Pew, pew, pew pew pew!"
"dota_chatwheel_label_tinker_1"	"Пиу, пиу, пиу, пиу, пиу!"
"[english]dota_chatwheel_label_tinker_1"	"Pew, pew, pew pew pew!"
"dota_chatwheel_message_tinker_2"	"Предсказах всичко това, разбирате ли? Всичкото!"
"[english]dota_chatwheel_message_tinker_2"	"I predicted all of this you know, all of it!"
"dota_chatwheel_label_tinker_2"	"Предсказах всичко това, разбирате ли…"
"[english]dota_chatwheel_label_tinker_2"	"I predicted all of this you know..."
"dota_chatwheel_message_tinker_3"	"Това беше гениално!"
"[english]dota_chatwheel_message_tinker_3"	"That was genius!"
"dota_chatwheel_label_tinker_3"	"Това беше гениално!"
"[english]dota_chatwheel_label_tinker_3"	"That was genius!"
"dota_chatwheel_message_tinker_4"	"Ще нарека този експеримент, неуспешен."
"[english]dota_chatwheel_message_tinker_4"	"I'm going to call that experiment, a failure."
"dota_chatwheel_label_tinker_4"	"Ще нарека този експеримент…"
"[english]dota_chatwheel_label_tinker_4"	"I'm going to call that experiment..."
"dota_chatwheel_message_tinker_5"	"Задръжте си магията, имам лазерни лъчи!"
"[english]dota_chatwheel_message_tinker_5"	"You can keep your magic, I have laser beams!"
"dota_chatwheel_label_tinker_5"	"Задръжте си магията…"
"[english]dota_chatwheel_label_tinker_5"	"You can keep your magic..."
"dota_chatwheel_message_sniper_laugh"	"Хее-хее-хее-хее-хее-хее-хее-хее-хее-хее!"
"[english]dota_chatwheel_message_sniper_laugh"	"Hee hee hee hee hee hee hee hee hee hee!"
"dota_chatwheel_label_sniper_laugh"	"Смях"
"[english]dota_chatwheel_label_sniper_laugh"	"Laugh"
"dota_chatwheel_message_sniper_thank"	"Упражняването по цели се отплаща!"
"[english]dota_chatwheel_message_sniper_thank"	"Target practice, payin' off!"
"dota_chatwheel_label_sniper_thank"	"Упражняването по цели се отплаща!"
"[english]dota_chatwheel_label_sniper_thank"	"Target practice, payin' off!"
"dota_chatwheel_message_sniper_deny"	"Какво по…?"
"[english]dota_chatwheel_message_sniper_deny"	"What the---?"
"dota_chatwheel_label_sniper_deny"	"Какво по…?"
"[english]dota_chatwheel_label_sniper_deny"	"What the---?"
"dota_chatwheel_message_sniper_1"	"Сбогувайте се с главата си!"
"[english]dota_chatwheel_message_sniper_1"	"Say goodbye to your head!"
"dota_chatwheel_label_sniper_1"	"Сбогувайте се с главата си!"
"[english]dota_chatwheel_label_sniper_1"	"Say goodbye to your head!"
"dota_chatwheel_message_sniper_2"	"Танцувайте! Ха-ха-ха-ха! Танцувайте!"
"[english]dota_chatwheel_message_sniper_2"	"Dance! Ha ha ha ha! Dance!"
"dota_chatwheel_label_sniper_2"	"Танцувайте! Ха-ха-ха-ха! Танцувайте!"
"[english]dota_chatwheel_label_sniper_2"	"Dance! Ha ha ha ha! Dance!"
"dota_chatwheel_message_sniper_3"	"Защо се усмихвам ли? Така изглежда лекомислената стрелба с оръжие."
"[english]dota_chatwheel_message_sniper_3"	"Why am I smiling? This is what trigger-happy looks like."
"dota_chatwheel_label_sniper_3"	"Защо се усмихвам ли…?"
"[english]dota_chatwheel_label_sniper_3"	"Why am I smiling?..."
"dota_chatwheel_message_sniper_4"	"Какъв глупчо!"
"[english]dota_chatwheel_message_sniper_4"	"What a dum-dum!"
"dota_chatwheel_label_sniper_4"	"Какъв глупчо"
"[english]dota_chatwheel_label_sniper_4"	"What a dumb dumb"
"dota_chatwheel_message_sniper_5"	"Хо-хо-ха-ха!"
"[english]dota_chatwheel_message_sniper_5"	"Ho ho ha ha!"
"dota_chatwheel_label_sniper_5"	"Хо-хо-ха-ха!"
"[english]dota_chatwheel_label_sniper_5"	"Ho ho ha ha!"
"dota_chatwheel_message_necrolyte_laugh"	"Ха-ха-ха-ха-ха-ха-ха-ха-ха-ха-ха-ха!"
"[english]dota_chatwheel_message_necrolyte_laugh"	"Ha ha ha ha ha ha ha ha ha ha ha ha!"
"dota_chatwheel_label_necrolyte_laugh"	"Смях"
"[english]dota_chatwheel_label_necrolyte_laugh"	"Laugh"
"dota_chatwheel_message_necrolyte_thank"	"Вдишайте."
"[english]dota_chatwheel_message_necrolyte_thank"	"Breathe it in."
"dota_chatwheel_label_necrolyte_thank"	"Вдишайте."
"[english]dota_chatwheel_label_necrolyte_thank"	"Breathe it in."
"dota_chatwheel_message_necrolyte_deny"	"Това беше скъпичко."
"[english]dota_chatwheel_message_necrolyte_deny"	"That was costly."
"dota_chatwheel_label_necrolyte_deny"	"Това беше скъпичко."
"[english]dota_chatwheel_label_necrolyte_deny"	"That was costly."
"dota_chatwheel_message_necrolyte_1"	"Зловонието на смъртта е надвиснало връз Вас."
"[english]dota_chatwheel_message_necrolyte_1"	"The stench of death is upon you."
"dota_chatwheel_label_necrolyte_1"	"Зловонието на смъртта е надвиснало връз Вас."
"[english]dota_chatwheel_label_necrolyte_1"	"The stench of death is upon you."
"dota_chatwheel_message_necrolyte_2"	"Какво имате предвид с това да се развеселя? Аз съм доста весел."
"[english]dota_chatwheel_message_necrolyte_2"	"What do you mean, cheer up? I'm quite cheerful."
"dota_chatwheel_label_necrolyte_2"	"Какво имате предвид с това да се развеселя…?"
"[english]dota_chatwheel_label_necrolyte_2"	"What do you mean, cheer up?..."
"dota_chatwheel_message_necrolyte_3"	"Всичко стана калпаво."
"[english]dota_chatwheel_message_necrolyte_3"	"It's all gone rotten."
"dota_chatwheel_label_necrolyte_3"	"Всичко стана калпаво."
"[english]dota_chatwheel_label_necrolyte_3"	"It's all gone rotten."
"dota_chatwheel_message_necrolyte_4"	"За Ваше здраве. Ха-ха-ха-ха-ха-ха-ха-ха-ха."
"[english]dota_chatwheel_message_necrolyte_4"	"To your health. Ha ha ha ha ha ha ha ha ha."
"dota_chatwheel_label_necrolyte_4"	"За Ваше здраве…"
"[english]dota_chatwheel_label_necrolyte_4"	"To your health..."
"dota_chatwheel_message_necrolyte_5"	"Аз съм изгнилата ябълка, която разваля целия куп."
"[english]dota_chatwheel_message_necrolyte_5"	"I am the rotten apple that spoils the bunch."
"dota_chatwheel_label_necrolyte_5"	"Аз съм изгнилата ябълка…"
"[english]dota_chatwheel_label_necrolyte_5"	"I am the rotten apple..."
"dota_chatwheel_message_warlock_laugh"	"Хо-ха-ха-ха-ха-ха-ха-ха-ха!"
"[english]dota_chatwheel_message_warlock_laugh"	"Ho ha ha ha ha ha ha ha ha!"
"dota_chatwheel_label_warlock_laugh"	"Смях"
"[english]dota_chatwheel_label_warlock_laugh"	"Laugh"
"dota_chatwheel_message_warlock_thank"	"Нека да се възцари хаос!"
"[english]dota_chatwheel_message_warlock_thank"	"Let chaos reign!"
"dota_chatwheel_label_warlock_thank"	"Нека да се възцари хаос!"
"[english]dota_chatwheel_label_warlock_thank"	"Let chaos reign!"
"dota_chatwheel_message_warlock_deny"	"Наистина? Действително ли сторихте това току-що?"
"[english]dota_chatwheel_message_warlock_deny"	"Really? You just did that?"
"dota_chatwheel_label_warlock_deny"	"Наистина? Действително ли сторихте това току-що?"
"[english]dota_chatwheel_label_warlock_deny"	"Really? You just did that?"
"dota_chatwheel_message_warlock_1"	"С Вас ще нахраня своите демони."
"[english]dota_chatwheel_message_warlock_1"	"I feed you to my fiends."
"dota_chatwheel_label_warlock_1"	"С Вас ще нахраня своите демони."
"[english]dota_chatwheel_label_warlock_1"	"I feed you to my fiends."
"dota_chatwheel_message_warlock_2"	"Зан коробос кор кораморд!"
"[english]dota_chatwheel_message_warlock_2"	"Zan korobos kor koramord!"
"dota_chatwheel_label_warlock_2"	"Зан коробос кор кораморд!"
"[english]dota_chatwheel_label_warlock_2"	"Zan korobos kor koramord!"
"dota_chatwheel_message_warlock_3"	"Още едно име в магьосническата ми книга."
"[english]dota_chatwheel_message_warlock_3"	"Another name in my grimoire."
"dota_chatwheel_label_warlock_3"	"Още едно име в магьосническата ми книга."
"[english]dota_chatwheel_label_warlock_3"	"Another name in my grimoire."
"dota_chatwheel_message_warlock_4"	"Мижитурки."
"[english]dota_chatwheel_message_warlock_4"	"Pipsqueak."
"dota_chatwheel_label_warlock_4"	"Мижитурки."
"[english]dota_chatwheel_label_warlock_4"	"Pipsqueak."
"dota_chatwheel_message_warlock_5"	"Това не е за вярване? Ах-ха-ха-ха-ха-ха-ха-ха-ха-ха!"
"[english]dota_chatwheel_message_warlock_5"	"Can you believe this? Ah ha ha ha ha ha ha ha ha ha!"
"dota_chatwheel_label_warlock_5"	"Това не е за вярване…"
"[english]dota_chatwheel_label_warlock_5"	"Can you believe this?..."
"dota_chatwheel_message_beastmaster_laugh"	"Хоуех-хех-хех-ех-хах-хех-хех-хех."
"[english]dota_chatwheel_message_beastmaster_laugh"	"Howeh heh heh eh hah heh heh heh."
"dota_chatwheel_label_beastmaster_laugh"	"Смях"
"[english]dota_chatwheel_label_beastmaster_laugh"	"Laugh"
"dota_chatwheel_message_beastmaster_thank"	"Разкъсайте ги!"
"[english]dota_chatwheel_message_beastmaster_thank"	"Sic 'em!"
"dota_chatwheel_label_beastmaster_thank"	"Разкъсайте ги!"
"[english]dota_chatwheel_label_beastmaster_thank"	"Sic 'em!"
"dota_chatwheel_message_beastmaster_deny"	"Аз ще се промъквам неусетно, докато спите."
"[english]dota_chatwheel_message_beastmaster_deny"	"I'll be creeping while you are sleeping."
"dota_chatwheel_label_beastmaster_deny"	"Аз ще се промъквам неусетно…"
"[english]dota_chatwheel_label_beastmaster_deny"	"I'll be creeping..."
"dota_chatwheel_message_beastmaster_1"	"Червеите ще разправят с Вас."
"[english]dota_chatwheel_message_beastmaster_1"	"The worms will have you."
"dota_chatwheel_label_beastmaster_1"	"Червеите ще разправят с Вас."
"[english]dota_chatwheel_label_beastmaster_1"	"The worms will have you."
"dota_chatwheel_message_beastmaster_2"	"Стриктна политика, непозволяваща убийства."
"[english]dota_chatwheel_message_beastmaster_2"	"A strict no-kill policy."
"dota_chatwheel_label_beastmaster_2"	"Стриктна политика, непозволяваща убийства."
"[english]dota_chatwheel_label_beastmaster_2"	"A strict no-kill policy."
"dota_chatwheel_message_beastmaster_3"	"Аррр-аррргх!"
"[english]dota_chatwheel_message_beastmaster_3"	"Aroo arooew!"
"dota_chatwheel_label_beastmaster_3"	"Аррр-аррргх!"
"[english]dota_chatwheel_label_beastmaster_3"	"Aroo arooew!"
"dota_chatwheel_message_beastmaster_4"	"Хмм, де да се бях научил да чета."
"[english]dota_chatwheel_message_beastmaster_4"	"Hmm, wish I'd learned how to read."
"dota_chatwheel_label_beastmaster_4"	"Хмм, де да се бях научил да чета."
"[english]dota_chatwheel_label_beastmaster_4"	"Hmm, wish I'd learned how to read."
"dota_chatwheel_message_beastmaster_5"	"Хоо-хоо-хоо."
"[english]dota_chatwheel_message_beastmaster_5"	"Hoo hoo hoo."
"dota_chatwheel_label_beastmaster_5"	"Хоо-хоо-хоо."
"[english]dota_chatwheel_label_beastmaster_5"	"Hoo hoo hoo."
"dota_chatwheel_message_queenofpain_laugh"	"Ух-ха-ха-ха-ха-ха-ха-ха-ха-ха-ха-ха!"
"[english]dota_chatwheel_message_queenofpain_laugh"	"Uh ha ha ha ha ha ha ha ha ha ha ha!"
"dota_chatwheel_label_queenofpain_laugh"	"Смях"
"[english]dota_chatwheel_label_queenofpain_laugh"	"Laugh"
"dota_chatwheel_message_queenofpain_thank"	"Ще има болка. Ще има писъци."
"[english]dota_chatwheel_message_queenofpain_thank"	"There will be pain, there will be screaming."
"dota_chatwheel_label_queenofpain_thank"	"Ще има болка…"
"[english]dota_chatwheel_label_queenofpain_thank"	"There will be pain..."
"dota_chatwheel_message_queenofpain_deny"	"Наранявате онези, които обичате."
"[english]dota_chatwheel_message_queenofpain_deny"	"You hurt the ones you love."
"dota_chatwheel_label_queenofpain_deny"	"Наранявате онези, които обичате."
"[english]dota_chatwheel_label_queenofpain_deny"	"You hurt the ones you love."
"dota_chatwheel_message_queenofpain_1"	"Това беше перфектно."
"[english]dota_chatwheel_message_queenofpain_1"	"That was perfect."
"dota_chatwheel_label_queenofpain_1"	"Това беше перфектно."
"[english]dota_chatwheel_label_queenofpain_1"	"That was perfect."
"dota_chatwheel_message_queenofpain_2"	"Това боли ли?"
"[english]dota_chatwheel_message_queenofpain_2"	"Does this hurt?"
"dota_chatwheel_label_queenofpain_2"	"Това боли ли?"
"[english]dota_chatwheel_label_queenofpain_2"	"Does this hurt?"
"dota_chatwheel_message_queenofpain_3"	"Харесва ми, когато се съпротивлявате."
"[english]dota_chatwheel_message_queenofpain_3"	"I love it when you resist."
"dota_chatwheel_label_queenofpain_3"	"Харесва ми, когато се съпротивлявате."
"[english]dota_chatwheel_label_queenofpain_3"	"I love it when you resist."
"dota_chatwheel_message_queenofpain_4"	"Искате ли ме? Елате да ме хванете."
"[english]dota_chatwheel_message_queenofpain_4"	"You want me? Come get me."
"dota_chatwheel_label_queenofpain_4"	"Искате ли ме? Елате да ме хванете."
"[english]dota_chatwheel_label_queenofpain_4"	"You want me? Come get me."
"dota_chatwheel_message_queenofpain_5"	"Знам, че причинявам болка, но Вие ме обичате, въпреки това."
"[english]dota_chatwheel_message_queenofpain_5"	"I know I'm a pain, but you love me anyway."
"dota_chatwheel_label_queenofpain_5"	"Знам, че причинявам болка…"
"[english]dota_chatwheel_label_queenofpain_5"	"I know I'm a pain..."
"dota_chatwheel_message_venomancer_laugh"	"Ссс-ех-хе-хе-хе-хе."
"[english]dota_chatwheel_message_venomancer_laugh"	"Sss eh he he he he."
"dota_chatwheel_label_venomancer_laugh"	"Смях"
"[english]dota_chatwheel_label_venomancer_laugh"	"Laugh"
"dota_chatwheel_message_venomancer_thank"	"Чума за враговете ни!"
"[english]dota_chatwheel_message_venomancer_thank"	"Plague our enemies!"
"dota_chatwheel_label_venomancer_thank"	"Чума за враговете ни!"
"[english]dota_chatwheel_label_venomancer_thank"	"Plague our enemies!"
"dota_chatwheel_message_venomancer_deny"	"О, скъпичко."
"[english]dota_chatwheel_message_venomancer_deny"	"Oh, costly."
"dota_chatwheel_label_venomancer_deny"	"О, скъпичко."
"[english]dota_chatwheel_label_venomancer_deny"	"Oh, costly."
"dota_chatwheel_message_venomancer_1"	"Нищо не докосва сърцето като моята отрова."
"[english]dota_chatwheel_message_venomancer_1"	"Nothing touches the heart like my venom."
"dota_chatwheel_label_venomancer_1"	"Нищо не докосва сърцето…"
"[english]dota_chatwheel_label_venomancer_1"	"Nothing touches the heart..."
"dota_chatwheel_message_venomancer_2"	"С-с-с-с, това пари."
"[english]dota_chatwheel_message_venomancer_2"	"Ssss, that burns."
"dota_chatwheel_label_venomancer_2"	"С-с-с-с, това пари."
"[english]dota_chatwheel_label_venomancer_2"	"Ssss, that burns."
"dota_chatwheel_message_venomancer_3"	"Не можете да избягате от отровния!"
"[english]dota_chatwheel_message_venomancer_3"	"You can't run from the venomous one!"
"dota_chatwheel_label_venomancer_3"	"Не можете да избягате…"
"[english]dota_chatwheel_label_venomancer_3"	"You can't run..."
"dota_chatwheel_message_venomancer_4"	"Всичко това е моя заслуга."
"[english]dota_chatwheel_message_venomancer_4"	"I owe it all to me."
"dota_chatwheel_label_venomancer_4"	"Всичко това е моя заслуга."
"[english]dota_chatwheel_label_venomancer_4"	"I owe it all to me."
"dota_chatwheel_message_venomancer_5"	"Ах, сладка токсичност!"
"[english]dota_chatwheel_message_venomancer_5"	"Ah, sweet toxicity!"
"dota_chatwheel_label_venomancer_5"	"Ах, сладка токсичност!"
"[english]dota_chatwheel_label_venomancer_5"	"Ah, sweet toxicity!"
"dota_chatwheel_message_faceless_void_laugh"	"Хех-хех-хах-ха-хах-хех-хеах-хех."
"[english]dota_chatwheel_message_faceless_void_laugh"	"Heh heh hah ha hah heh heah heh."
"dota_chatwheel_label_faceless_void_laugh"	"Смях"
"[english]dota_chatwheel_label_faceless_void_laugh"	"Laugh"
"dota_chatwheel_message_faceless_void_thank"	"Точно както предполагах!"
"[english]dota_chatwheel_message_faceless_void_thank"	"Just as I envisaged!"
"dota_chatwheel_label_faceless_void_thank"	"Точно както предполагах!"
"[english]dota_chatwheel_label_faceless_void_thank"	"Just as I envisaged!"
"dota_chatwheel_message_faceless_void_deny"	"На някои неща просто не им е писано да бъдат."
"[english]dota_chatwheel_message_faceless_void_deny"	"Some things were just not meant to be."
"dota_chatwheel_label_faceless_void_deny"	"… просто не им е писано да бъдат."
"[english]dota_chatwheel_label_faceless_void_deny"	"...just not meant to be."
"dota_chatwheel_message_faceless_void_1"	"Губите достойнството и живота си."
"[english]dota_chatwheel_message_faceless_void_1"	"You lose face and life."
"dota_chatwheel_label_faceless_void_1"	"Губите достойнството и живота си."
"[english]dota_chatwheel_label_faceless_void_1"	"You lose face and life."
"dota_chatwheel_message_faceless_void_2"	"Бяхте лишени."
"[english]dota_chatwheel_message_faceless_void_2"	"You've been voided."
"dota_chatwheel_label_faceless_void_2"	"Бяхте лишени."
"[english]dota_chatwheel_label_faceless_void_2"	"You've been voided."
"dota_chatwheel_message_faceless_void_3"	"Не мога да понеса гледката."
"[english]dota_chatwheel_message_faceless_void_3"	"I can't bear to look."
"dota_chatwheel_label_faceless_void_3"	"Не мога да понеса гледката."
"[english]dota_chatwheel_label_faceless_void_3"	"I can't bear to look."
"dota_chatwheel_message_faceless_void_4"	"Може да съм безличен, но не съм безвреден."
"[english]dota_chatwheel_message_faceless_void_4"	"I may be faceless, but I'm not maceless."
"dota_chatwheel_label_faceless_void_4"	"Може да съм безличен, но…"
"[english]dota_chatwheel_label_faceless_void_4"	"I may be faceless, but..."
"dota_chatwheel_message_faceless_void_5"	"Цяла вечност от злепоставяне!"
"[english]dota_chatwheel_message_faceless_void_5"	"An eternity of embarrassment!"
"dota_chatwheel_label_faceless_void_5"	"Цяла вечност от злепоставяне!"
"[english]dota_chatwheel_label_faceless_void_5"	"An eternity of embarrassment!"
"dota_chatwheel_message_skeleton_king_laugh"	"АХ-ХА-ХА-ХА-ХА!"
"[english]dota_chatwheel_message_skeleton_king_laugh"	"AH HA HA HA HA!"
"dota_chatwheel_label_skeleton_king_laugh"	"АХ-ХА-ХА-ХА-ХА!"
"[english]dota_chatwheel_label_skeleton_king_laugh"	"AH HA HA HA HA!"
"dota_chatwheel_message_skeleton_king_thank"	"ЩЕ ПОМОГНА НА СВОИТЕ СЛАБИ И ЖАЛКИ СЪЮЗНИЦИ, КЪДЕТО МОГА."
"[english]dota_chatwheel_message_skeleton_king_thank"	"I'LL HELP MY WEAK AND PUNY ALLIES WHERE I CAN."
"dota_chatwheel_label_skeleton_king_thank"	"… СЛАБИ И ЖАЛКИ СЪЮЗНИЦИ…"
"[english]dota_chatwheel_label_skeleton_king_thank"	"...WEAK AND PUNY ALLIES..."
"dota_chatwheel_message_skeleton_king_deny"	"И КАКВО, АКО СЪМ НАПЕРЕН?"
"[english]dota_chatwheel_message_skeleton_king_deny"	"SO WHAT IF I SWAGGER?"
"dota_chatwheel_label_skeleton_king_deny"	"И КАКВО, АКО СЪМ НАПЕРЕН?"
"[english]dota_chatwheel_label_skeleton_king_deny"	"SO WHAT IF I SWAGGER?"
"dota_chatwheel_message_skeleton_king_1"	"КОЛЕНИЧИ, СЕЛЯНИНО."
"[english]dota_chatwheel_message_skeleton_king_1"	"TAKE A KNEE, PEASANT."
"dota_chatwheel_label_skeleton_king_1"	"КОЛЕНИЧИ, СЕЛЯНИНО."
"[english]dota_chatwheel_label_skeleton_king_1"	"TAKE A KNEE, PEASANT."
"dota_chatwheel_message_skeleton_king_2"	"МНОГО ДОБРЕ."
"[english]dota_chatwheel_message_skeleton_king_2"	"VERY NICE."
"dota_chatwheel_label_skeleton_king_2"	"МНОГО ДОБРЕ."
"[english]dota_chatwheel_label_skeleton_king_2"	"VERY NICE."
"dota_chatwheel_message_skeleton_king_3"	"МОИТЕ КОСТИ МИ ЛИПСВАТ."
"[english]dota_chatwheel_message_skeleton_king_3"	"I MISS MY BONES."
"dota_chatwheel_label_skeleton_king_3"	"МОИТЕ КОСТИ МИ ЛИПСВАТ."
"[english]dota_chatwheel_label_skeleton_king_3"	"I MISS MY BONES."
"dota_chatwheel_message_skeleton_king_4"	"СЕГА РАЗПОЛАГАМ С ВСИЧКИЯ СЕКСАПИЛ."
"[english]dota_chatwheel_message_skeleton_king_4"	"I NOW HAVE ALL THE SEXY."
"dota_chatwheel_label_skeleton_king_4"	"СЕГА РАЗПОЛАГАМ С ВСИЧКИЯ СЕКСАПИЛ."
"[english]dota_chatwheel_label_skeleton_king_4"	"I NOW HAVE ALL THE SEXY."
"dota_chatwheel_message_skeleton_king_5"	"ПРИВЕТСТВАМ ВСИЧКИ СВОИ НОВИ ПОДАНИЦИ. А СЕГА, НЕКА ДА СЕ ОПОЗНАЕМ ВЗАИМНО."
"[english]dota_chatwheel_message_skeleton_king_5"	"WELCOME TO ALL MY NEW SUBJECTS. NOW LET'S GET TO KNOW EACH OTHER."
"dota_chatwheel_label_skeleton_king_5"	"ПРИВЕТСТВАМ ВСИЧКИ СВОИ НОВИ ПОДАНИЦИ…"
"[english]dota_chatwheel_label_skeleton_king_5"	"WELCOME TO ALL MY NEW SUBJECTS..."
"dota_chatwheel_message_death_prophet_laugh"	"Ох-ах-ха-ха-ха-ха-ха-хо-хо-хаа! Ха-ха-ха-ха-ха-ха!"
"[english]dota_chatwheel_message_death_prophet_laugh"	"Oh ah ha ha ha ha ha ho ho haa! Ha ha ha ha ha ha!"
"dota_chatwheel_label_death_prophet_laugh"	"Смях"
"[english]dota_chatwheel_label_death_prophet_laugh"	"Laugh"
"dota_chatwheel_message_death_prophet_thank"	"Много добре, красавици мои!"
"[english]dota_chatwheel_message_death_prophet_thank"	"Well done, my beauties!"
"dota_chatwheel_label_death_prophet_thank"	"Много добре, красавици мои!"
"[english]dota_chatwheel_label_death_prophet_thank"	"Well done, my beauties!"
"dota_chatwheel_message_death_prophet_deny"	"Не е било писано да бъде."
"[english]dota_chatwheel_message_death_prophet_deny"	"Not meant to be."
"dota_chatwheel_label_death_prophet_deny"	"Не е било писано да бъде."
"[english]dota_chatwheel_label_death_prophet_deny"	"Not meant to be."
"dota_chatwheel_message_death_prophet_1"	"Клети почитаеми."
"[english]dota_chatwheel_message_death_prophet_1"	"Poor dear."
"dota_chatwheel_label_death_prophet_1"	"Клети почитаеми."
"[english]dota_chatwheel_label_death_prophet_1"	"Poor dear."
"dota_chatwheel_message_death_prophet_2"	"Какво разочарование."
"[english]dota_chatwheel_message_death_prophet_2"	"How disappointing."
"dota_chatwheel_label_death_prophet_2"	"Какво разочарование."
"[english]dota_chatwheel_label_death_prophet_2"	"How disappointing."
"dota_chatwheel_message_death_prophet_3"	"Върнете се при мен! Върнете се при мен!"
"[english]dota_chatwheel_message_death_prophet_3"	"Come back to me! Come back to me!"
"dota_chatwheel_label_death_prophet_3"	"Върнете се при мен!"
"[english]dota_chatwheel_label_death_prophet_3"	"Come back to me!"
"dota_chatwheel_message_death_prophet_4"	"Не е нужно да сте пророци, за да предвидите какво Ви очакваше."
"[english]dota_chatwheel_message_death_prophet_4"	"It did not take a prophet to see that coming."
"dota_chatwheel_label_death_prophet_4"	"Не е нужно да сте пророци…"
"[english]dota_chatwheel_label_death_prophet_4"	"It did not take a prophet..."
"dota_chatwheel_message_death_prophet_5"	"Току-що малка част от мен умря."
"[english]dota_chatwheel_message_death_prophet_5"	"I died a little just now."
"dota_chatwheel_label_death_prophet_5"	"Току-що малка част от мен умря."
"[english]dota_chatwheel_label_death_prophet_5"	"I died a little just now."
"dota_chatwheel_message_phantom_assassin_laugh"	"Хо-хо-хо-хо-хо-ха-ха-ха."
"[english]dota_chatwheel_message_phantom_assassin_laugh"	"Ho ho ho ho ho ha ha ha"
"dota_chatwheel_label_phantom_assassin_laugh"	"Смях"
"[english]dota_chatwheel_label_phantom_assassin_laugh"	"Laugh"
"dota_chatwheel_message_phantom_assassin_thank"	"Ммм, божествено."
"[english]dota_chatwheel_message_phantom_assassin_thank"	"Mmm, divine."
"dota_chatwheel_label_phantom_assassin_thank"	"Ммм, божествено."
"[english]dota_chatwheel_label_phantom_assassin_thank"	"Mmm, divine."
"dota_chatwheel_message_phantom_assassin_deny"	"Всичко е според плана."
"[english]dota_chatwheel_message_phantom_assassin_deny"	"All according to plan."
"dota_chatwheel_label_phantom_assassin_deny"	"Всичко е според плана."
"[english]dota_chatwheel_label_phantom_assassin_deny"	"All according to plan."
"dota_chatwheel_message_phantom_assassin_1"	"Смъртта от моите ръце е чест."
"[english]dota_chatwheel_message_phantom_assassin_1"	"Death at my hands is an honor."
"dota_chatwheel_label_phantom_assassin_1"	"Смъртта от моите ръце е чест."
"[english]dota_chatwheel_label_phantom_assassin_1"	"Death at my hands is an honor."
"dota_chatwheel_message_phantom_assassin_2"	"Мисля, че това мина добре."
"[english]dota_chatwheel_message_phantom_assassin_2"	"That went well, I think."
"dota_chatwheel_label_phantom_assassin_2"	"Мисля, че това мина добре."
"[english]dota_chatwheel_label_phantom_assassin_2"	"That went well, I think."
"dota_chatwheel_message_phantom_assassin_3"	"Колко кинжала държа?"
"[english]dota_chatwheel_message_phantom_assassin_3"	"How many daggers am I holding up?"
"dota_chatwheel_label_phantom_assassin_3"	"Колко кинжала държа?"
"[english]dota_chatwheel_label_phantom_assassin_3"	"How many daggers am I holding up?"
"dota_chatwheel_message_phantom_assassin_4"	"Ха-аххх-ха-ха, не, не, не."
"[english]dota_chatwheel_message_phantom_assassin_4"	"Ha, ahhh, ha ha, no no no."
"dota_chatwheel_label_phantom_assassin_4"	"Смях… не, не, не."
"[english]dota_chatwheel_label_phantom_assassin_4"	"Laugh...no no no."
"dota_chatwheel_message_phantom_assassin_5"	"Аз съм нематериално момиче!"
"[english]dota_chatwheel_message_phantom_assassin_5"	"I'm an immaterial girl!"
"dota_chatwheel_label_phantom_assassin_5"	"Аз съм нематериално момиче!"
"[english]dota_chatwheel_label_phantom_assassin_5"	"I'm an immaterial girl!"
"dota_chatwheel_message_pugna_laugh"	"Ха-ха-ха-ха-ха-ха."
"[english]dota_chatwheel_message_pugna_laugh"	"Ha ha ha ha ha ha."
"dota_chatwheel_label_pugna_laugh"	"Смях"
"[english]dota_chatwheel_label_pugna_laugh"	"Laugh"
"dota_chatwheel_message_pugna_thank"	"Ах, това ще е добро."
"[english]dota_chatwheel_message_pugna_thank"	"Ah, this is going to be good."
"dota_chatwheel_label_pugna_thank"	"Ах, това ще е добро."
"[english]dota_chatwheel_label_pugna_thank"	"Ah, this is going to be good."
"dota_chatwheel_message_pugna_deny"	"Само влошавате ситуацията."
"[english]dota_chatwheel_message_pugna_deny"	"You're only making it worse."
"dota_chatwheel_label_pugna_deny"	"Само влошавате ситуацията."
"[english]dota_chatwheel_label_pugna_deny"	"You're only making it worse."
"dota_chatwheel_message_pugna_1"	"Ау, аз ли направих това?"
"[english]dota_chatwheel_message_pugna_1"	"Aw, did I do that?"
"dota_chatwheel_label_pugna_1"	"Ау, аз ли направих това?"
"[english]dota_chatwheel_label_pugna_1"	"Aw, did I do that?"
"dota_chatwheel_message_pugna_2"	"Липсвах ли на някого?"
"[english]dota_chatwheel_message_pugna_2"	"Anyone miss me?"
"dota_chatwheel_label_pugna_2"	"Липсвах ли на някого?"
"[english]dota_chatwheel_label_pugna_2"	"Anyone miss me?"
"dota_chatwheel_message_pugna_3"	"Време е да си заслужа малко лоша репутация."
"[english]dota_chatwheel_message_pugna_3"	"Time to earn myself a bad reputation."
"dota_chatwheel_label_pugna_3"	"Време е да си заслужа…"
"[english]dota_chatwheel_label_pugna_3"	"Time to earn myself..."
"dota_chatwheel_message_pugna_4"	"Сами си причинихте това."
"[english]dota_chatwheel_message_pugna_4"	"You did that to yourself."
"dota_chatwheel_label_pugna_4"	"Сами си причинихте това."
"[english]dota_chatwheel_label_pugna_4"	"You did that to yourself."
"dota_chatwheel_message_pugna_5"	"Хабите си живота."
"[english]dota_chatwheel_message_pugna_5"	"You're wasting your life."
"dota_chatwheel_label_pugna_5"	"Хабите си живота."
"[english]dota_chatwheel_label_pugna_5"	"You're wasting your life."
"dota_chatwheel_message_templar_assassin_laugh"	"Ха-ха-ха-ха-ха-ха-ха!"
"[english]dota_chatwheel_message_templar_assassin_laugh"	"Ha ha ha ha ha ha ha!"
"dota_chatwheel_label_templar_assassin_laugh"	"Смях"
"[english]dota_chatwheel_label_templar_assassin_laugh"	"Laugh"
"dota_chatwheel_message_templar_assassin_thank"	"Аз ще го взема."
"[english]dota_chatwheel_message_templar_assassin_thank"	"I'll take it."
"dota_chatwheel_label_templar_assassin_thank"	"Аз ще го взема."
"[english]dota_chatwheel_label_templar_assassin_thank"	"I'll take it."
"dota_chatwheel_message_templar_assassin_deny"	"Видях тази кончина от километри."
"[english]dota_chatwheel_message_templar_assassin_deny"	"I saw that ending from miles away."
"dota_chatwheel_label_templar_assassin_deny"	"Видях тази кончина от километри."
"[english]dota_chatwheel_label_templar_assassin_deny"	"I saw that ending from miles away."
"dota_chatwheel_message_templar_assassin_1"	"Никога няма да намерят гроба Ви."
"[english]dota_chatwheel_message_templar_assassin_1"	"They'll never find your grave."
"dota_chatwheel_label_templar_assassin_1"	"Никога няма да намерят гроба Ви."
"[english]dota_chatwheel_label_templar_assassin_1"	"They'll never find your grave."
"dota_chatwheel_message_templar_assassin_2"	"Това е капан!"
"[english]dota_chatwheel_message_templar_assassin_2"	"It's a trap!"
"dota_chatwheel_label_templar_assassin_2"	"Това е капан!"
"[english]dota_chatwheel_label_templar_assassin_2"	"It's a trap!"
"dota_chatwheel_message_templar_assassin_3"	"Мистерията се задълбочава."
"[english]dota_chatwheel_message_templar_assassin_3"	"The mystery deepens."
"dota_chatwheel_label_templar_assassin_3"	"Мистерията се задълбочава."
"[english]dota_chatwheel_label_templar_assassin_3"	"The mystery deepens."
"dota_chatwheel_message_templar_assassin_4"	"О, паднахте ми!"
"[english]dota_chatwheel_message_templar_assassin_4"	"Oh, snap!"
"dota_chatwheel_label_templar_assassin_4"	"О, паднахте ми!"
"[english]dota_chatwheel_label_templar_assassin_4"	"Oh, snap!"
"dota_chatwheel_message_templar_assassin_5"	"Подхранете ме, ако е нужно."
"[english]dota_chatwheel_message_templar_assassin_5"	"Feed me if you must."
"dota_chatwheel_label_templar_assassin_5"	"Подхранете ме, ако е нужно."
"[english]dota_chatwheel_label_templar_assassin_5"	"Feed me if you must."
"dota_chatwheel_message_viper_laugh"	"Те-хе-хе-хе-хар."
"[english]dota_chatwheel_message_viper_laugh"	"Tehehehehar."
"dota_chatwheel_label_viper_laugh"	"Смях"
"[english]dota_chatwheel_label_viper_laugh"	"Laugh"
"dota_chatwheel_message_viper_thank"	"Пристига въздушната подкрепа."
"[english]dota_chatwheel_message_viper_thank"	"Air support arrives."
"dota_chatwheel_label_viper_thank"	"Пристига въздушната подкрепа."
"[english]dota_chatwheel_label_viper_thank"	"Air support arrives."
"dota_chatwheel_message_viper_deny"	"Почти, но не съвсем."
"[english]dota_chatwheel_message_viper_deny"	"Close but not quite."
"dota_chatwheel_label_viper_deny"	"Почти, но не съвсем."
"[english]dota_chatwheel_label_viper_deny"	"Close but not quite."
"dota_chatwheel_message_viper_1"	"Смърт… от висините."
"[english]dota_chatwheel_message_viper_1"	"Death...from above."
"dota_chatwheel_label_viper_1"	"Смърт… от висините."
"[english]dota_chatwheel_label_viper_1"	"Death...from above."
"dota_chatwheel_message_viper_2"	"Впускам се яростно."
"[english]dota_chatwheel_message_viper_2"	"I fly into a rage."
"dota_chatwheel_label_viper_2"	"Впускам се яростно."
"[english]dota_chatwheel_label_viper_2"	"I fly into a rage."
"dota_chatwheel_message_viper_3"	"Има по-добри начини да умрете."
"[english]dota_chatwheel_message_viper_3"	"There are better deaths."
"dota_chatwheel_label_viper_3"	"Има по-добри начини да умрете."
"[english]dota_chatwheel_label_viper_3"	"There are better deaths."
"dota_chatwheel_message_viper_4"	"Пари… нали."
"[english]dota_chatwheel_message_viper_4"	"Burns...doesn't it."
"dota_chatwheel_label_viper_4"	"Пари… нали."
"[english]dota_chatwheel_label_viper_4"	"Burns...doesn't it."
"dota_chatwheel_message_viper_5"	"Кому са нужни крака, когато имате крила?"
"[english]dota_chatwheel_message_viper_5"	"Who needs legs, when you got wings?"
"dota_chatwheel_label_viper_5"	"Кому са нужни крака, когато…"
"[english]dota_chatwheel_label_viper_5"	"Who needs legs, when..."
"dota_chatwheel_message_luna_laugh"	"Ах-ха-ха-ха-ха-ха-ха!"
"[english]dota_chatwheel_message_luna_laugh"	"Ah ha ha ha ha ha ha!"
"dota_chatwheel_label_luna_laugh"	"Смях"
"[english]dota_chatwheel_label_luna_laugh"	"Laugh"
"dota_chatwheel_message_luna_thank"	"Благословения връз един лоялен войн."
"[english]dota_chatwheel_message_luna_thank"	"Blessings upon a loyal warrior."
"dota_chatwheel_label_luna_thank"	"Благословения връз един лоялен войн."
"[english]dota_chatwheel_label_luna_thank"	"Blessings upon a loyal warrior."
"dota_chatwheel_message_luna_deny"	"Интересно!"
"[english]dota_chatwheel_message_luna_deny"	"Interesting!"
"dota_chatwheel_label_luna_deny"	"Интересно!"
"[english]dota_chatwheel_label_luna_deny"	"Interesting!"
"dota_chatwheel_message_luna_1"	"Изгубили сте се в горите, а?"
"[english]dota_chatwheel_message_luna_1"	"Lost in the woods, are you?"
"dota_chatwheel_label_luna_1"	"Изгубили сте се в горите, а?"
"[english]dota_chatwheel_label_luna_1"	"Lost in the woods, are you?"
"dota_chatwheel_message_luna_2"	"Отпишете тази идея!"
"[english]dota_chatwheel_message_luna_2"	"W'scratch that idea!"
"dota_chatwheel_label_luna_2"	"Отпишете тази идея!"
"[english]dota_chatwheel_label_luna_2"	"W'scratch that idea!"
"dota_chatwheel_message_luna_3"	"И това ако не е нещо хубаво!"
"[english]dota_chatwheel_message_luna_3"	"Isn't that a pretty thing!"
"dota_chatwheel_label_luna_3"	"И това ако не е нещо хубаво!"
"[english]dota_chatwheel_label_luna_3"	"Isn't that a pretty thing!"
"dota_chatwheel_message_luna_4"	"Долен магьосник."
"[english]dota_chatwheel_message_luna_4"	"Piece of shite wizard."
"dota_chatwheel_label_luna_4"	"Долен магьосник."
"[english]dota_chatwheel_label_luna_4"	"Piece of shite wizard."
"dota_chatwheel_message_luna_5"	"Нека небето да опозори недостойните!"
"[english]dota_chatwheel_message_luna_5"	"Let the sky tear down the unworthy!"
"dota_chatwheel_label_luna_5"	"Нека небето да опозори…"
"[english]dota_chatwheel_label_luna_5"	"Let the sky tear down..."
"dota_chatwheel_message_dragon_knight_laugh"	"Техх-хех-хе-хъх-хех-хех-хъх."
"[english]dota_chatwheel_message_dragon_knight_laugh"	"Tehh, heh he huh heh heh huh."
"dota_chatwheel_label_dragon_knight_laugh"	"Смях"
"[english]dota_chatwheel_label_dragon_knight_laugh"	"Laugh"
"dota_chatwheel_message_dragon_knight_thank"	"Победата е в силата."
"[english]dota_chatwheel_message_dragon_knight_thank"	"In strength is victory."
"dota_chatwheel_label_dragon_knight_thank"	"Победата е в силата."
"[english]dota_chatwheel_label_dragon_knight_thank"	"In strength is victory."
"dota_chatwheel_message_dragon_knight_deny"	"Точно това чаках."
"[english]dota_chatwheel_message_dragon_knight_deny"	"Just what I've been waiting for."
"dota_chatwheel_label_dragon_knight_deny"	"Точно това…"
"[english]dota_chatwheel_label_dragon_knight_deny"	"Just what I've been..."
"dota_chatwheel_message_dragon_knight_1"	"Сражавахте се и умряхте с чест."
"[english]dota_chatwheel_message_dragon_knight_1"	"You fought and died with honor."
"dota_chatwheel_label_dragon_knight_1"	"Сражавахте се и умряхте с чест."
"[english]dota_chatwheel_label_dragon_knight_1"	"You fought and died with honor."
"dota_chatwheel_message_dragon_knight_2"	"Аз ще взема това."
"[english]dota_chatwheel_message_dragon_knight_2"	"I'll take that."
"dota_chatwheel_label_dragon_knight_2"	"Аз ще взема това."
"[english]dota_chatwheel_label_dragon_knight_2"	"I'll take that."
"dota_chatwheel_message_dragon_knight_3"	"Живейте според меча, умрете от дракона."
"[english]dota_chatwheel_message_dragon_knight_3"	"Live by the sword, die by the dragon."
"dota_chatwheel_label_dragon_knight_3"	"Живейте според меча…"
"[english]dota_chatwheel_label_dragon_knight_3"	"Live by the sword..."
"dota_chatwheel_message_dragon_knight_4"	"Разбира се."
"[english]dota_chatwheel_message_dragon_knight_4"	"Of course."
"dota_chatwheel_label_dragon_knight_4"	"Разбира се."
"[english]dota_chatwheel_label_dragon_knight_4"	"Of course."
"dota_chatwheel_message_dragon_knight_5"	"Опълчете се срещу рицаря. Опълчете се срещу дракона."
"[english]dota_chatwheel_message_dragon_knight_5"	"Face the knight, face the dragon."
"dota_chatwheel_label_dragon_knight_5"	"Опълчете се срещу рицаря. Опълчете се срещу дракона."
"[english]dota_chatwheel_label_dragon_knight_5"	"Face the knight, face the dragon."
"dota_chatwheel_message_dazzle_laugh"	"Ха-ха-хар-ха-ха-ха!"
"[english]dota_chatwheel_message_dazzle_laugh"	"Ha ha har ha ha ha!"
"dota_chatwheel_label_dazzle_laugh"	"Смях"
"[english]dota_chatwheel_label_dazzle_laugh"	"Laugh"
"dota_chatwheel_message_dazzle_thank"	"О, каква красота!"
"[english]dota_chatwheel_message_dazzle_thank"	"Oh, what a beauty!"
"dota_chatwheel_label_dazzle_thank"	"О, каква красота!"
"[english]dota_chatwheel_label_dazzle_thank"	"Oh, what a beauty!"
"dota_chatwheel_message_dazzle_deny"	"Това не е правилно."
"[english]dota_chatwheel_message_dazzle_deny"	"That's not right."
"dota_chatwheel_label_dazzle_deny"	"Това не е правилно."
"[english]dota_chatwheel_label_dazzle_deny"	"That's not right."
"dota_chatwheel_message_dazzle_1"	"Поразителна смърт."
"[english]dota_chatwheel_message_dazzle_1"	"A dazzling death."
"dota_chatwheel_label_dazzle_1"	"Поразителна смърт."
"[english]dota_chatwheel_label_dazzle_1"	"A dazzling death."
"dota_chatwheel_message_dazzle_2"	"Щедро от Ваша страна."
"[english]dota_chatwheel_message_dazzle_2"	"Charitable of you."
"dota_chatwheel_label_dazzle_2"	"Щедро от Ваша страна."
"[english]dota_chatwheel_label_dazzle_2"	"Charitable of you."
"dota_chatwheel_message_dazzle_3"	"Джзап!"
"[english]dota_chatwheel_message_dazzle_3"	"Jzap!"
"dota_chatwheel_label_dazzle_3"	"Джзап!"
"[english]dota_chatwheel_label_dazzle_3"	"Jzap!"
"dota_chatwheel_message_dazzle_4"	"Измамих Ви."
"[english]dota_chatwheel_message_dazzle_4"	"Tricked you."
"dota_chatwheel_label_dazzle_4"	"Измамих Ви."
"[english]dota_chatwheel_label_dazzle_4"	"Tricked you."
"dota_chatwheel_message_dazzle_5"	"Това почти беше бедствие."
"[english]dota_chatwheel_message_dazzle_5"	"That was almost a disaster."
"dota_chatwheel_label_dazzle_5"	"Това почти беше бедствие."
"[english]dota_chatwheel_label_dazzle_5"	"That was almost a disaster."
"dota_chatwheel_message_rattletrap_laugh"	"Ха-ха-ха-ха-ха-ха!"
"[english]dota_chatwheel_message_rattletrap_laugh"	"Ha ha ha ha ha ha!"
"dota_chatwheel_label_rattletrap_laugh"	"Смях"
"[english]dota_chatwheel_label_rattletrap_laugh"	"Laugh"
"dota_chatwheel_message_rattletrap_thank"	"Това тря'а да ги разтърси! Да!"
"[english]dota_chatwheel_message_rattletrap_thank"	"That oughta rattle em, yeah!"
"dota_chatwheel_label_rattletrap_thank"	"Това тря'а да ги разтърси! Да!"
"[english]dota_chatwheel_label_rattletrap_thank"	"That oughta rattle em, yeah!"
"dota_chatwheel_message_rattletrap_deny"	"Не очаквахте ли това?"
"[english]dota_chatwheel_message_rattletrap_deny"	"Not what you expected?"
"dota_chatwheel_label_rattletrap_deny"	"Не очаквахте ли това?"
"[english]dota_chatwheel_label_rattletrap_deny"	"Not what you expected?"
"dota_chatwheel_message_rattletrap_1"	"Кажете ми, че някой видя това!"
"[english]dota_chatwheel_message_rattletrap_1"	"Tell me someone saw that!"
"dota_chatwheel_label_rattletrap_1"	"Кажете ми, че някой видя това!"
"[english]dota_chatwheel_label_rattletrap_1"	"Tell me someone saw that!"
"dota_chatwheel_message_rattletrap_2"	"Ха, това гъделичка!"
"[english]dota_chatwheel_message_rattletrap_2"	"Ha, that tickles!"
"dota_chatwheel_label_rattletrap_2"	"Ха, това гъделичка!"
"[english]dota_chatwheel_label_rattletrap_2"	"Ha, that tickles!"
"dota_chatwheel_message_rattletrap_3"	"Еха!"
"[english]dota_chatwheel_message_rattletrap_3"	"Whoa!"
"dota_chatwheel_label_rattletrap_3"	"Еха!"
"[english]dota_chatwheel_label_rattletrap_3"	"Whoa!"
"dota_chatwheel_message_rattletrap_4"	"Блийп-блоп, аз съм робот. Ех, просто се шегувам."
"[english]dota_chatwheel_message_rattletrap_4"	"Bleep bloop, I am a robot. Eh, just kidding."
"dota_chatwheel_label_rattletrap_4"	"Блийп-блоп, аз съм робот…"
"[english]dota_chatwheel_label_rattletrap_4"	"Bleep bloop, I am a robot..."
"dota_chatwheel_message_rattletrap_5"	"Това е толкова метализирано!"
"[english]dota_chatwheel_message_rattletrap_5"	"That is so metal!"
"dota_chatwheel_label_rattletrap_5"	"Това е толкова метализирано!"
"[english]dota_chatwheel_label_rattletrap_5"	"That is so metal!"
"dota_chatwheel_message_leshrac_laugh"	"Ха-ха-ха-ха-ха-ха-ха!"
"[english]dota_chatwheel_message_leshrac_laugh"	"Ha ha ha ha ha ha ha!"
"dota_chatwheel_label_leshrac_laugh"	"Смях"
"[english]dota_chatwheel_label_leshrac_laugh"	"Laugh"
"dota_chatwheel_message_leshrac_thank"	"За бъдеще, изпълнено с печал."
"[english]dota_chatwheel_message_leshrac_thank"	"To a future of grief."
"dota_chatwheel_label_leshrac_thank"	"За бъдеще, изпълнено с печал."
"[english]dota_chatwheel_label_leshrac_thank"	"To a future of grief."
"dota_chatwheel_message_leshrac_deny"	"Ето Ви малко смирение."
"[english]dota_chatwheel_message_leshrac_deny"	"Have a little humility."
"dota_chatwheel_label_leshrac_deny"	"Ето Ви малко смирение."
"[english]dota_chatwheel_label_leshrac_deny"	"Have a little humility."
"dota_chatwheel_message_leshrac_1"	"Двукрака отврат."
"[english]dota_chatwheel_message_leshrac_1"	"Two legged abomination."
"dota_chatwheel_label_leshrac_1"	"Двукрака отврат."
"[english]dota_chatwheel_label_leshrac_1"	"Two legged abomination."
"dota_chatwheel_message_leshrac_2"	"Аз ще взема това."
"[english]dota_chatwheel_message_leshrac_2"	"I'll take that."
"dota_chatwheel_label_leshrac_2"	"Аз ще взема това."
"[english]dota_chatwheel_label_leshrac_2"	"I'll take that."
"dota_chatwheel_message_leshrac_3"	"Ах, всичко в служба на дисбаланса."
"[english]dota_chatwheel_message_leshrac_3"	"Ah, all in service to imbalance."
"dota_chatwheel_label_leshrac_3"	"… в служба на дисбаланса."
"[english]dota_chatwheel_label_leshrac_3"	"...in service to imbalance."
"dota_chatwheel_message_leshrac_4"	"Предрешен завършек."
"[english]dota_chatwheel_message_leshrac_4"	"A foregone conclusion."
"dota_chatwheel_label_leshrac_4"	"Предрешен завършек."
"[english]dota_chatwheel_label_leshrac_4"	"A foregone conclusion."
"dota_chatwheel_message_leshrac_5"	"Хиляди от вида Ви са били покосени пред мен."
"[english]dota_chatwheel_message_leshrac_5"	"A thousand of your kind have fallen before me."
"dota_chatwheel_label_leshrac_5"	"Хиляди от вида Ви…"
"[english]dota_chatwheel_label_leshrac_5"	"A thousand of your kind..."
"dota_chatwheel_message_furion_laugh"	"Му-ха-ха-ха-ха-ха-ха-ха-ха-ха!"
"[english]dota_chatwheel_message_furion_laugh"	"Ma ha ha ha ha ha ha ha ha ha!"
"dota_chatwheel_label_furion_laugh"	"Смях"
"[english]dota_chatwheel_label_furion_laugh"	"Laugh"
"dota_chatwheel_message_furion_thank"	"Възхитително."
"[english]dota_chatwheel_message_furion_thank"	"Admirable."
"dota_chatwheel_label_furion_thank"	"Възхитително."
"[english]dota_chatwheel_label_furion_thank"	"Admirable."
"dota_chatwheel_message_furion_deny"	"Хм-хм-хм. Е, я виж ти."
"[english]dota_chatwheel_message_furion_deny"	"Hmhmhm. Well, well."
"dota_chatwheel_label_furion_deny"	"Хм-хм-хм. Е, я виж ти."
"[english]dota_chatwheel_label_furion_deny"	"Hmhmhm. Well, well."
"dota_chatwheel_message_furion_1"	"Подхранете дърветата."
"[english]dota_chatwheel_message_furion_1"	"Feed the trees."
"dota_chatwheel_label_furion_1"	"Подхранете дърветата."
"[english]dota_chatwheel_label_furion_1"	"Feed the trees."
"dota_chatwheel_message_furion_2"	"Ще Ви разкъсам крайниците един подир друг."
"[english]dota_chatwheel_message_furion_2"	"I'll tear you limb from limb."
"dota_chatwheel_label_furion_2"	"Ще Ви разкъсам крайниците един подир друг."
"[english]dota_chatwheel_label_furion_2"	"I'll tear you limb from limb."
"dota_chatwheel_message_furion_3"	"Много добре."
"[english]dota_chatwheel_message_furion_3"	"Very nice."
"dota_chatwheel_label_furion_3"	"Много добре."
"[english]dota_chatwheel_label_furion_3"	"Very nice."
"dota_chatwheel_message_furion_4"	"Ауу, колко лошо."
"[english]dota_chatwheel_message_furion_4"	"Aww, too bad."
"dota_chatwheel_label_furion_4"	"Ауу, колко лошо."
"[english]dota_chatwheel_label_furion_4"	"Aww, too bad."
"dota_chatwheel_message_furion_5"	"Нов живот ще си намери своя дом насред костите Ви."
"[english]dota_chatwheel_message_furion_5"	"New life will make its home amongst your bones."
"dota_chatwheel_label_furion_5"	"Нов живот ще си намери своя дом…"
"[english]dota_chatwheel_label_furion_5"	"New life will make its home..."
"dota_chatwheel_message_life_stealer_laugh"	"Ха! Ха-ха-ха-ха!"
"[english]dota_chatwheel_message_life_stealer_laugh"	"Ha! Ha ha ha ha!"
"dota_chatwheel_label_life_stealer_laugh"	"Смях"
"[english]dota_chatwheel_label_life_stealer_laugh"	"Laugh"
"dota_chatwheel_message_life_stealer_thank"	"Това удовлетворява господаря."
"[english]dota_chatwheel_message_life_stealer_thank"	"This pleases the Master."
"dota_chatwheel_label_life_stealer_thank"	"Това удовлетворява господаря."
"[english]dota_chatwheel_label_life_stealer_thank"	"This pleases the Master."
"dota_chatwheel_message_life_stealer_deny"	"Изненада!"
"[english]dota_chatwheel_message_life_stealer_deny"	"Surprise!"
"dota_chatwheel_label_life_stealer_deny"	"Изненада!"
"[english]dota_chatwheel_label_life_stealer_deny"	"Surprise!"
"dota_chatwheel_message_life_stealer_1"	"Господарят е тук!"
"[english]dota_chatwheel_message_life_stealer_1"	"The master is here!"
"dota_chatwheel_label_life_stealer_1"	"Господарят е тук!"
"[english]dota_chatwheel_label_life_stealer_1"	"The master is here!"
"dota_chatwheel_message_life_stealer_2"	"Насаме със своята ярост!"
"[english]dota_chatwheel_message_life_stealer_2"	"Alone with my rage!"
"dota_chatwheel_label_life_stealer_2"	"Насаме със своята ярост!"
"[english]dota_chatwheel_label_life_stealer_2"	"Alone with my rage!"
"dota_chatwheel_message_life_stealer_3"	"Сладко, сладко насилие."
"[english]dota_chatwheel_message_life_stealer_3"	"Sweet, sweet violence."
"dota_chatwheel_label_life_stealer_3"	"Сладко, сладко насилие."
"[english]dota_chatwheel_label_life_stealer_3"	"Sweet, sweet violence."
"dota_chatwheel_message_life_stealer_4"	"Усещате червената ръка на смъртта."
"[english]dota_chatwheel_message_life_stealer_4"	"You feel the red hand of death."
"dota_chatwheel_label_life_stealer_4"	"Усещате червената ръка…"
"[english]dota_chatwheel_label_life_stealer_4"	"You feel the red hand..."
"dota_chatwheel_message_life_stealer_5"	"Та-да!"
"[english]dota_chatwheel_message_life_stealer_5"	"Ta-da!"
"dota_chatwheel_label_life_stealer_5"	"Та-да!"
"[english]dota_chatwheel_label_life_stealer_5"	"Ta-da!"
"dota_chatwheel_message_dark_seer_laugh"	"Хе-хех-йе-хе-хех-хей-хеехх-хе-йех-хей-йе-хе-хе-хех-ех-ех-йех."
"[english]dota_chatwheel_message_dark_seer_laugh"	"Heheh yeheheh hey heehhhe yehhey yehe heheh eheh yeh."
"dota_chatwheel_label_dark_seer_laugh"	"Смях"
"[english]dota_chatwheel_label_dark_seer_laugh"	"Laugh"
"dota_chatwheel_message_dark_seer_thank"	"Много добре."
"[english]dota_chatwheel_message_dark_seer_thank"	"Very good."
"dota_chatwheel_label_dark_seer_thank"	"Много добре."
"[english]dota_chatwheel_label_dark_seer_thank"	"Very good."
"dota_chatwheel_message_dark_seer_deny"	"Хх, това не го очаквахте, нали?"
"[english]dota_chatwheel_message_dark_seer_deny"	"Hh, didn't see that coming, did you?"
"dota_chatwheel_label_dark_seer_deny"	"Това не го очаквахте, нали?"
"[english]dota_chatwheel_label_dark_seer_deny"	"Didn't see that coming, did you?"
"dota_chatwheel_message_dark_seer_1"	"Животът Ви, подобно на главата, беше безсмислен."
"[english]dota_chatwheel_message_dark_seer_1"	"Your life, much like your head, lacked a point."
"dota_chatwheel_label_dark_seer_1"	"Животът Ви, подобно на главата…"
"[english]dota_chatwheel_label_dark_seer_1"	"Your life, much like your head..."
"dota_chatwheel_message_dark_seer_2"	"Не мога да повярвам, че това проработи."
"[english]dota_chatwheel_message_dark_seer_2"	"I cannot believe that worked."
"dota_chatwheel_label_dark_seer_2"	"Не мога да повярвам, че това проработи!"
"[english]dota_chatwheel_label_dark_seer_2"	"I cannot believe that worked!"
"dota_chatwheel_message_dark_seer_3"	"Хооо-аха-хааа-хеех."
"[english]dota_chatwheel_message_dark_seer_3"	"Hoooahahaaaheeh."
"dota_chatwheel_label_dark_seer_3"	"Хооо-аха-хааа-хеех."
"[english]dota_chatwheel_label_dark_seer_3"	"Hoooahahaaaheeh."
"dota_chatwheel_message_dark_seer_4"	"Сблъскахте се със стена."
"[english]dota_chatwheel_message_dark_seer_4"	"You've hit a wall."
"dota_chatwheel_label_dark_seer_4"	"Сблъскахте се със стена."
"[english]dota_chatwheel_label_dark_seer_4"	"You've hit a wall."
"dota_chatwheel_message_dark_seer_5"	"Аз и враговете ми не се различаваме чак толкова. Като изключим това, че мозъкът ми е много по-голям."
"[english]dota_chatwheel_message_dark_seer_5"	"We are not so different, my enemies and I. Except my brain is much larger."
"dota_chatwheel_label_dark_seer_5"	"Не се различаваме чак толкова…"
"[english]dota_chatwheel_label_dark_seer_5"	"We are not so different..."
"dota_chatwheel_message_clinkz_laugh"	"Ах-ха-ха-ха-ха!"
"[english]dota_chatwheel_message_clinkz_laugh"	"Ah ha ha ha ha."
"dota_chatwheel_label_clinkz_laugh"	"Смях"
"[english]dota_chatwheel_label_clinkz_laugh"	"Laugh"
"dota_chatwheel_message_clinkz_thank"	"Много добре."
"[english]dota_chatwheel_message_clinkz_thank"	"Well done."
"dota_chatwheel_label_clinkz_thank"	"Много добре."
"[english]dota_chatwheel_label_clinkz_thank"	"Well done."
"dota_chatwheel_message_clinkz_deny"	"А почти се бяхте справили."
"[english]dota_chatwheel_message_clinkz_deny"	"You almost had it too."
"dota_chatwheel_label_clinkz_deny"	"А почти се бяхте справили."
"[english]dota_chatwheel_label_clinkz_deny"	"You almost had it too."
"dota_chatwheel_message_clinkz_1"	"Ще изпепеля тялото Ви."
"[english]dota_chatwheel_message_clinkz_1"	"I'll burn your body to ashes."
"dota_chatwheel_label_clinkz_1"	"Ще изпепеля тялото Ви."
"[english]dota_chatwheel_label_clinkz_1"	"I'll burn your body to ashes."
"dota_chatwheel_message_clinkz_2"	"Борете се срещу огъня с огън."
"[english]dota_chatwheel_message_clinkz_2"	"Fight fire with fire."
"dota_chatwheel_label_clinkz_2"	"Борете се срещу огъня с огън."
"[english]dota_chatwheel_label_clinkz_2"	"Fight fire with fire."
"dota_chatwheel_message_clinkz_3"	"Благодаря за целевата тренировка."
"[english]dota_chatwheel_message_clinkz_3"	"Thanks for the target practice."
"dota_chatwheel_label_clinkz_3"	"Благодаря за целевата тренировка."
"[english]dota_chatwheel_label_clinkz_3"	"Thanks for the target practice."
"dota_chatwheel_message_clinkz_4"	"Да!"
"[english]dota_chatwheel_message_clinkz_4"	"Yes!"
"dota_chatwheel_label_clinkz_4"	"Да!"
"[english]dota_chatwheel_label_clinkz_4"	"Yes!"
"dota_chatwheel_message_clinkz_5"	"Колкото повече подклаждате огъня, толкова повече той се разраства."
"[english]dota_chatwheel_message_clinkz_5"	"Fire grows hungrier the more it's fed."
"dota_chatwheel_label_clinkz_5"	"Огънят се разраства…"
"[english]dota_chatwheel_label_clinkz_5"	"Fire grows hungrier..."
"dota_chatwheel_message_omniknight_laugh"	"Му-хоо-уе-хех-хъх-хей."
"[english]dota_chatwheel_message_omniknight_laugh"	"Mehooweheh hwh hew."
"dota_chatwheel_label_omniknight_laugh"	"Смях"
"[english]dota_chatwheel_label_omniknight_laugh"	"Laugh"
"dota_chatwheel_message_omniknight_thank"	"Красиво."
"[english]dota_chatwheel_message_omniknight_thank"	"Beautiful."
"dota_chatwheel_label_omniknight_thank"	"Красиво."
"[english]dota_chatwheel_label_omniknight_thank"	"Beautiful."
"dota_chatwheel_message_omniknight_deny"	"Заковах го."
"[english]dota_chatwheel_message_omniknight_deny"	"Nailed it."
"dota_chatwheel_label_omniknight_deny"	"Заковах го."
"[english]dota_chatwheel_label_omniknight_deny"	"Nailed it."
"dota_chatwheel_message_omniknight_1"	"Поредното леке на бойното поле."
"[english]dota_chatwheel_message_omniknight_1"	"Another stain on the battlefield."
"dota_chatwheel_label_omniknight_1"	"Поредното леке на бойното поле."
"[english]dota_chatwheel_label_omniknight_1"	"Another stain on the battlefield."
"dota_chatwheel_message_omniknight_2"	"Вината Ви натежава много."
"[english]dota_chatwheel_message_omniknight_2"	"Your guilt weighs heavily."
"dota_chatwheel_label_omniknight_2"	"Вината Ви натежава много."
"[english]dota_chatwheel_label_omniknight_2"	"Your guilt weighs heavily."
"dota_chatwheel_message_omniknight_3"	"Почивайте в мир, злочести глупако."
"[english]dota_chatwheel_message_omniknight_3"	"Be at peace you wretched fool."
"dota_chatwheel_label_omniknight_3"	"Почивайте в мир, злочести глупако."
"[english]dota_chatwheel_label_omniknight_3"	"Be at peace you wretched fool."
"dota_chatwheel_message_omniknight_4"	"Изборът Ви беше незадоволителен."
"[english]dota_chatwheel_message_omniknight_4"	"You chose poorly."
"dota_chatwheel_label_omniknight_4"	"Изборът Ви беше незадоволителен."
"[english]dota_chatwheel_label_omniknight_4"	"You chose poorly."
"dota_chatwheel_message_omniknight_5"	"Всезнаещият долавя разкаянието Ви."
"[english]dota_chatwheel_message_omniknight_5"	"The All-knowing One senses your regret."
"dota_chatwheel_label_omniknight_5"	"Всезнаещият долавя…"
"[english]dota_chatwheel_label_omniknight_5"	"The All-knowing One senses..."
"dota_chatwheel_message_enchantress_laugh"	"Ха-ха-ха-ха-ха-ха-ха!"
"[english]dota_chatwheel_message_enchantress_laugh"	"Ha ha ha ha ha ha ha!"
"dota_chatwheel_label_enchantress_laugh"	"Смях"
"[english]dota_chatwheel_label_enchantress_laugh"	"Laugh"
"dota_chatwheel_message_enchantress_thank"	"Обичам да побеждавам!"
"[english]dota_chatwheel_message_enchantress_thank"	"I love winning!"
"dota_chatwheel_label_enchantress_thank"	"Обичам да побеждавам!"
"[english]dota_chatwheel_label_enchantress_thank"	"I love winning!"
"dota_chatwheel_message_enchantress_deny"	"Не се гневете."
"[english]dota_chatwheel_message_enchantress_deny"	"Don't be mad."
"dota_chatwheel_label_enchantress_deny"	"Не се гневете."
"[english]dota_chatwheel_label_enchantress_deny"	"Don't be mad."
"dota_chatwheel_message_enchantress_1"	"Просто не е честно."
"[english]dota_chatwheel_message_enchantress_1"	"It's just not fair."
"dota_chatwheel_label_enchantress_1"	"Просто не е честно."
"[english]dota_chatwheel_label_enchantress_1"	"It's just not fair."
"dota_chatwheel_message_enchantress_2"	"Смехотворно."
"[english]dota_chatwheel_message_enchantress_2"	"Hilarious."
"dota_chatwheel_label_enchantress_2"	"Смехотворно."
"[english]dota_chatwheel_label_enchantress_2"	"Hilarious."
"dota_chatwheel_message_enchantress_3"	"Постарахте се, доколкото е възможно."
"[english]dota_chatwheel_message_enchantress_3"	"You did your best."
"dota_chatwheel_label_enchantress_3"	"Постарахте се, доколкото е възможно."
"[english]dota_chatwheel_label_enchantress_3"	"You did your best."
"dota_chatwheel_message_enchantress_4"	"Спройнк."
"[english]dota_chatwheel_message_enchantress_4"	"Sproink."
"dota_chatwheel_label_enchantress_4"	"Спройнк."
"[english]dota_chatwheel_label_enchantress_4"	"Sproink."
"dota_chatwheel_message_enchantress_5"	"Знаете ли какво обичам? Всичко!"
"[english]dota_chatwheel_message_enchantress_5"	"You know what I love? Everything!"
"dota_chatwheel_label_enchantress_5"	"Знаете ли какво обичам…?"
"[english]dota_chatwheel_label_enchantress_5"	"You know what I love?..."
"dota_chatwheel_message_huskar_laugh"	"Хех-хех-хеех."
"[english]dota_chatwheel_message_huskar_laugh"	"Heh heh heeh."
"dota_chatwheel_label_huskar_laugh"	"Смях"
"[english]dota_chatwheel_label_huskar_laugh"	"Laugh"
"dota_chatwheel_message_huskar_thank"	"Ахх, това ще се понрави на боговете."
"[english]dota_chatwheel_message_huskar_thank"	"Ahh, this will please the gods."
"dota_chatwheel_label_huskar_thank"	"Ахх, това ще се понрави на боговете."
"[english]dota_chatwheel_label_huskar_thank"	"Ahh, this will please the gods."
"dota_chatwheel_message_huskar_deny"	"Доста си заслужаваше."
"[english]dota_chatwheel_message_huskar_deny"	"Well worth it."
"dota_chatwheel_label_huskar_deny"	"Доста си заслужаваше."
"[english]dota_chatwheel_label_huskar_deny"	"Well worth it."
"dota_chatwheel_message_huskar_1"	"Поредният пропилян живот."
"[english]dota_chatwheel_message_huskar_1"	"Another life squandered."
"dota_chatwheel_label_huskar_1"	"Поредният пропилян живот."
"[english]dota_chatwheel_label_huskar_1"	"Another life squandered."
"dota_chatwheel_message_huskar_2"	"Честна размяна!"
"[english]dota_chatwheel_message_huskar_2"	"A fair trade!"
"dota_chatwheel_label_huskar_2"	"Честна размяна!"
"[english]dota_chatwheel_label_huskar_2"	"A fair trade!"
"dota_chatwheel_message_huskar_3"	"Сега животът ми има смисъл!"
"[english]dota_chatwheel_message_huskar_3"	"My life now has meaning!"
"dota_chatwheel_label_huskar_3"	"Сега животът ми има смисъл!"
"[english]dota_chatwheel_label_huskar_3"	"My life now has meaning!"
"dota_chatwheel_message_huskar_4"	"Това ли беше всичко?"
"[english]dota_chatwheel_message_huskar_4"	"Is that all?"
"dota_chatwheel_label_huskar_4"	"Това ли беше всичко?"
"[english]dota_chatwheel_label_huskar_4"	"Is that all?"
"dota_chatwheel_message_huskar_5"	"Дадохте всичко от себе си, но не беше достатъчно."
"[english]dota_chatwheel_message_huskar_5"	"You gave all you could give but it was not enough."
"dota_chatwheel_label_huskar_5"	"Дадохте всичко от себе си…"
"[english]dota_chatwheel_label_huskar_5"	"You gave all you could give..."
"dota_chatwheel_message_night_stalker_laugh"	"Хех-хех-хех-хах-хех-хехххх."
"[english]dota_chatwheel_message_night_stalker_laugh"	"Heh heh heh hah heh hehhhh."
"dota_chatwheel_label_night_stalker_laugh"	"Смях"
"[english]dota_chatwheel_label_night_stalker_laugh"	"Laugh"
"dota_chatwheel_message_night_stalker_thank"	"Сега вече ще страдат."
"[english]dota_chatwheel_message_night_stalker_thank"	"Now they will suffer."
"dota_chatwheel_label_night_stalker_thank"	"Сега вече ще страдат."
"[english]dota_chatwheel_label_night_stalker_thank"	"Now they will suffer."
"dota_chatwheel_message_night_stalker_deny"	"Кошмарът Ви продължава."
"[english]dota_chatwheel_message_night_stalker_deny"	"Your nightmare continues."
"dota_chatwheel_label_night_stalker_deny"	"Кошмарът Ви продължава."
"[english]dota_chatwheel_label_night_stalker_deny"	"Your nightmare continues."
"dota_chatwheel_message_night_stalker_1"	"Точно от това се нуждаех!"
"[english]dota_chatwheel_message_night_stalker_1"	"Just what I needed!"
"dota_chatwheel_label_night_stalker_1"	"Точно от това се нуждаех."
"[english]dota_chatwheel_label_night_stalker_1"	"Just what I needed."
"dota_chatwheel_message_night_stalker_2"	"Няма накъде да бягате."
"[english]dota_chatwheel_message_night_stalker_2"	"There's no escape."
"dota_chatwheel_label_night_stalker_2"	"Няма накъде да бягате."
"[english]dota_chatwheel_label_night_stalker_2"	"There's no escape."
"dota_chatwheel_message_night_stalker_3"	"Мракът копнее."
"[english]dota_chatwheel_message_night_stalker_3"	"Darkness hungers."
"dota_chatwheel_label_night_stalker_3"	"Мракът копнее."
"[english]dota_chatwheel_label_night_stalker_3"	"Darkness hungers."
"dota_chatwheel_message_night_stalker_4"	"Време е за прехраната."
"[english]dota_chatwheel_message_night_stalker_4"	"It's feeding time."
"dota_chatwheel_label_night_stalker_4"	"Време е за прехраната."
"[english]dota_chatwheel_label_night_stalker_4"	"It's feeding time."
"dota_chatwheel_message_night_stalker_5"	"Аз съм звярът от приказките преди лягане."
"[english]dota_chatwheel_message_night_stalker_5"	"I'm the beast of bedtime tales."
"dota_chatwheel_label_night_stalker_5"	"Аз съм звярът от приказките преди лягане."
"[english]dota_chatwheel_label_night_stalker_5"	"I'm the beast of bedtime tales."
"dota_chatwheel_message_broodmother_laugh"	"Ха-ха-ха-ха-ха."
"[english]dota_chatwheel_message_broodmother_laugh"	"Ha ha ha ha ha."
"dota_chatwheel_label_broodmother_laugh"	"Смях"
"[english]dota_chatwheel_label_broodmother_laugh"	"Laugh"
"dota_chatwheel_message_broodmother_thank"	"Какво прелестно люпило."
"[english]dota_chatwheel_message_broodmother_thank"	"What a lovely brood."
"dota_chatwheel_label_broodmother_thank"	"Прелестно люпило."
"[english]dota_chatwheel_label_broodmother_thank"	"A lovely brood."
"dota_chatwheel_message_broodmother_deny"	"Нуждая се от това, както ми е необходим още един чифт крака."
"[english]dota_chatwheel_message_broodmother_deny"	"I need this like I need another pair of legs."
"dota_chatwheel_label_broodmother_deny"	"Това не ми е нужно."
"[english]dota_chatwheel_label_broodmother_deny"	"I don't need this."
"dota_chatwheel_message_broodmother_1"	"Изящно."
"[english]dota_chatwheel_message_broodmother_1"	"Delicious."
"dota_chatwheel_label_broodmother_1"	"Изящно."
"[english]dota_chatwheel_label_broodmother_1"	"Delicious."
"dota_chatwheel_message_broodmother_2"	"Нали не се страхувате от паяци?"
"[english]dota_chatwheel_message_broodmother_2"	"You're not afraid of spiders, are you?"
"dota_chatwheel_label_broodmother_2"	"Нали не се страхувате от паяци?"
"[english]dota_chatwheel_label_broodmother_2"	"You're not afraid of spiders, are you?"
"dota_chatwheel_message_broodmother_3"	"Не умирайте, мили мои."
"[english]dota_chatwheel_message_broodmother_3"	"Don't die, my darlings."
"dota_chatwheel_label_broodmother_3"	"Не умирайте, мили мои."
"[english]dota_chatwheel_label_broodmother_3"	"Don't die, my darlings."
"dota_chatwheel_message_broodmother_4"	"О, колко красиво."
"[english]dota_chatwheel_message_broodmother_4"	"Oh so beautiful."
"dota_chatwheel_label_broodmother_4"	"О, колко красиво."
"[english]dota_chatwheel_label_broodmother_4"	"Oh, so beautiful."
"dota_chatwheel_message_broodmother_5"	"Ссс-ссс-сссърбане!"
"[english]dota_chatwheel_message_broodmother_5"	"Sss-sss-ssslurp!"
"dota_chatwheel_label_broodmother_5"	"Сърбане."
"[english]dota_chatwheel_label_broodmother_5"	"Slurp."
"dota_chatwheel_message_bounty_hunter_laugh"	"Ах-ха-ха-ха-ха-ха-ха-ха-ха."
"[english]dota_chatwheel_message_bounty_hunter_laugh"	"Ah ha ha ha ha ha ha ha ha."
"dota_chatwheel_label_bounty_hunter_laugh"	"Смях"
"[english]dota_chatwheel_label_bounty_hunter_laugh"	"Laugh"
"dota_chatwheel_message_bounty_hunter_thank"	"Съюзниците ми са си заслужили отплатата."
"[english]dota_chatwheel_message_bounty_hunter_thank"	"My allies have earned their keep."
"dota_chatwheel_label_bounty_hunter_thank"	"Заслужили са си отплатата."
"[english]dota_chatwheel_label_bounty_hunter_thank"	"Earned their keep."
"dota_chatwheel_message_bounty_hunter_deny"	"Колко от Вас трябва да убия?"
"[english]dota_chatwheel_message_bounty_hunter_deny"	"How many of you do I have to kill?"
"dota_chatwheel_label_bounty_hunter_deny"	"Колко трябва да убия?"
"[english]dota_chatwheel_label_bounty_hunter_deny"	"How many do I have to kill?"
"dota_chatwheel_message_bounty_hunter_1"	"Просто работа, нищо лично."
"[english]dota_chatwheel_message_bounty_hunter_1"	"Just business, nothing personal."
"dota_chatwheel_label_bounty_hunter_1"	"Просто работа…"
"[english]dota_chatwheel_label_bounty_hunter_1"	"Just business..."
"dota_chatwheel_message_bounty_hunter_2"	"Мъдрият ловец познава търпението."
"[english]dota_chatwheel_message_bounty_hunter_2"	"A wise hunter knows patience."
"dota_chatwheel_label_bounty_hunter_2"	"Мъдрият ловец познава търпението."
"[english]dota_chatwheel_label_bounty_hunter_2"	"A wise hunter knows patience."
"dota_chatwheel_message_bounty_hunter_3"	"Жегва, нали?"
"[english]dota_chatwheel_message_bounty_hunter_3"	"Stings, don't it?"
"dota_chatwheel_label_bounty_hunter_3"	"Жегва, нали?"
"[english]dota_chatwheel_label_bounty_hunter_3"	"Stings, don't it?"
"dota_chatwheel_message_bounty_hunter_5"	"Ще се носят истории за това."
"[english]dota_chatwheel_message_bounty_hunter_5"	"They'll tell tales of this."
"dota_chatwheel_label_bounty_hunter_5"	"Ще се носят истории за това."
"[english]dota_chatwheel_label_bounty_hunter_5"	"They'll tell tales of this."
"dota_chatwheel_message_weaver_laugh"	"Хе-хех-хе-хах!"
"[english]dota_chatwheel_message_weaver_laugh"	"Hehehhehah!"
"dota_chatwheel_label_weaver_laugh"	"Смях"
"[english]dota_chatwheel_label_weaver_laugh"	"Laugh"
"dota_chatwheel_message_weaver_thank"	"Кройката е завършена."
"[english]dota_chatwheel_message_weaver_thank"	"The pattern is complete."
"dota_chatwheel_label_weaver_thank"	"Кройката е завършена!"
"[english]dota_chatwheel_label_weaver_thank"	"The pattern is complete!"
"dota_chatwheel_message_weaver_deny"	"Помислихте си, че сте ме спипали, нали така?"
"[english]dota_chatwheel_message_weaver_deny"	"You thought you had me, didn't you?"
"dota_chatwheel_label_weaver_deny"	"Помислихте си, че сте ме спипали."
"[english]dota_chatwheel_label_weaver_deny"	"Thought you had me."
"dota_chatwheel_message_weaver_1"	"Долавям даден еталон тук."
"[english]dota_chatwheel_message_weaver_1"	"I'm sensing a pattern here."
"dota_chatwheel_label_weaver_1"	"Долавям даден еталон."
"[english]dota_chatwheel_label_weaver_1"	"Sensing a pattern."
"dota_chatwheel_message_weaver_2"	"В плановете има непредвидено препятствие."
"[english]dota_chatwheel_message_weaver_2"	"There's a snag in your plans."
"dota_chatwheel_label_weaver_2"	"Има непредвидено препятствие…"
"[english]dota_chatwheel_label_weaver_2"	"There's a snag..."
"dota_chatwheel_message_weaver_3"	"Даденият еталон се повтаря."
"[english]dota_chatwheel_message_weaver_3"	"A pattern repeats."
"dota_chatwheel_label_weaver_3"	"Даденият еталон се повтаря."
"[english]dota_chatwheel_label_weaver_3"	"A pattern repeats."
"dota_chatwheel_message_weaver_4"	"Пиршество за моите бръмбари."
"[english]dota_chatwheel_message_weaver_4"	"A feast for my beetles."
"dota_chatwheel_label_weaver_4"	"Пиршество за моите бръмбари."
"[english]dota_chatwheel_label_weaver_4"	"A feast for my beetles."
"dota_chatwheel_message_weaver_5"	"Хо, паднахте ми!"
"[english]dota_chatwheel_message_weaver_5"	"Ho, snap!"
"dota_chatwheel_label_weaver_5"	"Хо, паднахте ми!"
"[english]dota_chatwheel_label_weaver_5"	"Ho, snap!"
"dota_chatwheel_message_jakiro_laugh"	"Ха-ха-ха-ха-ха-ха-ха-ха-ха-ха-ха!"
"[english]dota_chatwheel_message_jakiro_laugh"	"Ha ha ha ha ha ha ha ha ha ha ha!"
"dota_chatwheel_label_jakiro_laugh"	"Смях"
"[english]dota_chatwheel_label_jakiro_laugh"	"Laugh"
"dota_chatwheel_message_jakiro_thank"	"Наздраве."
"[english]dota_chatwheel_message_jakiro_thank"	"Cheers."
"dota_chatwheel_label_jakiro_thank"	"Наздраве."
"[english]dota_chatwheel_label_jakiro_thank"	"Cheers."
"dota_chatwheel_message_jakiro_deny"	"Това променя всичко."
"[english]dota_chatwheel_message_jakiro_deny"	"This changes everything."
"dota_chatwheel_label_jakiro_deny"	"Това променя всичко."
"[english]dota_chatwheel_label_jakiro_deny"	"This changes everything."
"dota_chatwheel_message_jakiro_1"	"Попилени."
"[english]dota_chatwheel_message_jakiro_1"	"Burninated."
"dota_chatwheel_label_jakiro_1"	"Попилени!"
"[english]dota_chatwheel_label_jakiro_1"	"Burninated!"
"dota_chatwheel_message_jakiro_2"	"Да си дойдем на думата."
"[english]dota_chatwheel_message_jakiro_2"	"Now we're talking."
"dota_chatwheel_label_jakiro_2"	"Да си дойдем на думата."
"[english]dota_chatwheel_label_jakiro_2"	"Now we're talking."
"dota_chatwheel_message_jakiro_3"	"Ще я видим тая работа."
"[english]dota_chatwheel_message_jakiro_3"	"We'll see about that."
"dota_chatwheel_label_jakiro_3"	"Ще я видим тая работа!"
"[english]dota_chatwheel_label_jakiro_3"	"We'll see about that!"
"dota_chatwheel_message_jakiro_4"	"Не сме впечатлени."
"[english]dota_chatwheel_message_jakiro_4"	"We are not amused."
"dota_chatwheel_label_jakiro_4"	"Не сме впечатлени."
"[english]dota_chatwheel_label_jakiro_4"	"We are not amused."
"dota_chatwheel_message_jakiro_5"	"Това беше хладнокръвно."
"[english]dota_chatwheel_message_jakiro_5"	"That was cold blooded."
"dota_chatwheel_label_jakiro_5"	"Това беше хладнокръвно."
"[english]dota_chatwheel_label_jakiro_5"	"That was cold blooded."
"dota_chatwheel_message_batrider_laugh"	"Хе-ха-ха!"
"[english]dota_chatwheel_message_batrider_laugh"	"He ha ha!"
"dota_chatwheel_label_batrider_laugh"	"Смях"
"[english]dota_chatwheel_label_batrider_laugh"	"Laugh"
"dota_chatwheel_message_batrider_thank"	"Ах, ето за това иде реч!"
"[english]dota_chatwheel_message_batrider_thank"	"Ah, that's what I'm talking about!"
"dota_chatwheel_label_batrider_thank"	"Ето за това иде реч."
"[english]dota_chatwheel_label_batrider_thank"	"That's what I'm talking about."
"dota_chatwheel_message_batrider_deny"	"Това ще Ви жегне."
"[english]dota_chatwheel_message_batrider_deny"	"This is gonna sting."
"dota_chatwheel_label_batrider_deny"	"Това ще Ви жегне."
"[english]dota_chatwheel_label_batrider_deny"	"This is gonna sting."
"dota_chatwheel_message_batrider_1"	"Ау, да, отпрашваме към залеза."
"[english]dota_chatwheel_message_batrider_1"	"Aw yeah, off we ride into the sunset."
"dota_chatwheel_label_batrider_1"	"Към залеза!"
"[english]dota_chatwheel_label_batrider_1"	"Into the sunset!"
"dota_chatwheel_message_batrider_2"	"Животът току-що стана интересен!"
"[english]dota_chatwheel_message_batrider_2"	"Life just got interesting!"
"dota_chatwheel_label_batrider_2"	"Животът току-що стана интересен!"
"[english]dota_chatwheel_label_batrider_2"	"Life just got interesting!"
"dota_chatwheel_message_batrider_3"	"Изстисквам волята Ви за живот!"
"[english]dota_chatwheel_message_batrider_3"	"I'm sappin your will to live!"
"dota_chatwheel_label_batrider_3"	"Изстисквам волята Ви за живот!"
"[english]dota_chatwheel_label_batrider_3"	"Sappin' your will to live!"
"dota_chatwheel_message_batrider_4"	"Еха, болезнено изгаряне!"
"[english]dota_chatwheel_message_batrider_4"	"Whoa, sick burn!"
"dota_chatwheel_label_batrider_4"	"Болезнено изгаряне!"
"[english]dota_chatwheel_label_batrider_4"	"Sick burn!"
"dota_chatwheel_message_batrider_5"	"Това беше куцо."
"[english]dota_chatwheel_message_batrider_5"	"That was lame."
"dota_chatwheel_label_batrider_5"	"Това беше куцо."
"[english]dota_chatwheel_label_batrider_5"	"That was lame."
"dota_chatwheel_message_chen_laugh"	"Хе-хех-мех-мех-ммм."
"[english]dota_chatwheel_message_chen_laugh"	"Hehehmehmehmmm."
"dota_chatwheel_label_chen_laugh"	"Смях"
"[english]dota_chatwheel_label_chen_laugh"	"Laugh"
"dota_chatwheel_message_chen_thank"	"О, слава богу."
"[english]dota_chatwheel_message_chen_thank"	"Oh, thank God."
"dota_chatwheel_label_chen_thank"	"О, слава богу."
"[english]dota_chatwheel_label_chen_thank"	"Oh, thank God."
"dota_chatwheel_message_chen_deny"	"Не можете да избягате от своите грехове."
"[english]dota_chatwheel_message_chen_deny"	"Can't escape your sins."
"dota_chatwheel_label_chen_deny"	"Не можете да избягате от своите грехове."
"[english]dota_chatwheel_label_chen_deny"	"You can't escape your sins."
"dota_chatwheel_message_chen_1"	"Счетен за недостоен."
"[english]dota_chatwheel_message_chen_1"	"Found unworthy."
"dota_chatwheel_label_chen_1"	"Счетен за недостоен."
"[english]dota_chatwheel_label_chen_1"	"Found unworthy."
"dota_chatwheel_message_chen_2"	"Що за богохулство е това?"
"[english]dota_chatwheel_message_chen_2"	"What blasphemy is this?"
"dota_chatwheel_label_chen_2"	"Що за богохулство…"
"[english]dota_chatwheel_label_chen_2"	"What blasphemy..."
"dota_chatwheel_message_chen_3"	"Времето наближава."
"[english]dota_chatwheel_message_chen_3"	"The time draws nigh."
"dota_chatwheel_label_chen_3"	"Времето наближава."
"[english]dota_chatwheel_label_chen_3"	"The time draws nigh."
"dota_chatwheel_message_chen_4"	"Преследването започва сега!"
"[english]dota_chatwheel_message_chen_4"	"The persecution starts now!"
"dota_chatwheel_label_chen_4"	"Преследването…"
"[english]dota_chatwheel_label_chen_4"	"The persecution..."
"dota_chatwheel_message_chen_5"	"Осъществяване на пророчеството."
"[english]dota_chatwheel_message_chen_5"	"A fulfillment of the prophecy."
"dota_chatwheel_label_chen_5"	"Осъществяване на пророчеството."
"[english]dota_chatwheel_label_chen_5"	"A fulfillment of the prophecy."
"dota_chatwheel_message_spectre_laugh"	"Ха-ха-ха-ха-ха-ха-ха-ха-ха!"
"[english]dota_chatwheel_message_spectre_laugh"	"Ha ha ha ha ha ha ha ha ha!"
"dota_chatwheel_label_spectre_laugh"	"[Смях]"
"[english]dota_chatwheel_label_spectre_laugh"	"[Laugh]"
"dota_chatwheel_message_spectre_thank"	"Ще стоя до Вас."
"[english]dota_chatwheel_message_spectre_thank"	"I'll stand by you."
"dota_chatwheel_label_spectre_thank"	"Ще стоя до Вас."
"[english]dota_chatwheel_label_spectre_thank"	"I'll stand by you."
"dota_chatwheel_message_spectre_deny"	"Грешно."
"[english]dota_chatwheel_message_spectre_deny"	"Wrong."
"dota_chatwheel_label_spectre_deny"	"Грешно."
"[english]dota_chatwheel_label_spectre_deny"	"Wrong."
"dota_chatwheel_message_spectre_1"	"Не разбирам."
"[english]dota_chatwheel_message_spectre_1"	"I do not understand."
"dota_chatwheel_label_spectre_1"	"Не разбирам."
"[english]dota_chatwheel_label_spectre_1"	"I do not understand."
"dota_chatwheel_message_spectre_2"	"Какво е това?"
"[english]dota_chatwheel_message_spectre_2"	"What is this?"
"dota_chatwheel_label_spectre_2"	"Какво е това?"
"[english]dota_chatwheel_label_spectre_2"	"What is this?"
"dota_chatwheel_message_spectre_3"	"Полезно умение."
"[english]dota_chatwheel_message_spectre_3"	"A useful skill."
"dota_chatwheel_label_spectre_3"	"Полезно умение."
"[english]dota_chatwheel_label_spectre_3"	"A useful skill."
"dota_chatwheel_message_spectre_4"	"Никой ли не ме разбира?"
"[english]dota_chatwheel_message_spectre_4"	"Can no one understand me?"
"dota_chatwheel_label_spectre_4"	"Никой ли не ме разбира?"
"[english]dota_chatwheel_label_spectre_4"	"Can no one understand me?"
"dota_chatwheel_message_spectre_5"	"Мизерни и невежи."
"[english]dota_chatwheel_message_spectre_5"	"Miserable and ignorant."
"dota_chatwheel_label_spectre_5"	"Мизерни и невежи."
"[english]dota_chatwheel_label_spectre_5"	"Miserable and ignorant."
"dota_chatwheel_message_ancient_apparition_laugh"	"Хм-хм-ха-ха-ха-ха-ха-ха-ха!"
"[english]dota_chatwheel_message_ancient_apparition_laugh"	"Hm hm hm ha ha ha ha ha ha ha!"
"dota_chatwheel_label_ancient_apparition_laugh"	"Смях"
"[english]dota_chatwheel_label_ancient_apparition_laugh"	"Laugh"
"dota_chatwheel_message_ancient_apparition_thank"	"Интересно."
"[english]dota_chatwheel_message_ancient_apparition_thank"	"Interesting."
"dota_chatwheel_label_ancient_apparition_thank"	"Интересно."
"[english]dota_chatwheel_label_ancient_apparition_thank"	"Interesting."
"dota_chatwheel_message_ancient_apparition_deny"	"Духа студен повей."
"[english]dota_chatwheel_message_ancient_apparition_deny"	"A cold wind blows."
"dota_chatwheel_label_ancient_apparition_deny"	"Духа студен повей."
"[english]dota_chatwheel_label_ancient_apparition_deny"	"A cold wind blows."
"dota_chatwheel_message_ancient_apparition_1"	"Кръвта Ви се смразява."
"[english]dota_chatwheel_message_ancient_apparition_1"	"Your blood runs cold."
"dota_chatwheel_label_ancient_apparition_1"	"Кръвта Ви се смразява."
"[english]dota_chatwheel_label_ancient_apparition_1"	"Your blood runs cold."
"dota_chatwheel_message_ancient_apparition_2"	"Твърде съм стар за това!"
"[english]dota_chatwheel_message_ancient_apparition_2"	"I'm too old for this!"
"dota_chatwheel_label_ancient_apparition_2"	"Твърде съм стар за това."
"[english]dota_chatwheel_label_ancient_apparition_2"	"I'm too old for this."
"dota_chatwheel_message_ancient_apparition_3"	"Чаках цяла вечност, но си заслужаваше."
"[english]dota_chatwheel_message_ancient_apparition_3"	"I waited ages but it was worth it."
"dota_chatwheel_label_ancient_apparition_3"	"Чаках цяла вечност…"
"[english]dota_chatwheel_label_ancient_apparition_3"	"I waited ages..."
"dota_chatwheel_message_ancient_apparition_4"	"Време е да разчупим леда!"
"[english]dota_chatwheel_message_ancient_apparition_4"	"Time to break the ice!"
"dota_chatwheel_label_ancient_apparition_4"	"Разчупете леда."
"[english]dota_chatwheel_label_ancient_apparition_4"	"Break the ice."
"dota_chatwheel_message_ancient_apparition_5"	"Icefog!"
"[english]dota_chatwheel_message_ancient_apparition_5"	"Icefog!"
"dota_chatwheel_label_ancient_apparition_5"	"Icefog!"
"[english]dota_chatwheel_label_ancient_apparition_5"	"Icefog!"
"dota_chatwheel_message_doom_bringer_laugh"	"Хе-хех-хех-хах-хех-хах-хах-хах."
"[english]dota_chatwheel_message_doom_bringer_laugh"	"Heheh heh hah heh hah hah hah."
"dota_chatwheel_label_doom_bringer_laugh"	"Смях"
"[english]dota_chatwheel_label_doom_bringer_laugh"	"Laugh"
"dota_chatwheel_message_doom_bringer_thank"	"О, да."
"[english]dota_chatwheel_message_doom_bringer_thank"	"Oh, yes."
"dota_chatwheel_label_doom_bringer_thank"	"О, да."
"[english]dota_chatwheel_label_doom_bringer_thank"	"Oh, yes."
"dota_chatwheel_message_doom_bringer_deny"	"Аз рискувах, а Вие загубихте."
"[english]dota_chatwheel_message_doom_bringer_deny"	"I gambled, you lost."
"dota_chatwheel_label_doom_bringer_deny"	"Аз рискувах, а Вие загубихте."
"[english]dota_chatwheel_label_doom_bringer_deny"	"I gambled, you lost."
"dota_chatwheel_message_doom_bringer_1"	"Хе-хе-хех-хех-хе, дяволски съм красив, нали?"
"[english]dota_chatwheel_message_doom_bringer_1"	"He he heh heh he, handsome devil, aren't I?"
"dota_chatwheel_label_doom_bringer_1"	"Дяволски съм красив, нали?"
"[english]dota_chatwheel_label_doom_bringer_1"	"Handsome devil, aren't I?"
"dota_chatwheel_message_doom_bringer_2"	"Е, адските камбани ехтят."
"[english]dota_chatwheel_message_doom_bringer_2"	"Well, hell's bells."
"dota_chatwheel_label_doom_bringer_2"	"Е, адските камбани ехтят."
"[english]dota_chatwheel_label_doom_bringer_2"	"Well, hell's bells!"
"dota_chatwheel_message_doom_bringer_3"	"О, гадост."
"[english]dota_chatwheel_message_doom_bringer_3"	"Oh, crap."
"dota_chatwheel_label_doom_bringer_3"	"О, гадост!"
"[english]dota_chatwheel_label_doom_bringer_3"	"Oh, crap!"
"dota_chatwheel_message_doom_bringer_4"	"Хе-ммехм, този път имахте късмет."
"[english]dota_chatwheel_message_doom_bringer_4"	"Hemmehm, you were lucky this time."
"dota_chatwheel_label_doom_bringer_4"	"Този път имахте късмет."
"[english]dota_chatwheel_label_doom_bringer_4"	"You were lucky this time."
"dota_chatwheel_message_doom_bringer_5"	"Всичко отива по дяволите."
"[english]dota_chatwheel_message_doom_bringer_5"	"All hell's broken loose."
"dota_chatwheel_label_doom_bringer_5"	"Всичко отива по дяволите."
"[english]dota_chatwheel_label_doom_bringer_5"	"All hell's broken loose."
"dota_chatwheel_message_ursa_laugh"	"Хах! Хах! Хах-хах-хах!"
"[english]dota_chatwheel_message_ursa_laugh"	"Hah! Hah! Hah-hah-hah!"
"dota_chatwheel_label_ursa_laugh"	"Смях"
"[english]dota_chatwheel_label_ursa_laugh"	"Laugh"
"dota_chatwheel_message_ursa_thank"	"Пролет ли е вече?"
"[english]dota_chatwheel_message_ursa_thank"	"Is it spring already?"
"dota_chatwheel_label_ursa_thank"	"Пролет ли е вече?"
"[english]dota_chatwheel_label_ursa_thank"	"Is it spring already?"
"dota_chatwheel_message_ursa_deny"	"Толкова малка загуба, че светът едва ли би забелязал."
"[english]dota_chatwheel_message_ursa_deny"	"A loss so small, the world will hardly notice."
"dota_chatwheel_label_ursa_deny"	"Толкова малка загуба."
"[english]dota_chatwheel_label_ursa_deny"	"A loss so small."
"dota_chatwheel_message_ursa_1"	"Жалка отбрана."
"[english]dota_chatwheel_message_ursa_1"	"A poor defense."
"dota_chatwheel_label_ursa_1"	"Жалка отбрана."
"[english]dota_chatwheel_label_ursa_1"	"A poor defense."
"dota_chatwheel_message_ursa_2"	"Пухчо-мухчо!"
"[english]dota_chatwheel_message_ursa_2"	"Fuzzy Wuzzy!"
"dota_chatwheel_label_ursa_2"	"Пухчо-мухчо!"
"[english]dota_chatwheel_label_ursa_2"	"Fuzzy Wuzzy!"
"dota_chatwheel_message_ursa_3"	"Как така не чухте моите предупреждения?"
"[english]dota_chatwheel_message_ursa_3"	"How is it you heard not my warnings?"
"dota_chatwheel_label_ursa_3"	"Как така не чухте моите предупреждения?"
"[english]dota_chatwheel_label_ursa_3"	"How is it you heard not my warnings?"
"dota_chatwheel_message_ursa_4"	"Сладко като мед."
"[english]dota_chatwheel_message_ursa_4"	"Sweet as honey."
"dota_chatwheel_label_ursa_4"	"Сладко като мед."
"[english]dota_chatwheel_label_ursa_4"	"Sweet as honey."
"dota_chatwheel_message_ursa_5"	"Мляс, мляс, не е зле! Сърбане, мляс, мляс, мляс."
"[english]dota_chatwheel_message_ursa_5"	"Mtlap tlap, not bad! Sllleup tlap tlap tlap."
"dota_chatwheel_label_ursa_5"	"Мм, не е зле."
"[english]dota_chatwheel_label_ursa_5"	"Mm, not bad."
"dota_chatwheel_message_spirit_breaker_laugh"	"Уохо-хе-хе-хе-ах-ах-ах."
"[english]dota_chatwheel_message_spirit_breaker_laugh"	"Whoheheheahahah."
"dota_chatwheel_label_spirit_breaker_laugh"	"Смях"
"[english]dota_chatwheel_label_spirit_breaker_laugh"	"Laugh"
"dota_chatwheel_message_spirit_breaker_thank"	"Хах, всичко си идва на мястото!"
"[english]dota_chatwheel_message_spirit_breaker_thank"	"Hah, it's all coming together!"
"dota_chatwheel_label_spirit_breaker_thank"	"Всичко си идва на мястото."
"[english]dota_chatwheel_label_spirit_breaker_thank"	"All coming together."
"dota_chatwheel_message_spirit_breaker_deny"	"Зашеметяващо, нали така?"
"[english]dota_chatwheel_message_spirit_breaker_deny"	"Stunning, isn't it?"
"dota_chatwheel_label_spirit_breaker_deny"	"Зашеметяващо, нали така."
"[english]dota_chatwheel_label_spirit_breaker_deny"	"Stunning, isn't it."
"dota_chatwheel_message_spirit_breaker_1"	"Търпението ми е възнаградено."
"[english]dota_chatwheel_message_spirit_breaker_1"	"My patience is rewarded."
"dota_chatwheel_label_spirit_breaker_1"	"Търпението ми е възнаградено"
"[english]dota_chatwheel_label_spirit_breaker_1"	"My patience is rewarded"
"dota_chatwheel_message_spirit_breaker_2"	"Няма как да ми избягате."
"[english]dota_chatwheel_message_spirit_breaker_2"	"There's no escaping me."
"dota_chatwheel_label_spirit_breaker_2"	"Няма как да ми избягате."
"[english]dota_chatwheel_label_spirit_breaker_2"	"There's no escaping me."
"dota_chatwheel_message_spirit_breaker_3"	"Това са пълни и абсолютни глупости!"
"[english]dota_chatwheel_message_spirit_breaker_3"	"This is complete and utter bullshit!"
"dota_chatwheel_label_spirit_breaker_3"	"Това са глупости!"
"[english]dota_chatwheel_label_spirit_breaker_3"	"This is bullshit."
"dota_chatwheel_message_spirit_breaker_4"	"Само в този дух."
"[english]dota_chatwheel_message_spirit_breaker_4"	"That's the spirit."
"dota_chatwheel_label_spirit_breaker_4"	"Само в този дух."
"[english]dota_chatwheel_label_spirit_breaker_4"	"That's the spirit."
"dota_chatwheel_message_spirit_breaker_5"	"Това не се разви според очакваното."
"[english]dota_chatwheel_message_spirit_breaker_5"	"That did not go as expected."
"dota_chatwheel_label_spirit_breaker_5"	"Това не се разви според очакваното."
"[english]dota_chatwheel_label_spirit_breaker_5"	"That did not go as expected."
"dota_chatwheel_message_gyrocopter_laugh"	"Ах-ха! Уах-хаха-ха-ха! Ах-ха-ххух."
"[english]dota_chatwheel_message_gyrocopter_laugh"	"Ah ha! Wah haha ha ha! Ah ha hhuh."
"dota_chatwheel_label_gyrocopter_laugh"	"Смях"
"[english]dota_chatwheel_label_gyrocopter_laugh"	"Laugh"
"dota_chatwheel_message_gyrocopter_thank"	"По нещо за всекиго!"
"[english]dota_chatwheel_message_gyrocopter_thank"	"Something for everybody!"
"dota_chatwheel_label_gyrocopter_thank"	"По нещо за всекиго!"
"[english]dota_chatwheel_label_gyrocopter_thank"	"Something for everybody!"
"dota_chatwheel_message_gyrocopter_deny"	"Ааах, как пък не."
"[english]dota_chatwheel_message_gyrocopter_deny"	"Aaah phooey."
"dota_chatwheel_label_gyrocopter_deny"	"Ааах, как пък не!"
"[english]dota_chatwheel_label_gyrocopter_deny"	"Aaah phooey!"
"dota_chatwheel_message_gyrocopter_1"	"Късметлия!"
"[english]dota_chatwheel_message_gyrocopter_1"	"Lucky!"
"dota_chatwheel_label_gyrocopter_1"	"Късметлия!"
"[english]dota_chatwheel_label_gyrocopter_1"	"Lucky!"
"dota_chatwheel_message_gyrocopter_2"	"Ставам твърде стар за тези глупости."
"[english]dota_chatwheel_message_gyrocopter_2"	"I'm getting too old for this horse shit."
"dota_chatwheel_label_gyrocopter_2"	"Ставам твърде стар за тези глупости."
"[english]dota_chatwheel_label_gyrocopter_2"	"I'm getting too old for this horse shit."
"dota_chatwheel_message_gyrocopter_3"	"Разкарайте се от ливадата ми!"
"[english]dota_chatwheel_message_gyrocopter_3"	"Get off my lawn!"
"dota_chatwheel_label_gyrocopter_3"	"Разкарайте се от ливадата ми!"
"[english]dota_chatwheel_label_gyrocopter_3"	"Get off my lawn!"
"dota_chatwheel_message_gyrocopter_4"	"Т’ва ще Ви научи!"
"[english]dota_chatwheel_message_gyrocopter_4"	"That'll learn ya!"
"dota_chatwheel_label_gyrocopter_4"	"Т’ва ще Ви научи!"
"[english]dota_chatwheel_label_gyrocopter_4"	"That'll learn ya!"
"dota_chatwheel_message_gyrocopter_5"	"Аз принадлежа на небето, а Вие на земята."
"[english]dota_chatwheel_message_gyrocopter_5"	"I belong in the sky, and you belong in the ground."
"dota_chatwheel_label_gyrocopter_5"	"Вие принадлежите на земята."
"[english]dota_chatwheel_label_gyrocopter_5"	"You belong in the ground."
"dota_chatwheel_message_alchemist_laugh"	"Ха-ха-ха-ха-ха!"
"[english]dota_chatwheel_message_alchemist_laugh"	"Ha ha ha ha ha!"
"dota_chatwheel_label_alchemist_laugh"	"Смях"
"[english]dota_chatwheel_label_alchemist_laugh"	"Laugh"
"dota_chatwheel_message_alchemist_thank"	"Между нас се получава доста добра химия."
"[english]dota_chatwheel_message_alchemist_thank"	"We've got pretty good chemistry."
"dota_chatwheel_label_alchemist_thank"	"Добра химия!"
"[english]dota_chatwheel_label_alchemist_thank"	"Good chemistry!"
"dota_chatwheel_message_alchemist_deny"	"Това беше гениално!"
"[english]dota_chatwheel_message_alchemist_deny"	"That was genius!"
"dota_chatwheel_label_alchemist_deny"	"Това беше гениално!"
"[english]dota_chatwheel_label_alchemist_deny"	"That was genius!"
"dota_chatwheel_message_alchemist_1"	"Хей, всички!"
"[english]dota_chatwheel_message_alchemist_1"	"Hey, everybody!"
"dota_chatwheel_label_alchemist_1"	"Хей, всички."
"[english]dota_chatwheel_label_alchemist_1"	"Hey everybody."
"dota_chatwheel_message_alchemist_2"	"Като говорим за преиграване."
"[english]dota_chatwheel_message_alchemist_2"	"Talk about overreacting."
"dota_chatwheel_label_alchemist_2"	"Като говорим за преиграване."
"[english]dota_chatwheel_label_alchemist_2"	"Talk about overreacting."
"dota_chatwheel_message_alchemist_3"	"Не мога да повярвам, че виждам това със собствените си очи!"
"[english]dota_chatwheel_message_alchemist_3"	"I can't believe I'm seeing this with my own eyes!"
"dota_chatwheel_label_alchemist_3"	"Не мога да повярвам, че виждам това."
"[english]dota_chatwheel_label_alchemist_3"	"Can't believe I'm seeing this."
"dota_chatwheel_message_alchemist_4"	"Каква бъркотия!"
"[english]dota_chatwheel_message_alchemist_4"	"What a mess!"
"dota_chatwheel_label_alchemist_4"	"Каква бъркотия!"
"[english]dota_chatwheel_label_alchemist_4"	"What a mess!"
"dota_chatwheel_message_alchemist_5"	"Неуспехът просто е друг вид успех. Грешният вид."
"[english]dota_chatwheel_message_alchemist_5"	"Failure is just another kind of success. The wrong kind."
"dota_chatwheel_label_alchemist_5"	"Грешният вид успех!"
"[english]dota_chatwheel_label_alchemist_5"	"Wrong kind of success!"
"dota_chatwheel_message_invoker_laugh"	"Ха-ха-ха-ха-ха-ха-ха-ха-ха-ха!"
"[english]dota_chatwheel_message_invoker_laugh"	"Ha ha ha ha ha ha ha ha ha ha!"
"dota_chatwheel_label_invoker_laugh"	"Смях"
"[english]dota_chatwheel_label_invoker_laugh"	"Laugh"
"dota_chatwheel_message_invoker_thank"	"Ще запаметя това."
"[english]dota_chatwheel_message_invoker_thank"	"I will commit this to memory."
"dota_chatwheel_label_invoker_thank"	"Ще запаметя това."
"[english]dota_chatwheel_label_invoker_thank"	"I will commit this to memory."
"dota_chatwheel_message_silencer_laugh"	"Ах-ха-ха."
"[english]dota_chatwheel_message_silencer_laugh"	"Ah ha ha."
"dota_chatwheel_label_silencer_laugh"	"Смях"
"[english]dota_chatwheel_label_silencer_laugh"	"Laugh"
"dota_chatwheel_message_silencer_1"	"Успокойте се."
"[english]dota_chatwheel_message_silencer_1"	"Calm yourselves."
"dota_chatwheel_label_silencer_1"	"Успокой се"
"[english]dota_chatwheel_label_silencer_1"	"Calm yourselves"
"dota_chatwheel_message_obsidian_destroyer_laugh"	"Ха-ха-ха-ха-ха-ха-ха-ха-ха!"
"[english]dota_chatwheel_message_obsidian_destroyer_laugh"	"Ha ha ha ha ha ha ha ha ha!"
"dota_chatwheel_label_obsidian_destroyer_laugh"	"Смях"
"[english]dota_chatwheel_label_obsidian_destroyer_laugh"	"Laugh"
"dota_chatwheel_message_obsidian_destroyer_deny"	"Целта ми е изпълнена."
"[english]dota_chatwheel_message_obsidian_destroyer_deny"	"My purpose fulfilled."
"dota_chatwheel_label_obsidian_destroyer_deny"	"Целта ми е изпълнена."
"[english]dota_chatwheel_label_obsidian_destroyer_deny"	"My purpose fulfilled."
"dota_chatwheel_message_obsidian_destroyer_2"	"Това не променя нищо."
"[english]dota_chatwheel_message_obsidian_destroyer_2"	"This changes nothing."
"dota_chatwheel_label_obsidian_destroyer_2"	"Това не променя нищо."
"[english]dota_chatwheel_label_obsidian_destroyer_2"	"This changes nothing."
"dota_chatwheel_message_lycan_laugh"	"Ах-ха-ха-ха-ха-ха-ха-ха."
"[english]dota_chatwheel_message_lycan_laugh"	"Ah ha ha ha ha ha ha ha."
"dota_chatwheel_label_lycan_laugh"	"Смях"
"[english]dota_chatwheel_label_lycan_laugh"	"Laugh"
"dota_chatwheel_message_lycan_5"	"Започнахте да ми допадате. Ха-ха-ха-ха-ха."
"[english]dota_chatwheel_message_lycan_5"	"I've taken a Lycan to you. Ha ha ha ha ha."
"dota_chatwheel_label_brewmaster_laugh"	"Смях"
"[english]dota_chatwheel_label_brewmaster_laugh"	"Laugh"
"dota_chatwheel_message_brewmaster_deny"	"Повече късмет следващият път."
"[english]dota_chatwheel_message_brewmaster_deny"	"Better luck next time."
"dota_chatwheel_label_brewmaster_deny"	"Повече късмет следващият път."
"[english]dota_chatwheel_label_brewmaster_deny"	"Better luck next time."
"dota_chatwheel_message_shadow_demon_laugh"	"Ха-ха-ха-ха-ха-ха-ха-ха-ха-ха."
"[english]dota_chatwheel_message_shadow_demon_laugh"	"Ha ha ha ha ha ha ha ha ha ha."
"dota_chatwheel_label_shadow_demon_laugh"	"Смях"
"[english]dota_chatwheel_label_shadow_demon_laugh"	"Laugh"
"dota_chatwheel_message_lone_druid_laugh"	"Ах-ха-ха-ха-ха-хах!"
"[english]dota_chatwheel_message_lone_druid_laugh"	"Ah ha ha ha ha hah!"
"dota_chatwheel_label_lone_druid_laugh"	"Смях"
"[english]dota_chatwheel_label_lone_druid_laugh"	"Laugh"
"dota_chatwheel_message_chaos_knight_laugh"	"Оо-хо-хо-ха-ха-ха-ха-ха-ха-ха-ха-ха-ха-ха!"
"[english]dota_chatwheel_message_chaos_knight_laugh"	"Oo ho ho ha ha ha ha ha ha ha ha ha ha ha!"
"dota_chatwheel_label_chaos_knight_laugh"	"Смях"
"[english]dota_chatwheel_label_chaos_knight_laugh"	"Laugh"
"dota_chatwheel_message_chaos_knight_thank"	"Да. Да!"
"[english]dota_chatwheel_message_chaos_knight_thank"	"Yes. Yes!"
"dota_chatwheel_label_chaos_knight_thank"	"Да. Да!"
"[english]dota_chatwheel_label_chaos_knight_thank"	"Yes. Yes!"
"dota_chatwheel_message_meepo_laugh"	"Мхах! Мхах-мхах-ха-ха-ха-ха!"
"[english]dota_chatwheel_message_meepo_laugh"	"Hnya Hnyahnyaha ha ha ha!"
"dota_chatwheel_label_meepo_laugh"	"Смях"
"[english]dota_chatwheel_label_meepo_laugh"	"Laugh"
"dota_chatwheel_label_meepo_thank"	"Ето за това иде реч сега!"
"[english]dota_chatwheel_label_meepo_thank"	"Now that's what I'm talking about!"
"dota_chatwheel_label_treant_laugh"	"Смях"
"[english]dota_chatwheel_label_treant_laugh"	"Laugh"
"dota_chatwheel_message_ogre_magi_laugh"	"Хее-хее-хе-хе-хе-хе-хе-аха-ха… За какво се смеем?"
"[english]dota_chatwheel_message_ogre_magi_laugh"	"Hee hee he he he he he aha ha... What're we laughing about?"
"dota_chatwheel_label_ogre_magi_laugh"	"Смях"
"[english]dota_chatwheel_label_ogre_magi_laugh"	"Laugh"
"dota_chatwheel_message_undying_laugh"	"Хех-хех-хех-хех-ха-ха-ха-ха-ха-ха-ха-ха-ха-ха!"
"[english]dota_chatwheel_message_undying_laugh"	"Heh heh heh heh ha ha ha ha ha ha ha ha ha ha!"
"dota_chatwheel_label_undying_laugh"	"Смях"
"[english]dota_chatwheel_label_undying_laugh"	"Laugh"
"dota_chatwheel_message_rubick_laugh"	"Ах-ха-ха! Ех-хе-хе-хе-хе-хе-хе-хе-хе-хе!"
"[english]dota_chatwheel_message_rubick_laugh"	"Ah ha ha! Eh he he he he he he he he he!"
"dota_chatwheel_label_rubick_laugh"	"Смях"
"[english]dota_chatwheel_label_rubick_laugh"	"Laugh"
"dota_chatwheel_label_disruptor_laugh"	"Смях"
"[english]dota_chatwheel_label_disruptor_laugh"	"Laugh"
"dota_chatwheel_label_nyx_assassin_laugh"	"Смях"
"[english]dota_chatwheel_label_nyx_assassin_laugh"	"Laugh"
"dota_chatwheel_label_naga_siren_laugh"	"Смях"
"[english]dota_chatwheel_label_naga_siren_laugh"	"Laugh"
"dota_chatwheel_label_naga_siren_5"	"Краката ми!"
"[english]dota_chatwheel_label_naga_siren_5"	"My legs!"
"dota_chatwheel_label_keeper_of_the_light_laugh"	"Смях"
"[english]dota_chatwheel_label_keeper_of_the_light_laugh"	"Laugh"
"dota_chatwheel_message_keeper_of_the_light_5"	"Не бойте се от светлината. Страхувайте се от мен!"
"[english]dota_chatwheel_message_keeper_of_the_light_5"	"Do not fear the light - fear me!"
"dota_chatwheel_label_keeper_of_the_light_5"	"Не бойте се от светлината…"
"[english]dota_chatwheel_label_keeper_of_the_light_5"	"Do not fear the light..."
"dota_chatwheel_message_wisp_laugh"	"Смехотворни писукания"
"[english]dota_chatwheel_message_wisp_laugh"	"Laughing Beeps"
"dota_chatwheel_label_wisp_laugh"	"Смехотворни писукания"
"[english]dota_chatwheel_label_wisp_laugh"	"Laughing Beeps"
"dota_chatwheel_message_wisp_thank"	"Благодарни писукания"
"[english]dota_chatwheel_message_wisp_thank"	"Thankful Beeps"
"dota_chatwheel_label_wisp_thank"	"Благодарни писукания"
"[english]dota_chatwheel_label_wisp_thank"	"Thankful Beeps"
"dota_chatwheel_message_wisp_deny"	"Отказващи писукания"
"[english]dota_chatwheel_message_wisp_deny"	"Denying Beeps"
"dota_chatwheel_label_wisp_deny"	"Отказващи писукания"
"[english]dota_chatwheel_label_wisp_deny"	"Denying Beeps"
"dota_chatwheel_message_wisp_1"	"Приятелски писукания"
"[english]dota_chatwheel_message_wisp_1"	"Friendly Beeps"
"dota_chatwheel_label_wisp_1"	"Приятелски писукания"
"[english]dota_chatwheel_label_wisp_1"	"Friendly Beeps"
"dota_chatwheel_message_wisp_2"	"Триумфални писукания"
"[english]dota_chatwheel_message_wisp_2"	"Triumphant Beeps"
"dota_chatwheel_label_wisp_2"	"Триумфални писукания"
"[english]dota_chatwheel_label_wisp_2"	"Triumphant Beeps"
"dota_chatwheel_message_wisp_3"	"Скърбящи писукания"
"[english]dota_chatwheel_message_wisp_3"	"Sorrowful Beeps"
"dota_chatwheel_label_wisp_3"	"Скърбящи писукания"
"[english]dota_chatwheel_label_wisp_3"	"Sorrowful Beeps"
"dota_chatwheel_message_wisp_4"	"Гневни писукания"
"[english]dota_chatwheel_message_wisp_4"	"Angry Beeps"
"dota_chatwheel_label_wisp_4"	"Гневни писукания"
"[english]dota_chatwheel_label_wisp_4"	"Angry Beeps"
"dota_chatwheel_message_wisp_5"	"Съзерцателни писукания"
"[english]dota_chatwheel_message_wisp_5"	"Meditative Beeps"
"dota_chatwheel_label_wisp_5"	"Съзерцателни писукания"
"[english]dota_chatwheel_label_wisp_5"	"Meditative Beeps"
"dota_chatwheel_message_visage_laugh"	"Ах-ха-ха-ха-ха-ха-ха-ха-ха!"
"[english]dota_chatwheel_message_visage_laugh"	"Ah ha ha ha ha ha ha ha ha!"
"dota_chatwheel_label_visage_laugh"	"Смях"
"[english]dota_chatwheel_label_visage_laugh"	"Laugh"
"dota_chatwheel_label_slark_laugh"	"Смях"
"[english]dota_chatwheel_label_slark_laugh"	"Laugh"
"dota_chatwheel_message_slark_5"	"О, това е много добре."
"[english]dota_chatwheel_message_slark_5"	"Oh that's very nice."
"dota_chatwheel_label_slark_5"	"О, това е много добре."
"[english]dota_chatwheel_label_slark_5"	"Oh that's very nice."
"dota_chatwheel_message_medusa_laugh"	"Хмм, хмм, хмм. Ха-ха-ха-ха-ха!"
"[english]dota_chatwheel_message_medusa_laugh"	"Hmm hmm hmm ha ha ha ha ha!"
"dota_chatwheel_label_medusa_laugh"	"Смях"
"[english]dota_chatwheel_label_medusa_laugh"	"Laugh"
"dota_chatwheel_message_medusa_2"	"О, гадост!"
"[english]dota_chatwheel_message_medusa_2"	"Oh, crap!"
"dota_chatwheel_label_medusa_2"	"О, гадост."
"[english]dota_chatwheel_label_medusa_2"	"Oh, crap."
"dota_chatwheel_label_troll_warlord_laugh"	"Смях"
"[english]dota_chatwheel_label_troll_warlord_laugh"	"Laugh"
"dota_chatwheel_label_centaur_laugh"	"Смях"
"[english]dota_chatwheel_label_centaur_laugh"	"Laugh"
"dota_chatwheel_message_centaur_3"	"Дяволите да Ви вземат обратно."
"[english]dota_chatwheel_message_centaur_3"	"Back to hell with you."
"dota_chatwheel_label_centaur_3"	"Дяволите да Ви вземат обратно."
"[english]dota_chatwheel_label_centaur_3"	"Back to hell with you."
"dota_chatwheel_message_centaur_4"	"О, да, бойте се от тропота на моите копита."
"[english]dota_chatwheel_message_centaur_4"	"Oh, yes, fear my hoofbeats."
"dota_chatwheel_message_magnataur_laugh"	"Ах-ха-ха."
"[english]dota_chatwheel_message_magnataur_laugh"	"Ah ha ha."
"dota_chatwheel_label_magnataur_laugh"	"Смях"
"[english]dota_chatwheel_label_magnataur_laugh"	"Laugh"
"dota_chatwheel_message_magnataur_deny"	"Това са глупости!"
"[english]dota_chatwheel_message_magnataur_deny"	"This is bullshit!"
"dota_chatwheel_label_magnataur_deny"	"Това са глупости!"
"[english]dota_chatwheel_label_magnataur_deny"	"This is bullshit!"
"dota_chatwheel_message_magnataur_1"	"Ха-ха-ха-ха! Какво очаквахте?"
"[english]dota_chatwheel_message_magnataur_1"	"Ha ha ha ha! What did you expect?"
"dota_chatwheel_label_shredder_laugh"	"Смях"
"[english]dota_chatwheel_label_shredder_laugh"	"Laugh"
"dota_chatwheel_message_shredder_1"	"О, да, ха-ха."
"[english]dota_chatwheel_message_shredder_1"	"Oh yeah ha ha."
"dota_chatwheel_label_shredder_1"	"О, да, ха-ха."
"[english]dota_chatwheel_label_shredder_1"	"Oh yeah ha ha."
"dota_chatwheel_label_bristleback_laugh"	"Смях"
"[english]dota_chatwheel_label_bristleback_laugh"	"Laugh"
"dota_chatwheel_message_tusk_laugh"	"Олеле! Ха-ха-ха-ха-ха!"
"[english]dota_chatwheel_message_tusk_laugh"	"Oh boy! Ha ha ha ha ha!"
"dota_chatwheel_label_tusk_laugh"	"Смях"
"[english]dota_chatwheel_label_tusk_laugh"	"Laugh"
"dota_chatwheel_message_skywrath_mage_laugh"	"Ха-ха!"
"[english]dota_chatwheel_message_skywrath_mage_laugh"	"Ha ha!"
"dota_chatwheel_label_skywrath_mage_laugh"	"Смях"
"[english]dota_chatwheel_label_skywrath_mage_laugh"	"Laugh"
"dota_chatwheel_message_abaddon_laugh"	"Ха-ха-ха-ха-ха-ха-ха-ха-ха."
"[english]dota_chatwheel_message_abaddon_laugh"	"Ha ha ha ha ha ha ha ha ha."
"dota_chatwheel_label_abaddon_laugh"	"Смях"
"[english]dota_chatwheel_label_abaddon_laugh"	"Laugh"
"dota_chatwheel_message_elder_titan_laugh"	"Ех-ха-ха-ха-ха-ха."
"[english]dota_chatwheel_message_elder_titan_laugh"	"Eh ha ha ha ha ha."
"dota_chatwheel_label_elder_titan_laugh"	"Смях"
"[english]dota_chatwheel_label_elder_titan_laugh"	"Laugh"
"dota_chatwheel_message_legion_commander_laugh"	"Ах-ха-ха-ха-ха-ха-ха!"
"[english]dota_chatwheel_message_legion_commander_laugh"	"Ah ha ha ha ha ha ha!"
"dota_chatwheel_label_legion_commander_laugh"	"Смях"
"[english]dota_chatwheel_label_legion_commander_laugh"	"Laugh"
"dota_chatwheel_message_techies_laugh"	"Хе-хе-хе! Хехе-ах-ха! Ох-хо-хо-ох-ох-ха-ха-ха!"
"[english]dota_chatwheel_message_techies_laugh"	"He he he, hehe ah ha! Oh ho ho oh oh ha ha ha!"
"dota_chatwheel_label_techies_laugh"	"Смях"
"[english]dota_chatwheel_label_techies_laugh"	"Laugh"
"dota_chatwheel_message_techies_1"	"О, гадост!"
"[english]dota_chatwheel_message_techies_1"	"Oh crap!"
"dota_chatwheel_label_techies_1"	"О, гадост!"
"[english]dota_chatwheel_label_techies_1"	"Oh crap!"
"dota_chatwheel_label_ember_spirit_laugh"	"Смях"
"[english]dota_chatwheel_label_ember_spirit_laugh"	"Laugh"
"dota_chatwheel_message_earth_spirit_laugh"	"Ох-хо-хо-ха-ха-ха-ха-ха-ха!"
"[english]dota_chatwheel_message_earth_spirit_laugh"	"Oh ho ho ha ha ha ha ha ha!"
"dota_chatwheel_label_earth_spirit_laugh"	"Смях"
"[english]dota_chatwheel_label_earth_spirit_laugh"	"Laugh"
"dota_chatwheel_message_earth_spirit_deny"	"Да, току-що направих това."
"[english]dota_chatwheel_message_earth_spirit_deny"	"Yes, I just did that."
"dota_chatwheel_label_earth_spirit_deny"	"Да, току-що направих това."
"[english]dota_chatwheel_label_earth_spirit_deny"	"Yes, I just did that."
"dota_chatwheel_message_abyssal_underlord_laugh"	"Ах-ха-ха-ха-ха-ха-ха-ха-ха!"
"[english]dota_chatwheel_message_abyssal_underlord_laugh"	"Ah ha ha ha ha ha ha ha ha!"
"dota_chatwheel_label_abyssal_underlord_laugh"	"Смях"
"[english]dota_chatwheel_label_abyssal_underlord_laugh"	"Laugh"
"dota_chatwheel_message_abyssal_underlord_1"	"О, да."
"[english]dota_chatwheel_message_abyssal_underlord_1"	"Oh yes."
"dota_chatwheel_label_abyssal_underlord_1"	"О, да."
"[english]dota_chatwheel_label_abyssal_underlord_1"	"Oh yes."
"dota_chatwheel_label_terrorblade_laugh"	"Смях"
"[english]dota_chatwheel_label_terrorblade_laugh"	"Laugh"
"dota_chatwheel_message_phoenix_laugh"	"Смехотворно грачене"
"[english]dota_chatwheel_message_phoenix_laugh"	"Laughing Squawk"
"dota_chatwheel_label_phoenix_laugh"	"Смехотворно грачене"
"[english]dota_chatwheel_label_phoenix_laugh"	"Laughing Squawk"
"dota_chatwheel_message_oracle_laugh"	"Хе-ха-ха-хе-ха-ха!"
"[english]dota_chatwheel_message_oracle_laugh"	"He ha ha he ha ha!"
"dota_chatwheel_label_oracle_laugh"	"Смях"
"[english]dota_chatwheel_label_oracle_laugh"	"Laugh"
"dota_chatwheel_label_arc_warden_laugh"	"Смях"
"[english]dota_chatwheel_label_arc_warden_laugh"	"Laugh"
"dota_chatwheel_message_winter_wyvern_laugh"	"Ах-ха-ха-ха-ха-ха-ха-ха-ха-ха-ха!"
"[english]dota_chatwheel_message_winter_wyvern_laugh"	"Ah ha ha ha ha ha ha ha ha ha ha!"
"dota_chatwheel_label_winter_wyvern_laugh"	"Смях"
"[english]dota_chatwheel_label_winter_wyvern_laugh"	"Laugh"
"dota_chatwheel_message_winter_wyvern_2"	"Клети почитаеми."
"[english]dota_chatwheel_message_winter_wyvern_2"	"Poor dear."
"dota_chatwheel_label_winter_wyvern_2"	"Клети почитаеми."
"[english]dota_chatwheel_label_winter_wyvern_2"	"Poor dear."
"dota_chatwheel_message_winter_wyvern_5"	"Ах, никога не съм се чувствала толкова добре! Ах-ха-ха-ха-ха!"
"[english]dota_chatwheel_message_winter_wyvern_5"	"Ah, I've never felt this good! Ah ha ha ha ha!"
"dota_chatwheel_message_monkey_king_laugh"	"Ах-ха-ха-ха-ха-ха. Уоохоохоохоо. Оххх-хеее."
"[english]dota_chatwheel_message_monkey_king_laugh"	"Ah ha ha ha ha ha. Woohoohoohoo. Ohhh heee."
"dota_chatwheel_label_monkey_king_laugh"	"Смях"
"[english]dota_chatwheel_label_monkey_king_laugh"	"Laugh"
"dota_chatwheel_label_dark_willow_laugh"	"Смях"
"[english]dota_chatwheel_label_dark_willow_laugh"	"Laugh"
"dota_chatwheel_message_pangolier_laugh"	"Аааах-ха-хахахаха-хахахааа-хуу."
"[english]dota_chatwheel_message_pangolier_laugh"	"Aaaah ha hahahaha hahahaaa huu."
"dota_chatwheel_label_pangolier_laugh"	"Смях"
"[english]dota_chatwheel_label_pangolier_laugh"	"Laugh"
}
