"hero_chat_wheel"
{
"dota_chatwheel_message_antimage_laugh"	"Ha ha ha ha ha ha ha ha ha ha ha ha!"
"[english]dota_chatwheel_message_antimage_laugh"	"Ha ha ha ha ha ha ha ha ha ha ha ha!"
"dota_chatwheel_label_antimage_laugh"	"[Kahkaha]"
"[english]dota_chatwheel_label_antimage_laugh"	"[Laugh]"
"dota_chatwheel_message_antimage_thank"	"Onlara unutamayacakları bir sopa atacağım!"
"[english]dota_chatwheel_message_antimage_thank"	"I'll give them a drubbing they'll not soon forget!"
"dota_chatwheel_label_antimage_thank"	"Onlara unutamayacakları..."
"[english]dota_chatwheel_label_antimage_thank"	"I'll give them a drubbing..."
"dota_chatwheel_message_antimage_deny"	"Çaba gösteriyor musun?"
"[english]dota_chatwheel_message_antimage_deny"	"Are you even trying?"
"dota_chatwheel_label_antimage_deny"	"Çaba gösteriyor musun?"
"[english]dota_chatwheel_label_antimage_deny"	"Are you even trying?"
"dota_chatwheel_message_antimage_1"	"Büyü nefret edilesi bir şeydir."
"[english]dota_chatwheel_message_antimage_1"	"Magic is an abomination."
"dota_chatwheel_label_antimage_1"	"Büyü nefret edilesi bir şeydir."
"[english]dota_chatwheel_label_antimage_1"	"Magic is an abomination."
"dota_chatwheel_message_antimage_2"	"Tam bir hayal kırıklığı."
"[english]dota_chatwheel_message_antimage_2"	"A disappointment."
"dota_chatwheel_message_antimage_3"	"Kendini bir de bundan büyüyle kurtar bakalım."
"[english]dota_chatwheel_message_antimage_3"	"Magic thyself out of that."
"dota_chatwheel_label_antimage_3"	"Kendini bir de bundan büyüyle kurtar bakalım."
"[english]dota_chatwheel_label_antimage_3"	"Magic thyself out of that."
"dota_chatwheel_message_antimage_4"	"Lanetlendin!"
"[english]dota_chatwheel_message_antimage_4"	"Thou art damned!"
"dota_chatwheel_label_antimage_4"	"Lanetlendin."
"[english]dota_chatwheel_label_antimage_4"	"Thou art damned."
"dota_chatwheel_message_antimage_5"	"Ölü Tanrının lejyonlarını gönder, hepsini öldüreyim."
"[english]dota_chatwheel_message_antimage_5"	"Send thy Dead God's legions, I will put them all to death."
"dota_chatwheel_label_antimage_5"	"Ölü Tanrının lejyonlarını gönder..."
"[english]dota_chatwheel_label_antimage_5"	"Send thy Dead God's legions..."
"dota_chatwheel_message_axe_laugh"	"Ha ha ha ha ha ha!"
"[english]dota_chatwheel_message_axe_laugh"	"Ha ha ha ha ha ha!"
"dota_chatwheel_label_axe_laugh"	"[Kahkaha]"
"[english]dota_chatwheel_label_axe_laugh"	"[Laugh]"
"dota_chatwheel_message_axe_thank"	"Axe bunu çok sevdi."
"[english]dota_chatwheel_message_axe_thank"	"Axe likes this very much."
"dota_chatwheel_label_axe_thank"	"Axe bunu çok sevdi."
"[english]dota_chatwheel_label_axe_thank"	"Axe likes this very much."
"dota_chatwheel_message_axe_deny"	"Hiçbir şeyi hak etmiyorsun!"
"[english]dota_chatwheel_message_axe_deny"	"You deserve nothing!"
"dota_chatwheel_label_axe_deny"	"Hiçbir şeyi hak etmiyorsun!"
"[english]dota_chatwheel_label_axe_deny"	"You deserve nothing!"
"dota_chatwheel_message_axe_1"	"Kötü savaştın ve daha da kötü can verdin."
"[english]dota_chatwheel_message_axe_1"	"You fought badly--died worse."
"dota_chatwheel_label_axe_1"	"Kötü savaştın"
"[english]dota_chatwheel_label_axe_1"	"You fought badly"
"dota_chatwheel_message_axe_2"	"Size iyi günler dedim!"
"[english]dota_chatwheel_message_axe_2"	"I said good day, sir!"
"dota_chatwheel_label_axe_2"	"Size iyi günler dedim!"
"[english]dota_chatwheel_label_axe_2"	"I said good day, sir!"
"dota_chatwheel_message_axe_3"	"Axe yanlış mı değerlendirdi?"
"[english]dota_chatwheel_message_axe_3"	"Axe misjudged?"
"dota_chatwheel_message_axe_4"	"Axe'in bu saçmalıklar için vakti yok."
"[english]dota_chatwheel_message_axe_4"	"Axe has no time for all this jibber-jabber."
"dota_chatwheel_label_axe_4"	"Axe'in bu saçmalıklar için vakti yok."
"[english]dota_chatwheel_label_axe_4"	"Axe has no time for all this jibber-jabber."
"dota_chatwheel_message_axe_5"	"Ne mi oldu? Axe oldu!"
"[english]dota_chatwheel_message_axe_5"	"What happened? Axe happened!"
"dota_chatwheel_label_axe_5"	"Ne mi oldu? Axe oldu!"
"[english]dota_chatwheel_label_axe_5"	"What happened? Axe happened!"
"dota_chatwheel_message_bane_laugh"	"Ha ha ha ha ha ha ha ha ha!"
"[english]dota_chatwheel_message_bane_laugh"	"Ha ha ha ha ha ha ha ha ha!"
"dota_chatwheel_label_bane_laugh"	"[Kahkaha]"
"[english]dota_chatwheel_label_bane_laugh"	"[Laugh]"
"dota_chatwheel_message_bane_thank"	"Çok iyisin."
"[english]dota_chatwheel_message_bane_thank"	"You're so nice."
"dota_chatwheel_message_bane_deny"	"Bir dahaki sefere artık."
"[english]dota_chatwheel_message_bane_deny"	"Better luck next time."
"dota_chatwheel_label_bane_deny"	"Bir dahaki sefere artık."
"[english]dota_chatwheel_label_bane_deny"	"Better luck next time."
"dota_chatwheel_message_bane_1"	"Varlığının felaketi."
"[english]dota_chatwheel_message_bane_1"	"Bane of your existence."
"dota_chatwheel_label_bane_1"	"Varlığının felaketi."
"[english]dota_chatwheel_label_bane_1"	"Bane of your existence."
"dota_chatwheel_message_bane_2"	"Bu ânın hayâlini kuruyordum."
"[english]dota_chatwheel_message_bane_2"	"I've been dreaming of this moment."
"dota_chatwheel_label_bane_2"	"Bu ânın hayâlini kuruyordum."
"[english]dota_chatwheel_label_bane_2"	"I've been dreaming of this moment."
"dota_chatwheel_message_bane_3"	"Adil takas."
"[english]dota_chatwheel_message_bane_3"	"Fair exchange."
"dota_chatwheel_label_bane_3"	"Adil takas."
"[english]dota_chatwheel_label_bane_3"	"Fair exchange."
"dota_chatwheel_message_bane_4"	"Artık kâbusların sonsuza kadar sürecek."
"[english]dota_chatwheel_message_bane_4"	"Now your nightmare lasts forever."
"dota_chatwheel_label_bane_4"	"Artık kâbusların sonsuza kadar sürecek."
"[english]dota_chatwheel_label_bane_4"	"Now your nightmare lasts forever."
"dota_chatwheel_message_bane_5"	"Ah ya ya ya ya ya yai eeyas!"
"[english]dota_chatwheel_message_bane_5"	"Ah ya ya ya ya ya yai eeyas!"
"dota_chatwheel_label_bane_5"	"Ah ya ya ya ya ya yai eeyas!"
"[english]dota_chatwheel_label_bane_5"	"Ah ya ya ya ya ya yai eeyas!"
"dota_chatwheel_message_bloodseeker_laugh"	"Hmm-heh-heh-heh-heh-ha!"
"[english]dota_chatwheel_message_bloodseeker_laugh"	"Hmm-heh-heh-heh-heh-ha!"
"dota_chatwheel_label_bloodseeker_laugh"	"[Kahkaha]"
"[english]dota_chatwheel_label_bloodseeker_laugh"	"[Laugh]"
"dota_chatwheel_message_bloodseeker_thank"	"Çok fazla kan."
"[english]dota_chatwheel_message_bloodseeker_thank"	"So much blood."
"dota_chatwheel_label_bloodseeker_thank"	"Çok fazla kan."
"[english]dota_chatwheel_label_bloodseeker_thank"	"So much blood."
"dota_chatwheel_message_bloodseeker_deny"	"Sana kan yok."
"[english]dota_chatwheel_message_bloodseeker_deny"	"No blood for you."
"dota_chatwheel_label_bloodseeker_deny"	"Sana kan yok."
"[english]dota_chatwheel_label_bloodseeker_deny"	"No blood for you."
"dota_chatwheel_message_bloodseeker_1"	"Kızıl görüyorum ve bu harika bir şey!"
"[english]dota_chatwheel_message_bloodseeker_1"	"I'm seeing red...and it's amazing!"
"dota_chatwheel_label_bloodseeker_1"	"Kızıl görüyorum ve bu harika bir şey!"
"[english]dota_chatwheel_label_bloodseeker_1"	"I'm seeing red...and it's amazing!"
"dota_chatwheel_message_bloodseeker_2"	"Negatif olma... pozitif ol."
"[english]dota_chatwheel_message_bloodseeker_2"	"Don't be negative...be positive."
"dota_chatwheel_label_bloodseeker_2"	"Negatif olma..."
"[english]dota_chatwheel_label_bloodseeker_2"	"Don't be negative..."
"dota_chatwheel_message_bloodseeker_3"	"Hadi... koş."
"[english]dota_chatwheel_message_bloodseeker_3"	"Go ahead...run."
"dota_chatwheel_label_bloodseeker_3"	"Hadi... koş."
"[english]dota_chatwheel_label_bloodseeker_3"	"Go ahead...run."
"dota_chatwheel_message_bloodseeker_4"	"Uzan şöyle... bir kurabiye ye."
"[english]dota_chatwheel_message_bloodseeker_4"	"Lie down...have a cookie."
"dota_chatwheel_label_bloodseeker_4"	"Uzan şöyle... bir kurabiye ye."
"[english]dota_chatwheel_label_bloodseeker_4"	"Lie down...have a cookie."
"dota_chatwheel_message_bloodseeker_5"	"Savaş alanında kanın kokusu âdeta bir vaat gibi yükseliyor."
"[english]dota_chatwheel_message_bloodseeker_5"	"Over the field of battle, the smell of blood rises like a promise."
"dota_chatwheel_label_bloodseeker_5"	"Savaş alanında..."
"[english]dota_chatwheel_label_bloodseeker_5"	"Over the field of battle..."
"dota_chatwheel_message_crystal_maiden_laugh"	"Ah ha ha ha ha ha."
"[english]dota_chatwheel_message_crystal_maiden_laugh"	"Ah ha ha ha ha ha."
"dota_chatwheel_label_crystal_maiden_laugh"	"[Kahkaha]"
"[english]dota_chatwheel_label_crystal_maiden_laugh"	"[Laugh]"
"dota_chatwheel_message_crystal_maiden_thank"	"Çok teşekkürler!"
"[english]dota_chatwheel_message_crystal_maiden_thank"	"Very cool of you!"
"dota_chatwheel_label_crystal_maiden_thank"	"Çok teşekkürler!"
"[english]dota_chatwheel_label_crystal_maiden_thank"	"Very cool of you!"
"dota_chatwheel_message_crystal_maiden_deny"	"Şimdi kimse kazanamayacak!"
"[english]dota_chatwheel_message_crystal_maiden_deny"	"Now nobody wins!"
"dota_chatwheel_label_crystal_maiden_deny"	"Şimdi kimse kazanamayacak!"
"[english]dota_chatwheel_label_crystal_maiden_deny"	"Now nobody wins!"
"dota_chatwheel_message_crystal_maiden_1"	"Çok güzel bir kar meleği olacaksın."
"[english]dota_chatwheel_message_crystal_maiden_1"	"You'll make a nice snow angel."
"dota_chatwheel_label_crystal_maiden_1"	"Çok güzel bir kar meleği olacaksın."
"[english]dota_chatwheel_label_crystal_maiden_1"	"You'll make a nice snow angel."
"dota_chatwheel_message_crystal_maiden_2"	"Tüylerim diken diken oldu!"
"[english]dota_chatwheel_message_crystal_maiden_2"	"I've got goosebumps!"
"dota_chatwheel_label_crystal_maiden_2"	"Tüylerim diken diken oldu!"
"[english]dota_chatwheel_label_crystal_maiden_2"	"I've got goosebumps!"
"dota_chatwheel_message_crystal_maiden_3"	"Bunu fark etmedim."
"[english]dota_chatwheel_message_crystal_maiden_3"	"I didn't see that coming."
"dota_chatwheel_label_crystal_maiden_3"	"Bunu fark etmedim."
"[english]dota_chatwheel_label_crystal_maiden_3"	"I didn't see that coming."
"dota_chatwheel_message_crystal_maiden_4"	"Hep daha iyiye gitmeye devam ediyor."
"[english]dota_chatwheel_message_crystal_maiden_4"	"It just keeps getting better."
"dota_chatwheel_label_crystal_maiden_4"	"Hep daha iyiye gitmeye devam ediyor."
"[english]dota_chatwheel_label_crystal_maiden_4"	"It just keeps getting better."
"dota_chatwheel_message_crystal_maiden_5"	"Burası soğudu mu yoksa sadece bana mı öyle geliyor?"
"[english]dota_chatwheel_message_crystal_maiden_5"	"Is it cold in here or is it just me?"
"dota_chatwheel_label_crystal_maiden_5"	"Burası soğudu mu yoksa..."
"[english]dota_chatwheel_label_crystal_maiden_5"	"Is it cold in here or..."
"dota_chatwheel_message_drow_ranger_laugh"	"Ah ha ha ha ha ha ha ha ha ha ha ha ha ha!"
"[english]dota_chatwheel_message_drow_ranger_laugh"	"Ah ha ha ha ha ha ha ha ha ha ha ha ha ha!"
"dota_chatwheel_label_drow_ranger_laugh"	"[Kahkaha]"
"[english]dota_chatwheel_label_drow_ranger_laugh"	"[Laugh]"
"dota_chatwheel_message_drow_ranger_thank"	"Başka bir zafer!"
"[english]dota_chatwheel_message_drow_ranger_thank"	"Another triumph!"
"dota_chatwheel_label_drow_ranger_thank"	"Başka bir zafer!"
"[english]dota_chatwheel_label_drow_ranger_thank"	"Another triumph!"
"dota_chatwheel_message_drow_ranger_deny"	"Bundan daha iyisini yapman gerekecek!"
"[english]dota_chatwheel_message_drow_ranger_deny"	"You'll have to do better than that!"
"dota_chatwheel_label_drow_ranger_deny"	"Bundan daha iyisini yapman gerekecek!"
"[english]dota_chatwheel_label_drow_ranger_deny"	"You'll have to do better than that!"
"dota_chatwheel_message_drow_ranger_1"	"Yaşayamayacak kadar çok gürültü yapıyordun."
"[english]dota_chatwheel_message_drow_ranger_1"	"You were too noisy to live."
"dota_chatwheel_label_drow_ranger_1"	"Yaşayamayacak kadar çok gürültü yapıyordun."
"[english]dota_chatwheel_label_drow_ranger_1"	"You were too noisy to live."
"dota_chatwheel_message_drow_ranger_2"	"Amatör."
"[english]dota_chatwheel_message_drow_ranger_2"	"Amateur."
"dota_chatwheel_label_drow_ranger_2"	"Amatör."
"[english]dota_chatwheel_label_drow_ranger_2"	"Amateur."
"dota_chatwheel_message_drow_ranger_3"	"Yalnız öleceksin."
"[english]dota_chatwheel_message_drow_ranger_3"	"You die alone."
"dota_chatwheel_label_drow_ranger_3"	"Yalnız öleceksin."
"[english]dota_chatwheel_label_drow_ranger_3"	"You die alone."
"dota_chatwheel_message_drow_ranger_4"	"Bu başka bir şekilde sona eremezdi."
"[english]dota_chatwheel_message_drow_ranger_4"	"This couldn't have ended any other way."
"dota_chatwheel_label_drow_ranger_4"	"Bu başka bir şekilde..."
"[english]dota_chatwheel_label_drow_ranger_4"	"This couldn't have ended..."
"dota_chatwheel_message_drow_ranger_5"	"Artık öldüğüne göre sana saygı duymak daha kolay."
"[english]dota_chatwheel_message_drow_ranger_5"	"Now that you're dead, I find it easy to respect you."
"dota_chatwheel_label_drow_ranger_5"	"Artık öldüğüne göre..."
"[english]dota_chatwheel_label_drow_ranger_5"	"Now that you're dead..."
"dota_chatwheel_message_earthshaker_laugh"	"Ha ha ha ha ha ha ha ha ha."
"[english]dota_chatwheel_message_earthshaker_laugh"	"Ha ha ha ha ha ha ha ha ha."
"dota_chatwheel_label_earthshaker_laugh"	"[Kahkaha]"
"[english]dota_chatwheel_label_earthshaker_laugh"	"[Laugh]"
"dota_chatwheel_message_earthshaker_thank"	"Biraz ortalığı çalkalayalım!"
"[english]dota_chatwheel_message_earthshaker_thank"	"Let's shake things up!"
"dota_chatwheel_label_earthshaker_thank"	"Biraz ortalığı çalkalayalım!"
"[english]dota_chatwheel_label_earthshaker_thank"	"Let's shake things up!"
"dota_chatwheel_message_earthshaker_1"	"Bu senin kendi hatandı."
"[english]dota_chatwheel_message_earthshaker_1"	"It was your own damn fault."
"dota_chatwheel_label_earthshaker_1"	"Bu senin kendi hatandı."
"[english]dota_chatwheel_label_earthshaker_1"	"It was your own damn fault."
"dota_chatwheel_message_earthshaker_2"	"Vay be... Artçı şoklar..."
"[english]dota_chatwheel_message_earthshaker_2"	"Whoa... Aftershocks..."
"dota_chatwheel_label_earthshaker_2"	"Vay be... Artçı şoklar..."
"[english]dota_chatwheel_label_earthshaker_2"	"Whoa... Aftershocks..."
"dota_chatwheel_message_earthshaker_3"	"Çarpışıyorsun...?"
"[english]dota_chatwheel_message_earthshaker_3"	"Slammin'...?"
"dota_chatwheel_label_earthshaker_3"	"Çarpışıyorsun...?"
"[english]dota_chatwheel_label_earthshaker_3"	"Slammin'...?"
"dota_chatwheel_message_earthshaker_4"	"Ortalık çok kalabalıklaşmıştı."
"[english]dota_chatwheel_message_earthshaker_4"	"It was getting far too crowded."
"dota_chatwheel_label_earthshaker_4"	"Ortalık çok kalabalıklaşmıştı."
"[english]dota_chatwheel_label_earthshaker_4"	"It was getting far too crowded."
"dota_chatwheel_message_earthshaker_5"	"Birçok dünya olabilir ancak Earthshaker'dan sadece bir tane var."
"[english]dota_chatwheel_message_earthshaker_5"	"There may be many earths, but there's only one Earthshaker."
"dota_chatwheel_label_earthshaker_5"	"Birçok dünya olabilir..."
"[english]dota_chatwheel_label_earthshaker_5"	"There may be many earths..."
"dota_chatwheel_message_juggernaut_laugh"	"Ha ha ha ha ha!"
"[english]dota_chatwheel_message_juggernaut_laugh"	"Ha ha ha ha ha!"
"dota_chatwheel_label_juggernaut_laugh"	"[Kahkaha]"
"[english]dota_chatwheel_label_juggernaut_laugh"	"[Laugh]"
"dota_chatwheel_message_juggernaut_thank"	"Oh bu iyiydi."
"[english]dota_chatwheel_message_juggernaut_thank"	"Oh that's nice."
"dota_chatwheel_label_juggernaut_thank"	"Oh bu iyiydi."
"[english]dota_chatwheel_label_juggernaut_thank"	"Oh that's nice."
"dota_chatwheel_message_juggernaut_deny"	"Hm, iyi görünüyor."
"[english]dota_chatwheel_message_juggernaut_deny"	"Hm, looking good."
"dota_chatwheel_label_juggernaut_deny"	"Hm, iyi görünüyor."
"[english]dota_chatwheel_label_juggernaut_deny"	"Hm, looking good."
"dota_chatwheel_message_juggernaut_1"	"Sonsuza dek yalnız olacaksın."
"[english]dota_chatwheel_message_juggernaut_1"	"You will be forever alone."
"dota_chatwheel_label_juggernaut_1"	"Sonsuza dek yalnız olacaksın."
"[english]dota_chatwheel_label_juggernaut_1"	"You will be forever alone."
"dota_chatwheel_message_juggernaut_2"	"Her şey yerine oturuyor."
"[english]dota_chatwheel_message_juggernaut_2"	"It's all falling into place."
"dota_chatwheel_label_juggernaut_2"	"Her şey yerine oturuyor."
"[english]dota_chatwheel_label_juggernaut_2"	"It's all falling into place."
"dota_chatwheel_message_juggernaut_3"	"Bunu bitirmek için döneceğim."
"[english]dota_chatwheel_message_juggernaut_3"	"I'll be back to finish this later."
"dota_chatwheel_label_juggernaut_3"	"Bunu bitirmek için döneceğim."
"[english]dota_chatwheel_label_juggernaut_3"	"I'll be back to finish this later."
"dota_chatwheel_message_juggernaut_4"	"Cesaret ve aptallık arasında oldukça ince bir çizgi vardır."
"[english]dota_chatwheel_message_juggernaut_4"	"There's a fine line between bravery and stupidity."
"dota_chatwheel_label_juggernaut_4"	"Cesaret ve aptallık..."
"[english]dota_chatwheel_label_juggernaut_4"	"There's a fine line..."
"dota_chatwheel_message_juggernaut_5"	"Mm, havalı."
"[english]dota_chatwheel_message_juggernaut_5"	"Mm, snazzy."
"dota_chatwheel_label_juggernaut_5"	"Mm, havalı."
"[english]dota_chatwheel_label_juggernaut_5"	"Mm, snazzy."
"dota_chatwheel_message_mirana_laugh"	"Ha ha ha ha ha ha!"
"[english]dota_chatwheel_message_mirana_laugh"	"Ha ha ha ha ha ha!"
"dota_chatwheel_label_mirana_laugh"	"[Kahkaha]"
"[english]dota_chatwheel_label_mirana_laugh"	"[Laugh]"
"dota_chatwheel_message_mirana_thank"	"Geceden bir hediye!"
"[english]dota_chatwheel_message_mirana_thank"	"A gift from the night!"
"dota_chatwheel_label_mirana_thank"	"Geceden bir hediye!"
"[english]dota_chatwheel_label_mirana_thank"	"A gift from the night!"
"dota_chatwheel_message_mirana_deny"	"Yakala yakalayabilirsen!"
"[english]dota_chatwheel_message_mirana_deny"	"Catch us if you can!"
"dota_chatwheel_label_mirana_deny"	"Yakala yakalayabilirsen!"
"[english]dota_chatwheel_label_mirana_deny"	"Catch us if you can!"
"dota_chatwheel_message_mirana_1"	"Hiçbir şey öğrenmemişsin."
"[english]dota_chatwheel_message_mirana_1"	"You have learned nothing."
"dota_chatwheel_label_mirana_1"	"Hiçbir şey öğrenmemişsin."
"[english]dota_chatwheel_label_mirana_1"	"You have learned nothing."
"dota_chatwheel_message_mirana_2"	"İyi iş!"
"[english]dota_chatwheel_message_mirana_2"	"Nicely done!"
"dota_chatwheel_label_mirana_2"	"İyi iş!"
"[english]dota_chatwheel_label_mirana_2"	"Nicely done!"
"dota_chatwheel_message_mirana_3"	"Köpekler gibi kaçın!"
"[english]dota_chatwheel_message_mirana_3"	"Run like the dogs you are!"
"dota_chatwheel_label_mirana_3"	"Köpekler gibi kaçın!"
"[english]dota_chatwheel_label_mirana_3"	"Run like the dogs you are!"
"dota_chatwheel_message_mirana_4"	"Gel pisi pisi pisi..."
"[english]dota_chatwheel_message_mirana_4"	"Here, kitty-kitty-kitty...."
"dota_chatwheel_label_mirana_4"	"Gel pisi pisi pisi..."
"[english]dota_chatwheel_label_mirana_4"	"Here, kitty-kitty-kitty...."
"dota_chatwheel_message_mirana_5"	"Şans değil yetenekti!"
"[english]dota_chatwheel_message_mirana_5"	"It was not luck but skill!"
"dota_chatwheel_label_mirana_5"	"Şans değil yetenekti!"
"[english]dota_chatwheel_label_mirana_5"	"It was not luck but skill!"
"dota_chatwheel_message_morphling_laugh"	"Ha ha ha ha ha ha ha ha ha ha!"
"[english]dota_chatwheel_message_morphling_laugh"	"Ha ha ha ha ha ha ha ha ha ha!"
"dota_chatwheel_label_morphling_laugh"	"[Kahkaha]"
"[english]dota_chatwheel_label_morphling_laugh"	"[Laugh]"
"dota_chatwheel_message_morphling_deny"	"Boyundan büyük işlere kalkıştın."
"[english]dota_chatwheel_message_morphling_deny"	"You're in over your head."
"dota_chatwheel_label_morphling_deny"	"Boyundan büyük işlere kalkıştın."
"[english]dota_chatwheel_label_morphling_deny"	"You're in over your head."
"dota_chatwheel_message_morphling_1"	"Kaynayan öfke!"
"[english]dota_chatwheel_message_morphling_1"	"Boiling rage!"
"dota_chatwheel_label_morphling_1"	"Kaynayan öfke!"
"[english]dota_chatwheel_label_morphling_1"	"Boiling rage!"
"dota_chatwheel_message_morphling_2"	"Her zaman canlandırıcı."
"[english]dota_chatwheel_message_morphling_2"	"Always refreshing."
"dota_chatwheel_message_morphling_3"	"Artık durum değişti!"
"[english]dota_chatwheel_message_morphling_3"	"The tide has turned!"
"dota_chatwheel_label_morphling_3"	"Artık durum değişti!"
"[english]dota_chatwheel_label_morphling_3"	"The tide has turned!"
"dota_chatwheel_message_nevermore_1"	"Koleksiyonum için güzel bir ruh."
"[english]dota_chatwheel_message_nevermore_1"	"A beautiful soul for my collection."
"dota_chatwheel_label_nevermore_1"	"Koleksiyonum için güzel bir ruh."
"[english]dota_chatwheel_label_nevermore_1"	"A beautiful soul for my collection."
"dota_chatwheel_message_nevermore_4"	"Asla saklanamazsın!"
"[english]dota_chatwheel_message_nevermore_4"	"You can never hide!"
"dota_chatwheel_label_nevermore_4"	"Asla saklanamazsın!"
"[english]dota_chatwheel_label_nevermore_4"	"You can never hide!"
"dota_chatwheel_message_nevermore_5"	"Ozh icha gluth izh sol."
"[english]dota_chatwheel_message_nevermore_5"	"Ozh icha gluth izh sol."
"dota_chatwheel_label_nevermore_5"	"Ozh icha gluth izh sol."
"[english]dota_chatwheel_label_nevermore_5"	"Ozh icha gluth izh sol."
"dota_chatwheel_message_phantom_lancer_laugh"	"Ha ha ha ha ha ha ha ha ha ha ha ha ha!"
"[english]dota_chatwheel_message_phantom_lancer_laugh"	"Ha ha ha ha ha ha ha ha ha ha ha ha ha!"
"dota_chatwheel_message_phantom_lancer_2"	"Şimdi bu sadece aptalca."
"[english]dota_chatwheel_message_phantom_lancer_2"	"Now this is just silly."
"dota_chatwheel_label_phantom_lancer_2"	"Şimdi bu sadece aptalca."
"[english]dota_chatwheel_label_phantom_lancer_2"	"Now this is just silly."
"dota_chatwheel_message_phantom_lancer_3"	"Geldiğimiz yerde daha çok var."
"[english]dota_chatwheel_message_phantom_lancer_3"	"We have more where that came from."
"dota_chatwheel_label_phantom_lancer_3"	"Geldiğimiz yerde daha çok var."
"[english]dota_chatwheel_label_phantom_lancer_3"	"We have more where that came from."
"dota_chatwheel_message_phantom_lancer_4"	"Sayılar, tek başına stratejinin başaramadığını başardı."
"[english]dota_chatwheel_message_phantom_lancer_4"	"Numbers have accomplished what strategy alone could not."
"dota_chatwheel_label_phantom_lancer_4"	"Sayılar tek başına..."
"[english]dota_chatwheel_label_phantom_lancer_4"	"Numbers have accomplished..."
"dota_chatwheel_message_phantom_lancer_5"	"Senden sayıca üstünüz. Herkesten sayıca üstünüz!"
"[english]dota_chatwheel_message_phantom_lancer_5"	"We outnumbered you. We outnumber them all!"
"dota_chatwheel_label_phantom_lancer_5"	"Senden sayıca üstünüz..."
"[english]dota_chatwheel_label_phantom_lancer_5"	"We outnumbered you..."
"dota_chatwheel_message_puck_deny"	"Son hamleni geri almak isteyebilirsin."
"[english]dota_chatwheel_message_puck_deny"	"You might wish to retract your last move."
"dota_chatwheel_label_puck_deny"	"Son hamleni geri almak..."
"[english]dota_chatwheel_label_puck_deny"	"You might wish to retract..."
"dota_chatwheel_message_puck_2"	"Bu ne, bir tür oyun mu?"
"[english]dota_chatwheel_message_puck_2"	"What is this, a game of some sort?"
"dota_chatwheel_label_puck_2"	"Bu ne, bir tür oyun mu?"
"[english]dota_chatwheel_label_puck_2"	"What is this, a game of some sort?"
"dota_chatwheel_message_puck_3"	"Ebediyetimizin en büyük trajedisi."
"[english]dota_chatwheel_message_puck_3"	"The greatest tragedy of our eon."
"dota_chatwheel_label_puck_3"	"Ebediyetimizin en büyük trajedisi."
"[english]dota_chatwheel_label_puck_3"	"The greatest tragedy of our eon."
"dota_chatwheel_message_puck_5"	"Bu hisse alışık değilim. Bu haz mı?"
"[english]dota_chatwheel_message_puck_5"	"I am unfamiliar with this feeling. Is it joy?"
"dota_chatwheel_label_puck_5"	"Bu hisse alışık değilim..."
"[english]dota_chatwheel_label_puck_5"	"I am unfamiliar with this feeling..."
"dota_chatwheel_message_pudge_laugh"	"Hm hm hm hm ha ha ha."
"[english]dota_chatwheel_message_pudge_laugh"	"Hm hm hm hm ha ha ha."
"dota_chatwheel_message_pudge_thank"	"Bu harika bir şey."
"[english]dota_chatwheel_message_pudge_thank"	"That's a bit of all right."
"dota_chatwheel_label_pudge_thank"	"Bu harika bir şey."
"[english]dota_chatwheel_label_pudge_thank"	"That's a bit of all right."
"dota_chatwheel_message_pudge_deny"	"Oops. Ben miydim?"
"[english]dota_chatwheel_message_pudge_deny"	"Oops. Was that me?"
"dota_chatwheel_label_pudge_deny"	"Oops. Ben miydim?"
"[english]dota_chatwheel_label_pudge_deny"	"Oops. Was that me?"
"dota_chatwheel_message_pudge_1"	"Biraz kasaplık zamanı!"
"[english]dota_chatwheel_message_pudge_1"	"Time for a little butchery!"
"dota_chatwheel_label_pudge_1"	"Biraz kasaplık zamanı!"
"[english]dota_chatwheel_label_pudge_1"	"Time for a little butchery!"
"dota_chatwheel_message_pudge_2"	"Güzel, taze bir karaciğerden daha iyi bir şey yoktur."
"[english]dota_chatwheel_message_pudge_2"	"Nothing better than a nice raw liver."
"dota_chatwheel_label_pudge_2"	"Güzel, taze bir karaciğerden daha iyi bir şey yoktur."
"[english]dota_chatwheel_label_pudge_2"	"Nothing better than a nice raw liver."
"dota_chatwheel_message_pudge_3"	"Her neyse."
"[english]dota_chatwheel_message_pudge_3"	"Whateva."
"dota_chatwheel_label_pudge_3"	"Her neyse."
"[english]dota_chatwheel_label_pudge_3"	"Whateva."
"dota_chatwheel_message_pudge_4"	"Lezzetli..."
"[english]dota_chatwheel_message_pudge_4"	"Delicious..."
"dota_chatwheel_label_pudge_4"	"Lezzetli..."
"[english]dota_chatwheel_label_pudge_4"	"Delicious..."
"dota_chatwheel_message_pudge_5"	"Ağzında bir elmayla iyi görüneceksin!"
"[english]dota_chatwheel_message_pudge_5"	"You'll look good with an apple in yer mouth!"
"dota_chatwheel_label_pudge_5"	"Ağzında bir elmayla..."
"[english]dota_chatwheel_label_pudge_5"	"You'll look good with..."
"dota_chatwheel_message_razor_laugh"	"Ah ha ha ha ha ha ha ha ha."
"[english]dota_chatwheel_message_razor_laugh"	"Ah ha ha ha ha ha ha ha ha."
"dota_chatwheel_label_razor_laugh"	"[Kahkaha]"
"[english]dota_chatwheel_label_razor_laugh"	"[Laugh]"
"dota_chatwheel_message_razor_thank"	"Aramızda bir bağ hissediyorum!"
"[english]dota_chatwheel_message_razor_thank"	"I sense a connection between us!"
"dota_chatwheel_label_razor_thank"	"Aramızda bir bağ hissediyorum!"
"[english]dota_chatwheel_label_razor_thank"	"I sense a connection between us!"
"dota_chatwheel_message_razor_deny"	"Koşabilirsin. Koşmalısın."
"[english]dota_chatwheel_message_razor_deny"	"You can run. You should run."
"dota_chatwheel_label_razor_deny"	"Koşabilirsin. Koşmalısın."
"[english]dota_chatwheel_label_razor_deny"	"You can run. You should run."
"dota_chatwheel_message_razor_1"	"Sen öldün. Öldün."
"[english]dota_chatwheel_message_razor_1"	"You are dead. Dead."
"dota_chatwheel_label_razor_1"	"Sen öldün. Öldün."
"[english]dota_chatwheel_label_razor_1"	"You are dead. Dead."
"dota_chatwheel_message_razor_2"	"Küllerin bir yağmur gibi yağacak."
"[english]dota_chatwheel_message_razor_2"	"Your ashes will fall like rain."
"dota_chatwheel_label_razor_2"	"Küllerin bir yağmur gibi yağacak."
"[english]dota_chatwheel_label_razor_2"	"Your ashes will fall like rain."
"dota_chatwheel_message_razor_4"	"Bu sadece sonsuza dek acıtacak."
"[english]dota_chatwheel_message_razor_4"	"This will only hurt forever."
"dota_chatwheel_label_razor_4"	"Bu sadece sonsuza dek acıtacak."
"[english]dota_chatwheel_label_razor_4"	"This will only hurt forever."
"dota_chatwheel_message_razor_5"	"Kıçını şokladım!"
"[english]dota_chatwheel_message_razor_5"	"Zapped your ass!"
"dota_chatwheel_label_razor_5"	"Kıçını şokladım!"
"[english]dota_chatwheel_label_razor_5"	"Zapped your ass!"
"dota_chatwheel_message_sand_king_laugh"	"Ha ha ha ha ha ha ha!"
"[english]dota_chatwheel_message_sand_king_laugh"	"Ha ha ha ha ha ha ha!"
"dota_chatwheel_label_sand_king_laugh"	"[Kahkaha]"
"[english]dota_chatwheel_label_sand_king_laugh"	"[Laugh]"
"dota_chatwheel_message_sand_king_thank"	"Harika biz hizmette bulundun."
"[english]dota_chatwheel_message_sand_king_thank"	"You have done a great service."
"dota_chatwheel_label_sand_king_thank"	"Harika biz hizmette bulundun."
"[english]dota_chatwheel_label_sand_king_thank"	"You have done a great service."
"dota_chatwheel_message_sand_king_deny"	"Acıtıyor değil mi?"
"[english]dota_chatwheel_message_sand_king_deny"	"Stings, don't it?"
"dota_chatwheel_label_sand_king_deny"	"Acıtıyor değil mi?"
"[english]dota_chatwheel_label_sand_king_deny"	"Stings, don't it?"
"dota_chatwheel_message_sand_king_1"	"Efendinin karşısında diz çök."
"[english]dota_chatwheel_message_sand_king_1"	"Bow to your liege."
"dota_chatwheel_label_sand_king_1"	"Efendinin karşısında..."
"[english]dota_chatwheel_label_sand_king_1"	"Bow to your liege."
"dota_chatwheel_message_sand_king_2"	"Bir kumdan z-z-zafer!"
"[english]dota_chatwheel_message_sand_king_2"	"A Sandy V-V-Victory!"
"dota_chatwheel_label_sand_king_2"	"Bir kumdan z-z-zafer!"
"[english]dota_chatwheel_label_sand_king_2"	"A Sandy V-V-Victory!"
"dota_chatwheel_message_sand_king_3"	"Nereye gittiğini düşünüyorsun?"
"[english]dota_chatwheel_message_sand_king_3"	"Where do you think you're going?"
"dota_chatwheel_label_sand_king_3"	"Nereye gittiğini düşünüyorsun?"
"[english]dota_chatwheel_label_sand_king_3"	"Where do you think you're going?"
"dota_chatwheel_message_sand_king_4"	"Ne bekliyordun...Kumdan Kale mi?"
"[english]dota_chatwheel_message_sand_king_4"	"You were expecting...Sandy Claws?"
"dota_chatwheel_label_sand_king_4"	"Ne bekliyordun..."
"[english]dota_chatwheel_label_sand_king_4"	"You were expecting Sandy Claws?"
"dota_chatwheel_label_sand_king_5"	"Kral olmak güzel"
"[english]dota_chatwheel_label_sand_king_5"	"It's good to be King"
"dota_chatwheel_message_storm_spirit_laugh"	"Hm hm hm hm hee hee hee ha ha."
"[english]dota_chatwheel_message_storm_spirit_laugh"	"Hm hm hm hm hee hee hee ha ha."
"dota_chatwheel_label_storm_spirit_laugh"	"[Kahkaha]"
"[english]dota_chatwheel_label_storm_spirit_laugh"	"[Laugh]"
"dota_chatwheel_message_storm_spirit_deny"	"İçine ettin!"
"[english]dota_chatwheel_message_storm_spirit_deny"	"You blew it!"
"dota_chatwheel_label_storm_spirit_deny"	"İçine ettin!"
"[english]dota_chatwheel_label_storm_spirit_deny"	"You blew it!"
"dota_chatwheel_message_storm_spirit_1"	"Bu kısmı seviyorum!"
"[english]dota_chatwheel_message_storm_spirit_1"	"I love this part!"
"dota_chatwheel_label_storm_spirit_1"	"Bu kısmı seviyorum!"
"[english]dota_chatwheel_label_storm_spirit_1"	"I love this part!"
"dota_chatwheel_message_storm_spirit_2"	"Beni mi aradın?"
"[english]dota_chatwheel_message_storm_spirit_2"	"Lookin for me?"
"dota_chatwheel_label_storm_spirit_2"	"Beni mi aradın?"
"[english]dota_chatwheel_label_storm_spirit_2"	"Lookin for me?"
"dota_chatwheel_message_storm_spirit_3"	"Bir fırtınanın yaklaştığını söylemiştim!"
"[english]dota_chatwheel_message_storm_spirit_3"	"Told you a storm was coming!"
"dota_chatwheel_label_storm_spirit_3"	"Bir fırtınanın yaklaştığını söylemiştim!"
"[english]dota_chatwheel_label_storm_spirit_3"	"Told you a storm was coming!"
"dota_chatwheel_message_storm_spirit_4"	"İyi görünüyorsun!"
"[english]dota_chatwheel_message_storm_spirit_4"	"Looking good!"
"dota_chatwheel_label_storm_spirit_4"	"İyi görünüyorsun!"
"[english]dota_chatwheel_label_storm_spirit_4"	"Looking good!"
"dota_chatwheel_message_storm_spirit_5"	"Muhteşem!"
"[english]dota_chatwheel_message_storm_spirit_5"	"Glorious!"
"dota_chatwheel_label_storm_spirit_5"	"Muhteşem!"
"[english]dota_chatwheel_label_storm_spirit_5"	"Glorious!"
"dota_chatwheel_message_sven_laugh"	"Ahh ha ha ha! Ha ha ha ha!"
"[english]dota_chatwheel_message_sven_laugh"	"Ahh ha ha ha! Ha ha ha ha!"
"dota_chatwheel_label_sven_laugh"	"[Kahkaha]"
"[english]dota_chatwheel_label_sven_laugh"	"[Laugh]"
"dota_chatwheel_message_sven_thank"	"Sen gerçek bir dostsun."
"[english]dota_chatwheel_message_sven_thank"	"You are a true friend."
"dota_chatwheel_label_sven_thank"	"Sen gerçek bir dostsun."
"[english]dota_chatwheel_label_sven_thank"	"You are a true friend."
"dota_chatwheel_message_sven_deny"	"Sersem görünüyorsun."
"[english]dota_chatwheel_message_sven_deny"	"You look stunned."
"dota_chatwheel_label_sven_deny"	"Sersem görünüyorsun."
"[english]dota_chatwheel_label_sven_deny"	"You look stunned."
"dota_chatwheel_message_sven_1"	"Rogue Knight bir can daha aldı."
"[english]dota_chatwheel_message_sven_1"	"Rogue Knight claims another."
"dota_chatwheel_label_sven_1"	"Rogue Knight bir can daha aldı."
"[english]dota_chatwheel_label_sven_1"	"Rogue Knight claims another."
"dota_chatwheel_message_sven_2"	"Hak ettin."
"[english]dota_chatwheel_message_sven_2"	"You deserved it."
"dota_chatwheel_label_sven_2"	"Hak ettin."
"[english]dota_chatwheel_label_sven_2"	"You deserved it."
"dota_chatwheel_message_sven_3"	"Onurum benim... böbürlenmeme neden oluyor."
"[english]dota_chatwheel_message_sven_3"	"My honor compels me...to gloat."
"dota_chatwheel_label_sven_3"	"Onurum benim..."
"[english]dota_chatwheel_label_sven_3"	"My honor compels me...to gloat."
"dota_chatwheel_message_sven_5"	"Hm... şimdi bundan ne öğrendik."
"[english]dota_chatwheel_message_sven_5"	"Hm...now what do we learn from this."
"dota_chatwheel_label_sven_5"	"Hm... şimdi bundan ne öğrendik."
"[english]dota_chatwheel_label_sven_5"	"Hm...now what do we learn from this."
"dota_chatwheel_label_tiny_laugh"	"Kahkaha"
"[english]dota_chatwheel_label_tiny_laugh"	"Laugh"
"dota_chatwheel_message_tiny_thank"	"Ortalığı yıkmaya hazır mısınız?"
"[english]dota_chatwheel_message_tiny_thank"	"Are you ready to rubble?"
"dota_chatwheel_message_tiny_1"	"Vur, kır, parçala!"
"[english]dota_chatwheel_message_tiny_1"	"Rock em, sock em!"
"dota_chatwheel_label_tiny_1"	"Vur, kır, parçala!"
"[english]dota_chatwheel_label_tiny_1"	"Rock em, sock em!"
"dota_chatwheel_message_tiny_2"	"Taş kafalı."
"[english]dota_chatwheel_message_tiny_2"	"You got rocks in your head."
"dota_chatwheel_label_tiny_2"	"Taş kafalı."
"[english]dota_chatwheel_label_tiny_2"	"You got rocks in your head."
"dota_chatwheel_message_tiny_3"	"Özür dilerim."
"[english]dota_chatwheel_message_tiny_3"	"My apologies."
"dota_chatwheel_label_tiny_3"	"Özür dilerim."
"[english]dota_chatwheel_label_tiny_3"	"My apologies."
"dota_chatwheel_message_tiny_4"	"Sende o cesaret yok."
"[english]dota_chatwheel_message_tiny_4"	"You haven't got the stones."
"dota_chatwheel_label_tiny_4"	"Sende o cesaret yok."
"[english]dota_chatwheel_label_tiny_4"	"You haven't got the stones."
"dota_chatwheel_label_vengefulspirit_laugh"	"[Kahkaha]"
"[english]dota_chatwheel_label_vengefulspirit_laugh"	"[Laugh]"
"dota_chatwheel_message_vengefulspirit_thank"	"Çok tatlı..."
"[english]dota_chatwheel_message_vengefulspirit_thank"	"So sweet..."
"dota_chatwheel_label_vengefulspirit_thank"	"Çok tatlı..."
"[english]dota_chatwheel_label_vengefulspirit_thank"	"So sweet..."
"dota_chatwheel_message_vengefulspirit_deny"	"Ne...?"
"[english]dota_chatwheel_message_vengefulspirit_deny"	"What...?"
"dota_chatwheel_label_vengefulspirit_deny"	"Ne...?"
"[english]dota_chatwheel_label_vengefulspirit_deny"	"What...?"
"dota_chatwheel_message_vengefulspirit_1"	"Şimdiden daha iyi hissediyorum."
"[english]dota_chatwheel_message_vengefulspirit_1"	"I feel better already."
"dota_chatwheel_label_vengefulspirit_1"	"Şimdiden daha iyi hissediyorum."
"[english]dota_chatwheel_label_vengefulspirit_1"	"I feel better already."
"dota_chatwheel_message_vengefulspirit_2"	"Değiş tokuş!"
"[english]dota_chatwheel_message_vengefulspirit_2"	"Swapsies!"
"dota_chatwheel_label_vengefulspirit_2"	"Değiş tokuş!"
"[english]dota_chatwheel_label_vengefulspirit_2"	"Swapsies!"
"dota_chatwheel_message_vengefulspirit_4"	"Dehşet dalgasına hazırlanın: böö!"
"[english]dota_chatwheel_message_vengefulspirit_4"	"Prepare for the wave of terror: boo!"
"dota_chatwheel_label_vengefulspirit_4"	"Dehşet dalgasına hazırlanın: böö!"
"[english]dota_chatwheel_label_vengefulspirit_4"	"Prepare for the wave of terror: boo!"
"dota_chatwheel_message_windrunner_laugh"	"Hah-ha-ha-ha-ha!"
"[english]dota_chatwheel_message_windrunner_laugh"	"Hah-ha-ha-ha-ha!"
"dota_chatwheel_label_windrunner_laugh"	"[Kahkaha]"
"[english]dota_chatwheel_label_windrunner_laugh"	"[Laugh]"
"dota_chatwheel_message_windrunner_thank"	"Çocuk oyuncağı"
"[english]dota_chatwheel_message_windrunner_thank"	"Easy breezy"
"dota_chatwheel_label_windrunner_thank"	"Çocuk oyuncağı"
"[english]dota_chatwheel_label_windrunner_thank"	"Easy breezy"
"dota_chatwheel_message_windrunner_deny"	"Ben öyle düşünmüyorum."
"[english]dota_chatwheel_message_windrunner_deny"	"I don't think so."
"dota_chatwheel_label_windrunner_deny"	"Ben öyle düşünmüyorum."
"[english]dota_chatwheel_label_windrunner_deny"	"I don't think so."
"dota_chatwheel_message_windrunner_1"	"Daha kötüsü de olabilirdi. Aslına bakarsan, yok, olamazdı."
"[english]dota_chatwheel_message_windrunner_1"	"Could be worse. Oh, wait, no it couldn't."
"dota_chatwheel_label_windrunner_1"	"Daha kötü olabilirdi..."
"[english]dota_chatwheel_label_windrunner_1"	"Could be worse..."
"dota_chatwheel_message_windrunner_2"	"Hiçbir yere gitmiyorsun."
"[english]dota_chatwheel_message_windrunner_2"	"You're not going anywhere."
"dota_chatwheel_label_windrunner_2"	"Hiçbir yere gitmiyorsun."
"[english]dota_chatwheel_label_windrunner_2"	"You're not going anywhere."
"dota_chatwheel_message_windrunner_4"	"Yok artık, bana bunun olmadığını söyle."
"[english]dota_chatwheel_message_windrunner_4"	"Tell me this did not just happen."
"dota_chatwheel_label_windrunner_4"	"Yok artık, bana bunun olmadığını söyle."
"[english]dota_chatwheel_label_windrunner_4"	"Tell me this did not just happen."
"dota_chatwheel_message_zuus_laugh"	"Ha ha ha ha ha ha ha ha ha!"
"[english]dota_chatwheel_message_zuus_laugh"	"Ha ha ha ha ha ha ha ha ha!"
"dota_chatwheel_label_zuus_laugh"	"[Kahkaha]"
"[english]dota_chatwheel_label_zuus_laugh"	"[Laugh]"
"dota_chatwheel_message_zuus_thank"	"Bıyıklarımın aşkına, çok iyiymiş bu!"
"[english]dota_chatwheel_message_zuus_thank"	"By my whiskers, that's good stuff!"
"dota_chatwheel_message_zuus_deny"	"Ha ha ha ha ha. Ne bekliyordun ki?"
"[english]dota_chatwheel_message_zuus_deny"	"Ha ha ha ha ha. Well what did you expect?"
"dota_chatwheel_message_zuus_1"	"Bekle!"
"[english]dota_chatwheel_message_zuus_1"	"Wait for it!"
"dota_chatwheel_label_zuus_1"	"Bekle!"
"[english]dota_chatwheel_label_zuus_1"	"Wait for it!"
"dota_chatwheel_message_zuus_2"	"Seni öldürmek için gerekli olan şey bu kadar mı?"
"[english]dota_chatwheel_message_zuus_2"	"That's all it takes to kill you?"
"dota_chatwheel_label_zuus_2"	"Seni öldürmek için...?"
"[english]dota_chatwheel_label_zuus_2"	"That's all it takes..?"
"dota_chatwheel_message_zuus_3"	"Oh...bu iyi olamaz."
"[english]dota_chatwheel_message_zuus_3"	"Oh...this can't be good."
"dota_chatwheel_label_zuus_3"	"Bu iyi olamaz."
"[english]dota_chatwheel_label_zuus_3"	"This can't be good"
"dota_chatwheel_message_zuus_4"	"Şiddetli alkış!"
"[english]dota_chatwheel_message_zuus_4"	"Thund'rous applause!"
"dota_chatwheel_label_zuus_4"	"Şiddetli alkış!"
"[english]dota_chatwheel_label_zuus_4"	"Thund'rous applause!"
"dota_chatwheel_message_zuus_5"	"Bir tanrıdan saklanabileceğini mi düşünüyorsun?"
"[english]dota_chatwheel_message_zuus_5"	"Did you think you could hide from a god?"
"dota_chatwheel_label_zuus_5"	"Saklanabileceğini mi düşünüyorsun?"
"[english]dota_chatwheel_label_zuus_5"	"Did you think you could hide?"
"dota_chatwheel_message_kunkka_laugh"	"He-hu-hu-hu-hu-huhhuha!"
"[english]dota_chatwheel_message_kunkka_laugh"	"He-hu-hu-hu-hu-huhhuha!"
"dota_chatwheel_label_kunkka_laugh"	"[Kahkaha]"
"[english]dota_chatwheel_label_kunkka_laugh"	"[Laugh]"
"dota_chatwheel_message_kunkka_thank"	"Sen güvenilir bir dostsun!"
"[english]dota_chatwheel_message_kunkka_thank"	"You're a trusty mate!"
"dota_chatwheel_label_kunkka_thank"	"Sen güvenilir bir dostsun!"
"[english]dota_chatwheel_label_kunkka_thank"	"You're a trusty mate!"
"dota_chatwheel_message_kunkka_deny"	"Denizin dibine kadar yolun var!"
"[english]dota_chatwheel_message_kunkka_deny"	"Straight to the bottom with ya!"
"dota_chatwheel_label_kunkka_deny"	"Denizin dibine kadar yolun var!"
"[english]dota_chatwheel_label_kunkka_deny"	"Straight to the bottom with ya!"
"dota_chatwheel_message_kunkka_1"	"Sende o yürek yok."
"[english]dota_chatwheel_message_kunkka_1"	"You don't have the sand."
"dota_chatwheel_label_kunkka_1"	"Sende o yürek yok."
"[english]dota_chatwheel_label_kunkka_1"	"You don't have the sand."
"dota_chatwheel_message_kunkka_2"	"Heh! Güverteden adam düştü!"
"[english]dota_chatwheel_message_kunkka_2"	"Heh! Man overboard!"
"dota_chatwheel_label_kunkka_2"	"Heh! Güverteden adam düştü!"
"[english]dota_chatwheel_label_kunkka_2"	"Heh! Man overboard!"
"dota_chatwheel_message_kunkka_4"	"Anla diye söylüyorum, sana yardımcı kaptan dediğim zaman aslında bunu kastetmiyorum."
"[english]dota_chatwheel_message_kunkka_4"	"Just to be clear, if I call you mate, I don't mean it literally."
"dota_chatwheel_label_kunkka_4"	"Anla diye söylüyorum..."
"[english]dota_chatwheel_label_kunkka_4"	"Just to be clear..."
"dota_chatwheel_message_lina_laugh"	"Ha ha ha ha ha ha ha!"
"[english]dota_chatwheel_message_lina_laugh"	"Ha ha ha ha ha ha ha!"
"dota_chatwheel_label_lina_laugh"	"[Kahkaha]"
"[english]dota_chatwheel_label_lina_laugh"	"[Laugh]"
"dota_chatwheel_message_lina_thank"	"Bu iyiydi!"
"[english]dota_chatwheel_message_lina_thank"	"That was hot!"
"dota_chatwheel_label_lina_thank"	"Bu iyiydi!"
"[english]dota_chatwheel_label_lina_thank"	"That was hot!"
"dota_chatwheel_message_lina_deny"	"Yakıyor, öyle değil mi?"
"[english]dota_chatwheel_message_lina_deny"	"Burns, doesn't it?"
"dota_chatwheel_label_lina_deny"	"Yakıyor, öyle değil mi?"
"[english]dota_chatwheel_label_lina_deny"	"Burns, doesn't it?"
"dota_chatwheel_message_lina_1"	"Bu çok parlak değildi."
"[english]dota_chatwheel_message_lina_1"	"That wasn't too bright."
"dota_chatwheel_label_lina_1"	"Bu çok parlak değildi."
"[english]dota_chatwheel_label_lina_1"	"That wasn't too bright."
"dota_chatwheel_message_lina_2"	"Ateşle oynamak ister misin?"
"[english]dota_chatwheel_message_lina_2"	"Wanna play with fire?"
"dota_chatwheel_label_lina_2"	"Ateşle oynamak ister misin?"
"[english]dota_chatwheel_label_lina_2"	"Wanna play with fire?"
"dota_chatwheel_message_lina_3"	"Tam bir serseri."
"[english]dota_chatwheel_message_lina_3"	"What a punk."
"dota_chatwheel_label_lina_3"	"Tam bir serseri."
"[english]dota_chatwheel_label_lina_3"	"What a punk."
"dota_chatwheel_message_lina_4"	"Ne cehennem oluyor burada?"
"[english]dota_chatwheel_message_lina_4"	"What in the blazes?"
"dota_chatwheel_label_lina_4"	"Ne cehennem oluyor burada?"
"[english]dota_chatwheel_label_lina_4"	"What in the blazes?"
"dota_chatwheel_message_lina_5"	"Annene gel!"
"[english]dota_chatwheel_message_lina_5"	"Come to mama!"
"dota_chatwheel_label_lina_5"	"Annene gel!"
"[english]dota_chatwheel_label_lina_5"	"Come to mama!"
"dota_chatwheel_message_lion_laugh"	"Vho-ha-ha-ha-ha-ha-ha-he-havha!"
"[english]dota_chatwheel_message_lion_laugh"	"Who-ha-ha-ha-ha-ha-ha-he-hawha!"
"dota_chatwheel_label_lion_laugh"	"[Kahkaha]"
"[english]dota_chatwheel_label_lion_laugh"	"[Laugh]"
"dota_chatwheel_message_lion_deny"	"Ah, seni düş kırıklığına uğrattığım için üzgünüm."
"[english]dota_chatwheel_message_lion_deny"	"Ah, sorry to disappoint you."
"dota_chatwheel_label_lion_deny"	"Düş kırıklığına uğrattığım için üzgünüm."
"[english]dota_chatwheel_label_lion_deny"	"Ah, sorry to disappoint you."
"dota_chatwheel_message_lion_1"	"Aslanı evcilleştirmeyi mi düşündün?"
"[english]dota_chatwheel_message_lion_1"	"You thought to tame the lion?"
"dota_chatwheel_label_lion_1"	"Aslanı evcilleştirmeyi mi düşündün?"
"[english]dota_chatwheel_label_lion_1"	"You thought to tame the lion?"
"dota_chatwheel_message_lion_2"	"Bir büyücünün öfkesini hisset!"
"[english]dota_chatwheel_message_lion_2"	"Feel the rage of a mage!"
"dota_chatwheel_label_lion_2"	"Bir büyücünün öfkesini hisset!"
"[english]dota_chatwheel_label_lion_2"	"Feel the rage of a mage!"
"dota_chatwheel_message_lion_4"	"Büyülü bir dokunuş yaptım."
"[english]dota_chatwheel_message_lion_4"	"I've got the magic touch."
"dota_chatwheel_label_lion_4"	"Büyülü bir dokunuş yaptım."
"[english]dota_chatwheel_label_lion_4"	"I've got the magic touch."
"dota_chatwheel_message_lion_5"	"Ceheneme gittim, geri geldim ve tekrar gittim... geri geldim."
"[english]dota_chatwheel_message_lion_5"	"I've been to hell and back, and back to hell...and back."
"dota_chatwheel_label_lion_5"	"Cehenneme gittim ve geri geldim..."
"[english]dota_chatwheel_label_lion_5"	"I've been to hell and back..."
"dota_chatwheel_message_shadow_shaman_thank"	"Dualarım kabul oldu."
"[english]dota_chatwheel_message_shadow_shaman_thank"	"My prayers are answered."
"dota_chatwheel_label_shadow_shaman_thank"	"Dualarım kabul oldu."
"[english]dota_chatwheel_label_shadow_shaman_thank"	"My prayers are answered."
"dota_chatwheel_message_shadow_shaman_1"	"Senin için ölümle dolu bir gelecek görüyorum!"
"[english]dota_chatwheel_message_shadow_shaman_1"	"I see for you a future full of death!"
"dota_chatwheel_label_shadow_shaman_1"	"Senin için ölüme dolu..."
"[english]dota_chatwheel_label_shadow_shaman_1"	"I see for you a future..."
"dota_chatwheel_message_shadow_shaman_2"	"Hiçbir yere gitmiyorsun."
"[english]dota_chatwheel_message_shadow_shaman_2"	"You're not going anywhere."
"dota_chatwheel_label_shadow_shaman_2"	"Hiçbir yere gitmiyorsun."
"[english]dota_chatwheel_label_shadow_shaman_2"	"You're not going anywhere."
"dota_chatwheel_message_shadow_shaman_3"	"Heh ha ha hah, ferahlatıcı!"
"[english]dota_chatwheel_message_shadow_shaman_3"	"Heh ha ha hah, how refreshing!"
"dota_chatwheel_label_shadow_shaman_3"	"Heh ha ha hah, ferahlatıcı!"
"[english]dota_chatwheel_label_shadow_shaman_3"	"Heh ha ha hah, how refreshing!"
"dota_chatwheel_message_shadow_shaman_4"	"Tadı tavuğa benziyor!"
"[english]dota_chatwheel_message_shadow_shaman_4"	"Tastes like chicken!"
"dota_chatwheel_message_slardar_laugh"	"Heh heeh heh hah hah ha hah hah!"
"[english]dota_chatwheel_message_slardar_laugh"	"Heh heeh heh hah hah ha hah hah!"
"dota_chatwheel_message_slardar_deny"	"Başınız sağ olsun."
"[english]dota_chatwheel_message_slardar_deny"	"My deepest sympathies."
"dota_chatwheel_label_slardar_deny"	"Başınız sağ olsun."
"[english]dota_chatwheel_label_slardar_deny"	"My deepest sympathies."
"dota_chatwheel_message_slardar_1"	"Senin ölümünü görmek için uzun yol kat ettim."
"[english]dota_chatwheel_message_slardar_1"	"I came a long way to see you die."
"dota_chatwheel_label_slardar_1"	"Senin ölümünü..."
"[english]dota_chatwheel_label_slardar_1"	"I came a long way..."
"dota_chatwheel_message_slardar_4"	"Boyundan büyük işlere kalkıştın."
"[english]dota_chatwheel_message_slardar_4"	"You were out of your depth."
"dota_chatwheel_label_slardar_4"	"Boyundan büyük işlere kalkıştın."
"[english]dota_chatwheel_label_slardar_4"	"You were out of your depth."
"dota_chatwheel_message_slardar_5"	"Ah, derinlerdekiler nasıl da ziyafet çekecek şimdi!"
"[english]dota_chatwheel_message_slardar_5"	"Oh, how the deep ones will feast!"
"dota_chatwheel_label_slardar_5"	"Ah, derinlerdekiler nasıl da ziyafet çekecek şimdi!"
"[english]dota_chatwheel_label_slardar_5"	"Oh, how the deep ones will feast!"
"dota_chatwheel_message_tidehunter_thank"	"Bu akıntıyı lehimize çevireceğiz."
"[english]dota_chatwheel_message_tidehunter_thank"	"We'll turn this tide to our advantage."
"dota_chatwheel_label_tidehunter_thank"	"Bu akıntıyı lehimize çevireceğiz."
"[english]dota_chatwheel_label_tidehunter_thank"	"We'll turn this tide to our advantage."
"dota_chatwheel_message_tidehunter_1"	"Ha ha ha ha ha ha, artık balık yemisin."
"[english]dota_chatwheel_message_tidehunter_1"	"Ha ha ha ha ha ha, Now you're fish food."
"dota_chatwheel_message_tidehunter_2"	"Ha ha bir deniz aygırı yiyebilirim."
"[english]dota_chatwheel_message_tidehunter_2"	"Ha ha I could eat a walrus."
"dota_chatwheel_label_tidehunter_2"	"Ha ha bir deniz aygırı yiyebilirim."
"[english]dota_chatwheel_label_tidehunter_2"	"Ha ha I could eat a walrus."
"dota_chatwheel_message_tidehunter_5"	"Bu dişlerim varken kim büyük bir beyne gereksinim duyar ki?"
"[english]dota_chatwheel_message_tidehunter_5"	"Who needs a big brain when you've got teeth like mine?"
"dota_chatwheel_label_tidehunter_5"	"Bu dişlerim varken kim...?"
"[english]dota_chatwheel_label_tidehunter_5"	"Who needs a big brain...?"
"dota_chatwheel_message_witch_doctor_deny"	"Bekleyin... bekleyin..."
"[english]dota_chatwheel_message_witch_doctor_deny"	"Wait for it...wait for it..."
"dota_chatwheel_label_witch_doctor_deny"	"Bekleyin... bekleyin..."
"[english]dota_chatwheel_label_witch_doctor_deny"	"Wait for it...wait for it..."
"dota_chatwheel_message_witch_doctor_2"	"Birisi doktor mu çağırdı?"
"[english]dota_chatwheel_message_witch_doctor_2"	"Someone call de doctor?"
"dota_chatwheel_label_witch_doctor_2"	"Birisi doktor mu çağırdı?"
"[english]dota_chatwheel_label_witch_doctor_2"	"Someone call de doctor?"
"dota_chatwheel_message_witch_doctor_3"	"Oh, şuna bak."
"[english]dota_chatwheel_message_witch_doctor_3"	"Oh, look at it go."
"dota_chatwheel_label_witch_doctor_3"	"Oh, şuna bak."
"[english]dota_chatwheel_label_witch_doctor_3"	"Oh, look at it go."
"dota_chatwheel_message_witch_doctor_4"	"İçine bir kemik sokuşturalım. Hazırsın."
"[english]dota_chatwheel_message_witch_doctor_4"	"Stick a bone in it. You're done."
"dota_chatwheel_label_witch_doctor_4"	"İçine bir kemik sokuşturalım. Hazırsın."
"[english]dota_chatwheel_label_witch_doctor_4"	"Stick a bone in it. You're done."
"dota_chatwheel_message_lich_laugh"	"Ha ha ha ha ha ha ha ha!"
"[english]dota_chatwheel_message_lich_laugh"	"Ha ha ha ha ha ha ha ha!"
"dota_chatwheel_message_lich_thank"	"Soğukkanlı ol!"
"[english]dota_chatwheel_message_lich_thank"	"Stay frosty!"
"dota_chatwheel_message_lich_deny"	"Adımına dikkat et de tahtalı köyü boylama."
"[english]dota_chatwheel_message_lich_deny"	"Watch your step, it's six feet down."
"dota_chatwheel_message_lich_1"	"Ölüyü öldüremezsin."
"[english]dota_chatwheel_message_lich_1"	"Can't kill the dead."
"dota_chatwheel_label_lich_1"	"Ölüyü öldüremezsin."
"[english]dota_chatwheel_label_lich_1"	"Can't kill the dead."
"dota_chatwheel_message_lich_3"	"Soğuk kucaklamamı hissedin!"
"[english]dota_chatwheel_message_lich_3"	"Feel my cold embrace!"
"dota_chatwheel_label_lich_3"	"Soğuk kucaklamamı hissedin!"
"[english]dota_chatwheel_label_lich_3"	"Feel my cold embrace!"
"dota_chatwheel_message_lich_4"	"Şimdi bir numara kim?"
"[english]dota_chatwheel_message_lich_4"	"Who's the number one now?"
"dota_chatwheel_label_lich_4"	"Şimdi bir numara kim?"
"[english]dota_chatwheel_label_lich_4"	"Who's the number one now?"
"dota_chatwheel_message_riki_laugh"	"hoo hoo hoo hoo hoo hoo hoo."
"[english]dota_chatwheel_message_riki_laugh"	"hoo hoo hoo hoo hoo hoo hoo."
"dota_chatwheel_message_riki_thank"	"Sözleşme tamamlandı."
"[english]dota_chatwheel_message_riki_thank"	"Contract complete."
"dota_chatwheel_label_riki_thank"	"Sözleşme tamamlandı."
"[english]dota_chatwheel_label_riki_thank"	"Contract complete."
"dota_chatwheel_message_riki_deny"	"Heh-ho, bunun geldiğini görmedin."
"[english]dota_chatwheel_message_riki_deny"	"Heh-ho, you didn't see that coming."
"dota_chatwheel_label_riki_deny"	"Bunun geldiğini görmedin."
"[english]dota_chatwheel_label_riki_deny"	"You didn't see that coming."
"dota_chatwheel_message_riki_1"	"Neden kaçınılmaz olanı uzatasın?"
"[english]dota_chatwheel_message_riki_1"	"Why prolong the inevitable?"
"dota_chatwheel_label_riki_1"	"Neden kaçınılmaz olanı uzatasın?"
"[english]dota_chatwheel_label_riki_1"	"Why prolong the inevitable?"
"dota_chatwheel_message_riki_3"	"Eğer beni görüyorsan çoktan ölmüşsün demektir."
"[english]dota_chatwheel_message_riki_3"	"If you can see me, you're already dead."
"dota_chatwheel_label_riki_3"	"Eğer beni görüyorsan..."
"[english]dota_chatwheel_label_riki_3"	"If you can see me..."
"dota_chatwheel_message_riki_4"	"Onca zamandır buradaydım."
"[english]dota_chatwheel_message_riki_4"	"I've been here the whole time."
"dota_chatwheel_label_riki_4"	"Onca zamandır buradaydım."
"[english]dota_chatwheel_label_riki_4"	"I've been here the whole time."
"dota_chatwheel_message_riki_5"	"Oh sen ölüsün. Bu ne sürpriz."
"[english]dota_chatwheel_message_riki_5"	"Oh you're dead. What a surprise."
"dota_chatwheel_label_riki_5"	"Oh sen ölüsün. Bu ne sürpriz."
"[english]dota_chatwheel_label_riki_5"	"Oh you're dead. What a surprise."
"dota_chatwheel_message_enigma_laugh"	"He-he-huh-heh-heh."
"[english]dota_chatwheel_message_enigma_laugh"	"He-he-huh-heh-heh."
"dota_chatwheel_message_enigma_thank"	"Eh, bu bir paradoks."
"[english]dota_chatwheel_message_enigma_thank"	"Well, this is a paradox."
"dota_chatwheel_label_enigma_thank"	"Eh, bu bir paradoks."
"[english]dota_chatwheel_label_enigma_thank"	"Well, this is a paradox."
"dota_chatwheel_message_enigma_deny"	"Çok uçuk bir fiyat."
"[english]dota_chatwheel_message_enigma_deny"	"An astronomical price."
"dota_chatwheel_label_enigma_deny"	"Çok uçuk bir fiyat."
"[english]dota_chatwheel_label_enigma_deny"	"An astronomical price."
"dota_chatwheel_message_enigma_1"	"Uçuruma doğru bak."
"[english]dota_chatwheel_message_enigma_1"	"Stare into the abyss."
"dota_chatwheel_label_enigma_1"	"Uçuruma doğru bak."
"[english]dota_chatwheel_label_enigma_1"	"Stare into the abyss."
"dota_chatwheel_message_enigma_2"	"Sukût altındır."
"[english]dota_chatwheel_message_enigma_2"	"Silence is golden."
"dota_chatwheel_label_enigma_2"	"Sukût altındır."
"[english]dota_chatwheel_label_enigma_2"	"Silence is golden."
"dota_chatwheel_message_enigma_3"	"Benim için değersizsin."
"[english]dota_chatwheel_message_enigma_3"	"You are beneath me."
"dota_chatwheel_label_enigma_3"	"Benim için değersizsin."
"[english]dota_chatwheel_label_enigma_3"	"You are beneath me."
"dota_chatwheel_message_enigma_4"	"Afakiliğin memnuniyetle karşılanan bir tezahürü."
"[english]dota_chatwheel_message_enigma_4"	"A welcome manifestation of randomness."
"dota_chatwheel_label_enigma_4"	"Afakiliğin memnuniyetle karşılanan bir tezahürü."
"[english]dota_chatwheel_label_enigma_4"	"A welcome manifestation of randomness."
"dota_chatwheel_message_enigma_5"	"Işık bile benden kaçamazken senin ne umudun var?"
"[english]dota_chatwheel_message_enigma_5"	"If light cannot escape me, what hope have you?"
"dota_chatwheel_label_enigma_5"	"Işık bile benden kaçamazken..."
"[english]dota_chatwheel_label_enigma_5"	"If light cannot escape me..."
"dota_chatwheel_message_tinker_thank"	"Hünerlerin sevimliliğini gölgede bırakıyor."
"[english]dota_chatwheel_message_tinker_thank"	"Your talents surpass your loveliness."
"dota_chatwheel_label_tinker_thank"	"Hünerlerin sevimliliğini gölgede bırakıyor."
"[english]dota_chatwheel_label_tinker_thank"	"Your talents surpass your loveliness."
"dota_chatwheel_message_tinker_deny"	"Harika bir şey değil mi?"
"[english]dota_chatwheel_message_tinker_deny"	"Well isn't that something!"
"dota_chatwheel_label_tinker_deny"	"Harika bir şey değil mi?"
"[english]dota_chatwheel_label_tinker_deny"	"Well isn't that something!"
"dota_chatwheel_message_tinker_1"	"Dıkşın, dıkşın!"
"[english]dota_chatwheel_message_tinker_1"	"Pew, pew, pew pew pew!"
"dota_chatwheel_label_tinker_1"	"Dıkşın, dıkşın!"
"[english]dota_chatwheel_label_tinker_1"	"Pew, pew, pew pew pew!"
"dota_chatwheel_message_tinker_2"	"Bunların hepsini tahmin ettiğimi biliyor musun, hepsini!"
"[english]dota_chatwheel_message_tinker_2"	"I predicted all of this you know, all of it!"
"dota_chatwheel_label_tinker_2"	"Bunların hepsini tahmin ettiğimi..."
"[english]dota_chatwheel_label_tinker_2"	"I predicted all of this you know..."
"dota_chatwheel_label_tinker_4"	"Bu deney başarısız oldu."
"[english]dota_chatwheel_label_tinker_4"	"I'm going to call that experiment..."
"dota_chatwheel_message_tinker_5"	"Büyün sende kalsın, benim lazer ışınlarım var!"
"[english]dota_chatwheel_message_tinker_5"	"You can keep your magic, I have laser beams!"
"dota_chatwheel_label_tinker_5"	"Büyün sende kalsın..."
"[english]dota_chatwheel_label_tinker_5"	"You can keep your magic..."
"dota_chatwheel_message_sniper_laugh"	"Hee hee hee hee hee hee hee hee hee hee!"
"[english]dota_chatwheel_message_sniper_laugh"	"Hee hee hee hee hee hee hee hee hee hee!"
"dota_chatwheel_message_sniper_thank"	"Hedef talimi işe yarıyor!"
"[english]dota_chatwheel_message_sniper_thank"	"Target practice, payin' off!"
"dota_chatwheel_label_sniper_thank"	"Hedef talimi işe yarıyor!"
"[english]dota_chatwheel_label_sniper_thank"	"Target practice, payin' off!"
"dota_chatwheel_message_sniper_3"	"Neden mi gülümsüyorum? Tetiği çekmeye sürekli hazır olmak böyle bir his işte."
"[english]dota_chatwheel_message_sniper_3"	"Why am I smiling? This is what trigger-happy looks like."
"dota_chatwheel_message_necrolyte_laugh"	"Ha ha ha ha ha ha ha ha ha ha ha ha!"
"[english]dota_chatwheel_message_necrolyte_laugh"	"Ha ha ha ha ha ha ha ha ha ha ha ha!"
"dota_chatwheel_message_necrolyte_1"	"Ölümün kokusu üstünde."
"[english]dota_chatwheel_message_necrolyte_1"	"The stench of death is upon you."
"dota_chatwheel_label_necrolyte_1"	"Ölümün kokusu üstünde."
"[english]dota_chatwheel_label_necrolyte_1"	"The stench of death is upon you."
"dota_chatwheel_message_necrolyte_2"	"Neşelen de ne demekmiş? Ben zaten oldukça neşeliyim."
"[english]dota_chatwheel_message_necrolyte_2"	"What do you mean, cheer up? I'm quite cheerful."
"dota_chatwheel_label_necrolyte_2"	"Neşelen de ne demekmiş?..."
"[english]dota_chatwheel_label_necrolyte_2"	"What do you mean, cheer up?..."
"dota_chatwheel_message_necrolyte_4"	"Sağlığınıza. Ha ha ha ha ha ha ha ha ha."
"[english]dota_chatwheel_message_necrolyte_4"	"To your health. Ha ha ha ha ha ha ha ha ha."
"dota_chatwheel_message_warlock_laugh"	"Ho ha ha ha ha ha ha ha ha!"
"[english]dota_chatwheel_message_warlock_laugh"	"Ho ha ha ha ha ha ha ha ha!"
"dota_chatwheel_message_warlock_3"	"Kara büyü kitabıma bir isim daha eklendi."
"[english]dota_chatwheel_message_warlock_3"	"Another name in my grimoire."
"dota_chatwheel_label_warlock_3"	"Kara büyü kitabıma bir isim..."
"[english]dota_chatwheel_label_warlock_3"	"Another name in my grimoire."
"dota_chatwheel_message_beastmaster_laugh"	"Howeh heh heh eh hah heh heh heh."
"[english]dota_chatwheel_message_beastmaster_laugh"	"Howeh heh heh eh hah heh heh heh."
"dota_chatwheel_message_beastmaster_deny"	"Siz uyurken sizi izliyor olacağım."
"[english]dota_chatwheel_message_beastmaster_deny"	"I'll be creeping while you are sleeping."
"dota_chatwheel_label_beastmaster_deny"	"Siz uyurken..."
"[english]dota_chatwheel_label_beastmaster_deny"	"I'll be creeping..."
"dota_chatwheel_message_beastmaster_4"	"Hmm, keşke okumam olsaydı."
"[english]dota_chatwheel_message_beastmaster_4"	"Hmm, wish I'd learned how to read."
"dota_chatwheel_label_beastmaster_4"	"Hmm, keşke okumam olsaydı."
"[english]dota_chatwheel_label_beastmaster_4"	"Hmm, wish I'd learned how to read."
"dota_chatwheel_message_queenofpain_laugh"	"Uh ha ha ha ha ha ha ha ha ha ha ha!"
"[english]dota_chatwheel_message_queenofpain_laugh"	"Uh ha ha ha ha ha ha ha ha ha ha ha!"
"dota_chatwheel_message_queenofpain_thank"	"Acı olacak, çığlıklar duyulacak."
"[english]dota_chatwheel_message_queenofpain_thank"	"There will be pain, there will be screaming."
"dota_chatwheel_message_queenofpain_deny"	"Sevdiklerini incitiyorsun."
"[english]dota_chatwheel_message_queenofpain_deny"	"You hurt the ones you love."
"dota_chatwheel_label_queenofpain_deny"	"Sevdiklerini incitiyorsun."
"[english]dota_chatwheel_label_queenofpain_deny"	"You hurt the ones you love."
"dota_chatwheel_message_queenofpain_3"	"Karşı koymana bayılıyorum."
"[english]dota_chatwheel_message_queenofpain_3"	"I love it when you resist."
"dota_chatwheel_label_queenofpain_3"	"Karşı koymana bayılıyorum."
"[english]dota_chatwheel_label_queenofpain_3"	"I love it when you resist."
"dota_chatwheel_message_queenofpain_5"	"Bir acı olduğumu biliyorum ancak sen yine de beni seviyorsun."
"[english]dota_chatwheel_message_queenofpain_5"	"I know I'm a pain, but you love me anyway."
"dota_chatwheel_label_queenofpain_5"	"Bir acı olduğumu biliyorum..."
"[english]dota_chatwheel_label_queenofpain_5"	"I know I'm a pain..."
"dota_chatwheel_message_venomancer_laugh"	"Sss eh he he he he."
"[english]dota_chatwheel_message_venomancer_laugh"	"Sss eh he he he he."
"dota_chatwheel_message_venomancer_thank"	"Düşmanlarımıza zeval!"
"[english]dota_chatwheel_message_venomancer_thank"	"Plague our enemies!"
"dota_chatwheel_label_venomancer_thank"	"Düşmanlarımıza zeval!"
"[english]dota_chatwheel_label_venomancer_thank"	"Plague our enemies!"
"dota_chatwheel_message_venomancer_1"	"Hiçbir şey benim zehrim gibi kalplere dokunamaz."
"[english]dota_chatwheel_message_venomancer_1"	"Nothing touches the heart like my venom."
"dota_chatwheel_label_venomancer_1"	"Hiçbir şey benim zehrim..."
"[english]dota_chatwheel_label_venomancer_1"	"Nothing touches the heart..."
"dota_chatwheel_message_venomancer_3"	"Zehirli olandan kaçamazsın!"
"[english]dota_chatwheel_message_venomancer_3"	"You can't run from the venomous one!"
"dota_chatwheel_message_venomancer_4"	"Hepsini bana borçluyum."
"[english]dota_chatwheel_message_venomancer_4"	"I owe it all to me."
"dota_chatwheel_label_venomancer_4"	"Hepsini bana borçluyum."
"[english]dota_chatwheel_label_venomancer_4"	"I owe it all to me."
"dota_chatwheel_message_venomancer_5"	"Ah, tatlı zehir!"
"[english]dota_chatwheel_message_venomancer_5"	"Ah, sweet toxicity!"
"dota_chatwheel_label_venomancer_5"	"Ah, tatlı zehir!"
"[english]dota_chatwheel_label_venomancer_5"	"Ah, sweet toxicity!"
"dota_chatwheel_message_faceless_void_laugh"	"Heh heh hah ha hah heh heah heh."
"[english]dota_chatwheel_message_faceless_void_laugh"	"Heh heh hah ha hah heh heah heh."
"dota_chatwheel_message_faceless_void_deny"	"Bazı şeylerin olacağı yokmuş."
"[english]dota_chatwheel_message_faceless_void_deny"	"Some things were just not meant to be."
"dota_chatwheel_label_faceless_void_deny"	"...olacağı yokmuş."
"[english]dota_chatwheel_label_faceless_void_deny"	"...just not meant to be."
"dota_chatwheel_message_faceless_void_1"	"Yüzünü ve hayatını kaybedeceksin."
"[english]dota_chatwheel_message_faceless_void_1"	"You lose face and life."
"dota_chatwheel_label_faceless_void_1"	"Yüzünü ve hayatını..."
"[english]dota_chatwheel_label_faceless_void_1"	"You lose face and life."
"dota_chatwheel_message_faceless_void_4"	"Yüzsüz olabilirim ama topuzsuz değilim."
"[english]dota_chatwheel_message_faceless_void_4"	"I may be faceless, but I'm not maceless."
"dota_chatwheel_label_faceless_void_4"	"Yüzsüz olabilirim ama..."
"[english]dota_chatwheel_label_faceless_void_4"	"I may be faceless, but..."
"dota_chatwheel_message_faceless_void_5"	"Zamanın sonuna kadar sürecek bir utanç!"
"[english]dota_chatwheel_message_faceless_void_5"	"An eternity of embarrassment!"
"dota_chatwheel_label_faceless_void_5"	"Zamanın sonuna kadar..."
"[english]dota_chatwheel_label_faceless_void_5"	"An eternity of embarrassment!"
"dota_chatwheel_message_skeleton_king_thank"	"GÜÇSÜZ VE UFAK DOSTLARIMA MÜMKÜN OLDUKÇA YARDIMCI OLACAĞIM."
"[english]dota_chatwheel_message_skeleton_king_thank"	"I'LL HELP MY WEAK AND PUNY ALLIES WHERE I CAN."
"dota_chatwheel_label_skeleton_king_thank"	"GÜÇSÜZ VE UFAK DOSTLARIMA..."
"[english]dota_chatwheel_label_skeleton_king_thank"	"...WEAK AND PUNY ALLIES..."
"dota_chatwheel_message_skeleton_king_4"	"ARTIK ÇOK SEKSİYİM."
"[english]dota_chatwheel_message_skeleton_king_4"	"I NOW HAVE ALL THE SEXY."
"dota_chatwheel_label_skeleton_king_4"	"ARTIK ÇOK SEKSİYİM."
"[english]dota_chatwheel_label_skeleton_king_4"	"I NOW HAVE ALL THE SEXY."
"dota_chatwheel_message_skeleton_king_5"	"HOŞ GELDİNİZ YENİ KULLARIM. HAYDİ TANIŞALIM."
"[english]dota_chatwheel_message_skeleton_king_5"	"WELCOME TO ALL MY NEW SUBJECTS. NOW LET'S GET TO KNOW EACH OTHER."
"dota_chatwheel_label_skeleton_king_5"	"HOŞ GELDİNİZ YENİ KULLARIM..."
"[english]dota_chatwheel_label_skeleton_king_5"	"WELCOME TO ALL MY NEW SUBJECTS..."
"dota_chatwheel_message_death_prophet_laugh"	"Oh ah ha ha ha ha ha ho ho haa! Ha ha ha ha ha ha!"
"[english]dota_chatwheel_message_death_prophet_laugh"	"Oh ah ha ha ha ha ha ho ho haa! Ha ha ha ha ha ha!"
"dota_chatwheel_message_death_prophet_thank"	"Aferin güzellerim."
"[english]dota_chatwheel_message_death_prophet_thank"	"Well done, my beauties!"
"dota_chatwheel_label_death_prophet_thank"	"Aferin güzellerim."
"[english]dota_chatwheel_label_death_prophet_thank"	"Well done, my beauties!"
"dota_chatwheel_message_death_prophet_3"	"Bana geri dön! Bana geri dön!"
"[english]dota_chatwheel_message_death_prophet_3"	"Come back to me! Come back to me!"
"dota_chatwheel_message_death_prophet_4"	"Bunun olacağını bilmek için kâhin olmaya gerek yok."
"[english]dota_chatwheel_message_death_prophet_4"	"It did not take a prophet to see that coming."
"dota_chatwheel_label_death_prophet_4"	"Bunun olacağını bilmek..."
"[english]dota_chatwheel_label_death_prophet_4"	"It did not take a prophet..."
"dota_chatwheel_message_death_prophet_5"	"Az evvel içimden bir parça koptu."
"[english]dota_chatwheel_message_death_prophet_5"	"I died a little just now."
"dota_chatwheel_label_death_prophet_5"	"Az evvel içimden bir parça koptu."
"[english]dota_chatwheel_label_death_prophet_5"	"I died a little just now."
"dota_chatwheel_message_phantom_assassin_laugh"	"Ho ho ho ho ho ha ha ha"
"[english]dota_chatwheel_message_phantom_assassin_laugh"	"Ho ho ho ho ho ha ha ha"
"dota_chatwheel_message_phantom_assassin_deny"	"Her şey plana göre."
"[english]dota_chatwheel_message_phantom_assassin_deny"	"All according to plan."
"dota_chatwheel_label_phantom_assassin_deny"	"Her şey plana göre."
"[english]dota_chatwheel_label_phantom_assassin_deny"	"All according to plan."
"dota_chatwheel_message_phantom_assassin_1"	"Benim ellerimden gelen ölüm bir onurdur."
"[english]dota_chatwheel_message_phantom_assassin_1"	"Death at my hands is an honor."
"dota_chatwheel_label_phantom_assassin_1"	"Benim ellerimden gelen ölüm..."
"[english]dota_chatwheel_label_phantom_assassin_1"	"Death at my hands is an honor."
"dota_chatwheel_message_phantom_assassin_2"	"İyiydi, sanırım."
"[english]dota_chatwheel_message_phantom_assassin_2"	"That went well, I think."
"dota_chatwheel_label_phantom_assassin_2"	"İyiydi, sanırım."
"[english]dota_chatwheel_label_phantom_assassin_2"	"That went well, I think."
"dota_chatwheel_message_phantom_assassin_3"	"Elimde kaç tane hançer tutuyorum?"
"[english]dota_chatwheel_message_phantom_assassin_3"	"How many daggers am I holding up?"
"dota_chatwheel_label_phantom_assassin_3"	"Elimde kaç tane hançer tutuyorum?"
"[english]dota_chatwheel_label_phantom_assassin_3"	"How many daggers am I holding up?"
"dota_chatwheel_message_phantom_assassin_4"	"Ha, ahhh, ha ha, no no no."
"[english]dota_chatwheel_message_phantom_assassin_4"	"Ha, ahhh, ha ha, no no no."
"dota_chatwheel_message_pugna_thank"	"Ah, bu çok iyi olacak."
"[english]dota_chatwheel_message_pugna_thank"	"Ah, this is going to be good."
"dota_chatwheel_label_pugna_thank"	"Ah, bu çok iyi olacak."
"[english]dota_chatwheel_label_pugna_thank"	"Ah, this is going to be good."
"dota_chatwheel_message_pugna_deny"	"İşi daha da kötülüştirmekten başka bir şey yapmıyorsun."
"[english]dota_chatwheel_message_pugna_deny"	"You're only making it worse."
"dota_chatwheel_label_pugna_deny"	"İşi daha da kötülüştirmekten..."
"[english]dota_chatwheel_label_pugna_deny"	"You're only making it worse."
"dota_chatwheel_message_pugna_3"	"Kötü şöhret kazanma vakti."
"[english]dota_chatwheel_message_pugna_3"	"Time to earn myself a bad reputation."
"dota_chatwheel_label_pugna_3"	"Kötü şöhret..."
"[english]dota_chatwheel_label_pugna_3"	"Time to earn myself..."
"dota_chatwheel_message_templar_assassin_deny"	"Sonu çok tahmin edilebilirdi."
"[english]dota_chatwheel_message_templar_assassin_deny"	"I saw that ending from miles away."
"dota_chatwheel_label_templar_assassin_deny"	"Sonu çok tahmin edilebilirdi."
"[english]dota_chatwheel_label_templar_assassin_deny"	"I saw that ending from miles away."
"dota_chatwheel_message_templar_assassin_1"	"Mezarını asla bulamayacaklar."
"[english]dota_chatwheel_message_templar_assassin_1"	"They'll never find your grave."
"dota_chatwheel_label_templar_assassin_1"	"Mezarını asla bulamayacaklar."
"[english]dota_chatwheel_label_templar_assassin_1"	"They'll never find your grave."
"dota_chatwheel_message_luna_thank"	"Şükürler üzerinde olsun sadık savaşçı."
"[english]dota_chatwheel_message_luna_thank"	"Blessings upon a loyal warrior."
"dota_chatwheel_label_luna_thank"	"Şükürler üzerinde olsun sadık savaşçı."
"[english]dota_chatwheel_label_luna_thank"	"Blessings upon a loyal warrior."
"dota_chatwheel_message_luna_1"	"Ormanda mı kayboldun?"
"[english]dota_chatwheel_message_luna_1"	"Lost in the woods, are you?"
"dota_chatwheel_label_luna_1"	"Ormanda mı kayboldun?"
"[english]dota_chatwheel_label_luna_1"	"Lost in the woods, are you?"
"dota_chatwheel_message_dragon_knight_laugh"	"Tehh, heh he huh heh heh huh."
"[english]dota_chatwheel_message_dragon_knight_laugh"	"Tehh, heh he huh heh heh huh."
"dota_chatwheel_message_dragon_knight_1"	"Onurlu savaştın ve onurlu öldün."
"[english]dota_chatwheel_message_dragon_knight_1"	"You fought and died with honor."
"dota_chatwheel_label_dragon_knight_1"	"Onurlu savaştın ve onurlu öldün."
"[english]dota_chatwheel_label_dragon_knight_1"	"You fought and died with honor."
"dota_chatwheel_message_dragon_knight_3"	"Kılıçla yaşa, ejderhadan  öl."
"[english]dota_chatwheel_message_dragon_knight_3"	"Live by the sword, die by the dragon."
"dota_chatwheel_label_dragon_knight_3"	"Kılıçla yaşa..."
"[english]dota_chatwheel_label_dragon_knight_3"	"Live by the sword..."
"dota_chatwheel_message_dragon_knight_5"	"Dünya, ateşler içinde yok olacak."
"[english]dota_chatwheel_message_dragon_knight_5"	"The world shall end in fire."
"dota_chatwheel_label_dragon_knight_5"	"Dünya, ateşler içinde yok olacak."
"[english]dota_chatwheel_label_dragon_knight_5"	"The world shall end in fire."
"dota_chatwheel_message_dazzle_5"	"Neredeyse tam bir felaketti."
"[english]dota_chatwheel_message_dazzle_5"	"That was almost a disaster."
"dota_chatwheel_label_dazzle_5"	"Neredeyse tam bir felaketti."
"[english]dota_chatwheel_label_dazzle_5"	"That was almost a disaster."
"dota_chatwheel_message_rattletrap_deny"	"Bunu beklemiyor muydun?"
"[english]dota_chatwheel_message_rattletrap_deny"	"Not what you expected?"
"dota_chatwheel_label_rattletrap_deny"	"Bunu beklemiyor muydun?"
"[english]dota_chatwheel_label_rattletrap_deny"	"Not what you expected?"
"dota_chatwheel_message_rattletrap_4"	"Bip bop, ben bir robotum. Hehe şaka yaptım."
"[english]dota_chatwheel_message_rattletrap_4"	"Bleep bloop, I am a robot. Eh, just kidding."
"dota_chatwheel_label_rattletrap_4"	"Bip bop, ben bir robotum..."
"[english]dota_chatwheel_label_rattletrap_4"	"Bleep bloop, I am a robot..."
"dota_chatwheel_message_furion_laugh"	"Ma ha ha ha ha ha ha ha ha ha!"
"[english]dota_chatwheel_message_furion_laugh"	"Ma ha ha ha ha ha ha ha ha ha!"
"dota_chatwheel_message_furion_2"	"Seni paramparça edeceğim."
"[english]dota_chatwheel_message_furion_2"	"I'll tear you limb from limb."
"dota_chatwheel_label_furion_2"	"Seni paramparça edeceğim."
"[english]dota_chatwheel_label_furion_2"	"I'll tear you limb from limb."
"dota_chatwheel_message_furion_5"	"Kemiklerinin arasında yeni bir yaşam ortaya çıkacak."
"[english]dota_chatwheel_message_furion_5"	"New life will make its home amongst your bones."
"dota_chatwheel_label_furion_5"	"Kemiklerinin arasında yeni..."
"[english]dota_chatwheel_label_furion_5"	"New life will make its home..."
"dota_chatwheel_message_dark_seer_laugh"	"Heheh yeheheh hey heehhhe yehhey yehe heheh eheh yeh."
"[english]dota_chatwheel_message_dark_seer_laugh"	"Heheh yeheheh hey heehhhe yehhey yehe heheh eheh yeh."
"dota_chatwheel_message_clinkz_1"	"Bedenini küle çevireceğim."
"[english]dota_chatwheel_message_clinkz_1"	"I'll burn your body to ashes."
"dota_chatwheel_label_clinkz_1"	"Bedenini küle çevireceğim."
"[english]dota_chatwheel_label_clinkz_1"	"I'll burn your body to ashes."
"dota_chatwheel_message_clinkz_3"	"Hedef talimi için teşekkürler."
"[english]dota_chatwheel_message_clinkz_3"	"Thanks for the target practice."
"dota_chatwheel_label_clinkz_3"	"Hedef talimi için teşekkürler."
"[english]dota_chatwheel_label_clinkz_3"	"Thanks for the target practice."
"dota_chatwheel_message_clinkz_5"	"Ateş beslendikçe daha fazlasını istiyor."
"[english]dota_chatwheel_message_clinkz_5"	"Fire grows hungrier the more its fed."
"dota_chatwheel_label_clinkz_5"	"Ateş beslendikçe..."
"[english]dota_chatwheel_label_clinkz_5"	"Fire grows hungrier..."
"dota_chatwheel_message_omniknight_1"	"Savaş alanında başka bir leke daha."
"[english]dota_chatwheel_message_omniknight_1"	"Another stain on the battlefield."
"dota_chatwheel_label_omniknight_1"	"Savaş alanında başka bir leke daha."
"[english]dota_chatwheel_label_omniknight_1"	"Another stain on the battlefield."
"dota_chatwheel_message_omniknight_5"	"Her Şeyi Bilen, pişmanlığını hissedebiliyor."
"[english]dota_chatwheel_message_omniknight_5"	"The All-knowing One senses your regret."
"dota_chatwheel_label_omniknight_5"	"Her Şeyi Bilen, pişmanlığını..."
"[english]dota_chatwheel_label_omniknight_5"	"The All-knowing One senses..."
"dota_chatwheel_message_bounty_hunter_laugh"	"Ah ha ha ha ha ha ha ha ha."
"[english]dota_chatwheel_message_bounty_hunter_laugh"	"Ah ha ha ha ha ha ha ha ha."
"dota_chatwheel_message_spectre_laugh"	"Ha ha ha ha ha ha ha ha ha ha ha ha ha ha ha ha ha ha ha ha!"
"[english]dota_chatwheel_message_spectre_laugh"	"Ha ha ha ha ha ha ha ha ha ha ha ha ha ha ha ha ha ha ha ha!"
"dota_chatwheel_message_ancient_apparition_laugh"	"Hm hm hm ha ha ha ha ha ha ha!"
"[english]dota_chatwheel_message_ancient_apparition_laugh"	"Hm hm hm ha ha ha ha ha ha ha!"
"dota_chatwheel_message_invoker_laugh"	"Ha ha ha ha ha ha ha ha ha ha!"
"[english]dota_chatwheel_message_invoker_laugh"	"Ha ha ha ha ha ha ha ha ha ha!"
"dota_chatwheel_message_obsidian_destroyer_laugh"	"Ha ha ha ha ha ha ha ha ha!"
"[english]dota_chatwheel_message_obsidian_destroyer_laugh"	"Ha ha ha ha ha ha ha ha ha!"
"dota_chatwheel_message_lycan_laugh"	"Ah ha ha ha ha ha ha ha."
"[english]dota_chatwheel_message_lycan_laugh"	"Ah ha ha ha ha ha ha ha."
"dota_chatwheel_message_shadow_demon_laugh"	"Ha ha ha ha ha ha ha ha ha ha."
"[english]dota_chatwheel_message_shadow_demon_laugh"	"Ha ha ha ha ha ha ha ha ha ha."
"dota_chatwheel_message_meepo_laugh"	"Hnya Hnyahnyaha ha ha ha!"
"[english]dota_chatwheel_message_meepo_laugh"	"Hnya Hnyahnyaha ha ha ha!"
"dota_chatwheel_message_undying_laugh"	"Heh heh heh heh ha ha ha ha ha ha ha ha ha ha!"
"[english]dota_chatwheel_message_undying_laugh"	"Heh heh heh heh ha ha ha ha ha ha ha ha ha ha!"
"dota_chatwheel_message_visage_laugh"	"Ah ha ha ha ha ha ha ha ha!"
"[english]dota_chatwheel_message_visage_laugh"	"Ah ha ha ha ha ha ha ha ha!"
"dota_chatwheel_message_medusa_1"	"Kobraya karşı koyma küçük kuş."
"[english]dota_chatwheel_message_medusa_1"	"Don't resist the cobra, little bird."
"dota_chatwheel_label_medusa_1"	"Kobraya karşı koyma"
"[english]dota_chatwheel_label_medusa_1"	"Don't resist the cobra"
"dota_chatwheel_message_medusa_3"	"Soğuk kanlı olduğumu biliyordun."
"[english]dota_chatwheel_message_medusa_3"	"You knew I was cold-blooded."
"dota_chatwheel_label_medusa_3"	"Soğuk kanlı olduğumu biliyordun."
"[english]dota_chatwheel_label_medusa_3"	"You knew I was cold-blooded."
"dota_chatwheel_message_medusa_4"	"Yılan geri döndü."
"[english]dota_chatwheel_message_medusa_4"	"The snake strikes back."
"dota_chatwheel_label_medusa_4"	"Yılan geri döndü."
"[english]dota_chatwheel_label_medusa_4"	"The snake strikes back."
"dota_chatwheel_message_medusa_5"	"Kimse kimseye bakmıyor!"
"[english]dota_chatwheel_message_medusa_5"	"Nobody look at anybody!"
"dota_chatwheel_label_medusa_5"	"Kimse kimseye bakmıyor!"
"[english]dota_chatwheel_label_medusa_5"	"Nobody look at anybody!"
"dota_chatwheel_message_troll_warlord_1"	"Geri gel ve tekrar öl."
"[english]dota_chatwheel_message_troll_warlord_1"	"Come back and die again."
"dota_chatwheel_label_troll_warlord_1"	"Geri gel..."
"[english]dota_chatwheel_label_troll_warlord_1"	"Come back..."
"dota_chatwheel_message_troll_warlord_2"	"Şaka yapıyor olmalısın."
"[english]dota_chatwheel_message_troll_warlord_2"	"You've got to be kidding."
"dota_chatwheel_label_troll_warlord_2"	"Şaka yapıyor olmalısın."
"[english]dota_chatwheel_label_troll_warlord_2"	"You've gotta be kidding."
"dota_chatwheel_message_troll_warlord_4"	"Bunun olmaması lazım."
"[english]dota_chatwheel_message_troll_warlord_4"	"This can't be happening."
"dota_chatwheel_label_troll_warlord_4"	"Bunun olmaması lazım."
"[english]dota_chatwheel_label_troll_warlord_4"	"This can't be happening."
"dota_chatwheel_message_troll_warlord_5"	"Neden hiç kimse beni sevmiyor?"
"[english]dota_chatwheel_message_troll_warlord_5"	"Why doesn't anybody like me?"
"dota_chatwheel_label_troll_warlord_5"	"Neden hiç kimse beni sevmiyor?"
"[english]dota_chatwheel_label_troll_warlord_5"	"Why doesn't anybody like me?"
"dota_chatwheel_message_centaur_laugh"	"Heheeeh hahah ehha."
"[english]dota_chatwheel_message_centaur_laugh"	"Heheeeh hahah ehha."
"dota_chatwheel_message_centaur_thank"	"Adını onurlandıracağım."
"[english]dota_chatwheel_message_centaur_thank"	"I shall honor your name."
"dota_chatwheel_label_centaur_thank"	"Adını onurlandıracağım."
"[english]dota_chatwheel_label_centaur_thank"	"I shall honor your name."
"dota_chatwheel_message_centaur_3"	"Cehenneme kadar yolun var."
"[english]dota_chatwheel_message_centaur_3"	"Back to hell with you."
"dota_chatwheel_label_centaur_3"	"Cehenneme kadar yolun var."
"[english]dota_chatwheel_label_centaur_3"	"Back to hell with you."
"dota_chatwheel_message_centaur_4"	"Hiç şansın yoktu."
"[english]dota_chatwheel_message_centaur_4"	"You had no chance."
"dota_chatwheel_label_centaur_4"	"Hiç şansın yoktu."
"[english]dota_chatwheel_label_centaur_4"	"You had no chance."
"dota_chatwheel_message_centaur_5"	"Beni yaraladığından daha fazla yaralanıyorsun."
"[english]dota_chatwheel_message_centaur_5"	"Hurts you more than it hurts me."
"dota_chatwheel_label_centaur_5"	"Beni yaraladığından daha fazla yaralanıyorsun."
"[english]dota_chatwheel_label_centaur_5"	"Hurts you more than it hurts me."
"dota_chatwheel_message_magnataur_thank"	"Evet, bu iş görecektir."
"[english]dota_chatwheel_message_magnataur_thank"	"Yes, this will do just fine."
"dota_chatwheel_label_magnataur_thank"	"Bu iş görecektir."
"[english]dota_chatwheel_label_magnataur_thank"	"This will do just fine."
"dota_chatwheel_message_magnataur_1"	"Ha ha ha ha! Ne bekliyordun ki?"
"[english]dota_chatwheel_message_magnataur_1"	"Ha ha ha ha! What did you expect?"
"dota_chatwheel_label_magnataur_1"	"Ne bekliyordun ki?"
"[english]dota_chatwheel_label_magnataur_1"	"What did you expect?"
"dota_chatwheel_message_magnataur_2"	"Benimle dalga mı geçiyorsun?"
"[english]dota_chatwheel_message_magnataur_2"	"Are you kidding me?"
"dota_chatwheel_label_magnataur_2"	"Benimle dalga mı geçiyorsun?"
"[english]dota_chatwheel_label_magnataur_2"	"Are you kidding me?"
"dota_chatwheel_message_magnataur_3"	"Hepsi bir günlük iş."
"[english]dota_chatwheel_message_magnataur_3"	"All in a day's work."
"dota_chatwheel_label_magnataur_3"	"Hepsi bir günlük iş."
"[english]dota_chatwheel_label_magnataur_3"	"All in a day's work."
"dota_chatwheel_message_magnataur_5"	"Bak ne diyeceğim. Sen benim boynuzuma dokun ben de senin yüzünü dağıtayım."
"[english]dota_chatwheel_message_magnataur_5"	"I tell you what. You touch my horn, I break your face."
"dota_chatwheel_label_magnataur_5"	"Boynuzuma dokun, yüzünü dağıtayım."
"[english]dota_chatwheel_label_magnataur_5"	"Touch my horn, break your face."
"dota_chatwheel_message_shredder_thank"	"Sana neredeyse güveniyordum."
"[english]dota_chatwheel_message_shredder_thank"	"I almost trust you."
"dota_chatwheel_label_shredder_thank"	"Sana neredeyse güveniyordum."
"[english]dota_chatwheel_label_shredder_thank"	"I almost trust you."
"dota_chatwheel_message_shredder_deny"	"Kızdın mı? Çünkü ben kızdım!"
"[english]dota_chatwheel_message_shredder_deny"	"You mad? Cuz I am!"
"dota_chatwheel_label_shredder_deny"	"Kızdın mı?"
"[english]dota_chatwheel_label_shredder_deny"	"You mad?"
"dota_chatwheel_label_skywrath_mage_3"	"Onurlu bir şekilde yapıldı!"
"[english]dota_chatwheel_label_skywrath_mage_3"	"Twas honorably done!"
"dota_chatwheel_message_skywrath_mage_4"	"Dehşetli Tepe'den dünyanın sonunun geldiğini görebiliyorum ve bu bakış açısından, bunun çantada keklik olduğuna eminim!"
"[english]dota_chatwheel_message_skywrath_mage_4"	"From the Ghastly Eyrie I can see to the ends of the world, and from this vantage point I declare with utter certainty that this one is in the bag!"
"dota_chatwheel_label_skywrath_mage_4"	"Dehşetli Tepe'den..."
"[english]dota_chatwheel_label_skywrath_mage_4"	"From the Ghastly Eyrie..."
"dota_chatwheel_message_skywrath_mage_5"	"Gökler, Skywrath'ın gücüyle karanlığa boyandı!"
"[english]dota_chatwheel_message_skywrath_mage_5"	"The skies are dark with Skywrath power!"
"dota_chatwheel_label_skywrath_mage_5"	"Gökler, Skywrath'ın gücüyle karanlığa boyandı!"
"[english]dota_chatwheel_label_skywrath_mage_5"	"The skies are dark with Skywrath power!"
"dota_chatwheel_message_abaddon_laugh"	"Ha ha ha ha ha ha ha ha ha."
"[english]dota_chatwheel_message_abaddon_laugh"	"Ha ha ha ha ha ha ha ha ha."
"dota_chatwheel_message_abaddon_thank"	"Avernus'un Kamarası bunun için beni reddedecek."
"[english]dota_chatwheel_message_abaddon_thank"	"The House Avernus will disown me for that."
"dota_chatwheel_label_abaddon_thank"	"Reddedileceğim."
"[english]dota_chatwheel_label_abaddon_thank"	"I will be disowned."
"dota_chatwheel_message_abaddon_1"	"Lordunun karşısında diz çök."
"[english]dota_chatwheel_message_abaddon_1"	"Bow to your lord."
"dota_chatwheel_label_abaddon_1"	"Lordunun karşısında diz çök."
"[english]dota_chatwheel_label_abaddon_1"	"Bow to your lord."
"dota_chatwheel_message_abaddon_2"	"Böyle bir şey nasıl olabilir?"
"[english]dota_chatwheel_message_abaddon_2"	"How can such a thing be?"
"dota_chatwheel_label_abaddon_2"	"Böyle bir şey..."
"[english]dota_chatwheel_label_abaddon_2"	"How can such..."
"dota_chatwheel_message_abaddon_3"	"Zamanın sislerinde sen bir bulanıklıksın."
"[english]dota_chatwheel_message_abaddon_3"	"In the mists of time you are but a blur."
"dota_chatwheel_label_abaddon_3"	"Zamanın sislerinde..."
"[english]dota_chatwheel_label_abaddon_3"	"In the mists of time..."
"dota_chatwheel_message_abaddon_4"	"Burada ne hakla bulunuyorsun?"
"[english]dota_chatwheel_message_abaddon_4"	"By what right do you tread here?"
"dota_chatwheel_label_abaddon_4"	"Ne hakla.."
"[english]dota_chatwheel_label_abaddon_4"	"By what right..."
"dota_chatwheel_message_abaddon_5"	"Savaşın sisi kaderin sisiyle boy ölçüşemez."
"[english]dota_chatwheel_message_abaddon_5"	"The fog of war is no match for the mist of fate."
"dota_chatwheel_message_elder_titan_laugh"	"Eh ha ha ha ha ha."
"[english]dota_chatwheel_message_elder_titan_laugh"	"Eh ha ha ha ha ha."
"dota_chatwheel_message_elder_titan_thank"	"Şimdi savaş lehimize dönecek."
"[english]dota_chatwheel_message_elder_titan_thank"	"Now shall the battle turn."
"dota_chatwheel_label_elder_titan_thank"	"Şimdi savaş lehimize dönecek."
"[english]dota_chatwheel_label_elder_titan_thank"	"Now shall the battle turn."
"dota_chatwheel_message_elder_titan_deny"	"Titan hayır diyor."
"[english]dota_chatwheel_message_elder_titan_deny"	"The Titan says no."
"dota_chatwheel_label_elder_titan_deny"	"Titan hayır diyor."
"[english]dota_chatwheel_label_elder_titan_deny"	"The Titan says no."
"dota_chatwheel_message_elder_titan_1"	"Yolumdan çekil!"
"[english]dota_chatwheel_message_elder_titan_1"	"Get off my lawn!"
"dota_chatwheel_label_elder_titan_1"	"Yolumdan çekil."
"[english]dota_chatwheel_label_elder_titan_1"	"Get off my lawn."
"dota_chatwheel_message_elder_titan_2"	"Ben şimdi ne yaptım?"
"[english]dota_chatwheel_message_elder_titan_2"	"What have I done now?"
"dota_chatwheel_label_elder_titan_2"	"Ben şimdi ne yaptım?"
"[english]dota_chatwheel_label_elder_titan_2"	"What have I done now?"
"dota_chatwheel_message_elder_titan_3"	"Bu iyiye işaret."
"[english]dota_chatwheel_message_elder_titan_3"	"This bodes well."
"dota_chatwheel_label_elder_titan_3"	"Bu iyiye işaret."
"[english]dota_chatwheel_label_elder_titan_3"	"This bodes well."
"dota_chatwheel_message_elder_titan_4"	"Acınası bir girişim."
"[english]dota_chatwheel_message_elder_titan_4"	"A pitiable attempt."
"dota_chatwheel_label_elder_titan_4"	"Acınası bir girişim."
"[english]dota_chatwheel_label_elder_titan_4"	"A pitiable attempt."
"dota_chatwheel_message_elder_titan_5"	"Büyüklerine saygılı davranmayı öğrenmelisin."
"[english]dota_chatwheel_message_elder_titan_5"	"You must learn respect for your elders."
"dota_chatwheel_label_elder_titan_5"	"Büyüklerine saygılı davranmayı..."
"[english]dota_chatwheel_label_elder_titan_5"	"You must learn respect..."
"dota_chatwheel_message_legion_commander_laugh"	"Ah ha ha ha ha ha ha!"
"[english]dota_chatwheel_message_legion_commander_laugh"	"Ah ha ha ha ha ha ha!"
"dota_chatwheel_message_legion_commander_deny"	"Daha çok çaba göster."
"[english]dota_chatwheel_message_legion_commander_deny"	"Try harder."
"dota_chatwheel_message_legion_commander_5"	"Bu pek ani oldu!"
"[english]dota_chatwheel_message_legion_commander_5"	"That escalated quickly!"
"dota_chatwheel_label_legion_commander_5"	"Bu pek ani oldu."
"[english]dota_chatwheel_label_legion_commander_5"	"That escalated quickly."
"dota_chatwheel_message_techies_laugh"	"He he he, hehe ah ha! Oh ho ho oh oh ha ha ha!"
"[english]dota_chatwheel_message_techies_laugh"	"He he he, hehe ah ha! Oh ho ho oh oh ha ha ha!"
"dota_chatwheel_message_techies_deny"	"Bir mantar bulutu olacağını söylemiştim!"
"[english]dota_chatwheel_message_techies_deny"	"I was told there'd be a mushroom cloud!"
"dota_chatwheel_message_techies_2"	"Nereye gidebilir ki? Her yere!"
"[english]dota_chatwheel_message_techies_2"	"Where'd he go? Everywhere!"
"dota_chatwheel_label_techies_2"	"Nereye gidebilir ki? Her yere!"
"[english]dota_chatwheel_label_techies_2"	"Where'd he go? Everywhere!"
"dota_chatwheel_message_techies_4"	"Geç kenara otur. Bırak da akıllı kişiler işlerini yapsın."
"[english]dota_chatwheel_message_techies_4"	"Just have a seat right over there. And let the smart people work."
"dota_chatwheel_label_techies_4"	"Bir otursana."
"[english]dota_chatwheel_label_techies_4"	"Have a seat."
"dota_chatwheel_message_techies_5"	"Bunun işe yaradığına inanamıyorum."
"[english]dota_chatwheel_message_techies_5"	"I can't believe that worked."
"dota_chatwheel_label_techies_5"	"Bunun işe yaradığına inanamıyorum."
"[english]dota_chatwheel_label_techies_5"	"I can't believe that worked."
"dota_chatwheel_message_ember_spirit_laugh"	"Eh he he he he he!"
"[english]dota_chatwheel_message_ember_spirit_laugh"	"Eh he he he he he!"
"dota_chatwheel_message_ember_spirit_thank"	"Bir ilham kaynağı!"
"[english]dota_chatwheel_message_ember_spirit_thank"	"A flash of inspiration!"
"dota_chatwheel_label_ember_spirit_thank"	"Bir ilham kaynağı!"
"[english]dota_chatwheel_label_ember_spirit_thank"	"A flash of inspiration!"
"dota_chatwheel_message_ember_spirit_deny"	"Bu ödül beklediğimden de güzel!"
"[english]dota_chatwheel_message_ember_spirit_deny"	"This reward transcends expectation!"
"dota_chatwheel_label_ember_spirit_deny"	"Bu ödül beklediğimden de güzel!"
"[english]dota_chatwheel_label_ember_spirit_deny"	"This reward transcends expectation!"
"dota_chatwheel_message_ember_spirit_1"	"Bir ders için hazırlanın."
"[english]dota_chatwheel_message_ember_spirit_1"	"Prepare for a lesson."
"dota_chatwheel_label_ember_spirit_1"	"Bir ders için hazırlanın."
"[english]dota_chatwheel_label_ember_spirit_1"	"Prepare for a lesson."
"dota_chatwheel_message_ember_spirit_2"	"Ne öğrendiniz?"
"[english]dota_chatwheel_message_ember_spirit_2"	"What did you learn?"
"dota_chatwheel_label_ember_spirit_2"	"Ne öğrendiniz?"
"[english]dota_chatwheel_label_ember_spirit_2"	"What did you learn?"
"dota_chatwheel_message_ember_spirit_3"	"Bu zor bir ders."
"[english]dota_chatwheel_message_ember_spirit_3"	"Balance in all things."
"dota_chatwheel_label_ember_spirit_3"	"Bu zor bir ders."
"[english]dota_chatwheel_label_ember_spirit_3"	"Balance in all things."
"dota_chatwheel_message_ember_spirit_4"	"Daha fazla öğretecek bir şey yok."
"[english]dota_chatwheel_message_ember_spirit_4"	"Nothing more to teach."
"dota_chatwheel_label_ember_spirit_4"	"Daha fazla öğretecek şey yok"
"[english]dota_chatwheel_label_ember_spirit_4"	"Nothing more to teach"
"dota_chatwheel_message_ember_spirit_5"	"Bir usta bile bocalayabilir."
"[english]dota_chatwheel_message_ember_spirit_5"	"Even a master falters."
"dota_chatwheel_label_ember_spirit_5"	"Bir usta bile bocalayabilir."
"[english]dota_chatwheel_label_ember_spirit_5"	"Even a master falters."
"dota_chatwheel_message_earth_spirit_laugh"	"Oh ho ho ha ha ha ha ha ha!"
"[english]dota_chatwheel_message_earth_spirit_laugh"	"Oh ho ho ha ha ha ha ha ha!"
"dota_chatwheel_message_earth_spirit_thank"	"Taş gibisin."
"[english]dota_chatwheel_message_earth_spirit_thank"	"You rock."
"dota_chatwheel_label_earth_spirit_thank"	"Taş gibisin."
"[english]dota_chatwheel_label_earth_spirit_thank"	"You rock."
"dota_chatwheel_message_earth_spirit_deny"	"Evet, ben de öyle yaptım."
"[english]dota_chatwheel_message_earth_spirit_deny"	"Yes, I just did that."
"dota_chatwheel_label_earth_spirit_deny"	"Evet, ben de öyle yaptım."
"[english]dota_chatwheel_label_earth_spirit_deny"	"Yes, I just did that."
"dota_chatwheel_message_abyssal_underlord_laugh"	"Ah ha ha ha ha ha ha ha ha!"
"[english]dota_chatwheel_message_abyssal_underlord_laugh"	"Ah ha ha ha ha ha ha ha ha!"
"dota_chatwheel_message_abyssal_underlord_3"	"Yeni lordunun karşısında diz çok."
"[english]dota_chatwheel_message_abyssal_underlord_3"	"Bow to your new lord."
"dota_chatwheel_label_abyssal_underlord_3"	"Yeni lordunun karşısında diz çok."
"[english]dota_chatwheel_label_abyssal_underlord_3"	"Bow to your new lord."
"dota_chatwheel_message_abyssal_underlord_4"	"Hiç umut kalmadı."
"[english]dota_chatwheel_message_abyssal_underlord_4"	"There is no hope."
"dota_chatwheel_label_abyssal_underlord_4"	"Hiç umut kalmadı."
"[english]dota_chatwheel_label_abyssal_underlord_4"	"There is no hope."
"dota_chatwheel_message_abyssal_underlord_5"	"Sıkı tutunun."
"[english]dota_chatwheel_message_abyssal_underlord_5"	"Hold on to your butts."
"dota_chatwheel_label_abyssal_underlord_5"	"Sıkı tutunun!"
"[english]dota_chatwheel_label_abyssal_underlord_5"	"Hold on!"
"dota_chatwheel_message_terrorblade_thank"	"Ne yakışıklı bir iblis."
"[english]dota_chatwheel_message_terrorblade_thank"	"What a handsome devil."
"dota_chatwheel_label_terrorblade_thank"	"Ne yakışıklı bir iblis."
"[english]dota_chatwheel_label_terrorblade_thank"	"What a handsome devil."
"dota_chatwheel_message_terrorblade_deny"	"Oh, bu yüzden benden nefret edecekler"
"[english]dota_chatwheel_message_terrorblade_deny"	"Oh, they're gonna hate me for this."
"dota_chatwheel_label_terrorblade_deny"	"Bu yüzden benden nefret edecekler."
"[english]dota_chatwheel_label_terrorblade_deny"	"They're gonna hate me for this."
"dota_chatwheel_message_terrorblade_1"	"Ticaret hilesi."
"[english]dota_chatwheel_message_terrorblade_1"	"Trick of the trade."
"dota_chatwheel_label_terrorblade_1"	"Ticaret hilesi."
"[english]dota_chatwheel_label_terrorblade_1"	"Trick of the trade."
"dota_chatwheel_message_terrorblade_2"	"En kötü düşmanınız."
"[english]dota_chatwheel_message_terrorblade_2"	"Your own worst enemy."
"dota_chatwheel_label_terrorblade_2"	"Kendi baş düşmanınsın."
"[english]dota_chatwheel_label_terrorblade_2"	"Your own worst enemy."
"dota_chatwheel_message_terrorblade_3"	"Belki bu akılıca değildi."
"[english]dota_chatwheel_message_terrorblade_3"	"Perhaps that wasn't wise."
"dota_chatwheel_label_terrorblade_3"	"Belki bu akılıca değildi."
"[english]dota_chatwheel_label_terrorblade_3"	"Perhaps that wasn't wise."
"dota_chatwheel_message_terrorblade_4"	"Bilge bir bıçak bir aptalın hayatını alır."
"[english]dota_chatwheel_message_terrorblade_4"	"A wise blade takes a fool's life."
"dota_chatwheel_label_terrorblade_4"	"Bilge bıçak."
"[english]dota_chatwheel_label_terrorblade_4"	"Wise blade."
"dota_chatwheel_message_terrorblade_5"	"Dövüşün benimle, korkaklar!"
"[english]dota_chatwheel_message_terrorblade_5"	"Fight me, cowards!"
"dota_chatwheel_label_terrorblade_5"	"Dövüş benimle!"
"[english]dota_chatwheel_label_terrorblade_5"	"Fight me!"
"dota_chatwheel_message_oracle_laugh"	"He ha ha he ha ha!"
"[english]dota_chatwheel_message_oracle_laugh"	"He ha ha he ha ha!"
"dota_chatwheel_message_oracle_thank"	"Kadere inanç tazelendi."
"[english]dota_chatwheel_message_oracle_thank"	"Faith in fate restored."
"dota_chatwheel_label_oracle_thank"	"Kadere inanç tazelendi."
"[english]dota_chatwheel_label_oracle_thank"	"Faith in fate restored."
"dota_chatwheel_message_oracle_deny"	"Ölmek istiyorum."
"[english]dota_chatwheel_message_oracle_deny"	"I want to die."
"dota_chatwheel_label_oracle_deny"	"Ölmek istiyorum."
"[english]dota_chatwheel_label_oracle_deny"	"I want to die."
"dota_chatwheel_message_oracle_1"	"Onu gördüm."
"[english]dota_chatwheel_message_oracle_1"	"I saw that."
"dota_chatwheel_label_oracle_1"	"Onu gördüm."
"[english]dota_chatwheel_label_oracle_1"	"I saw that."
"dota_chatwheel_message_oracle_2"	"Şoke oldum. Şoke!"
"[english]dota_chatwheel_message_oracle_2"	"I am shocked. Shocked!"
"dota_chatwheel_label_oracle_2"	"Şoke oldum."
"[english]dota_chatwheel_label_oracle_2"	"I am shocked."
"dota_chatwheel_message_oracle_3"	"Bu gerçekten tuhaftı!"
"[english]dota_chatwheel_message_oracle_3"	"That was odd indeed!"
"dota_chatwheel_label_oracle_3"	"Bu gerçekten tuhaftı!"
"[english]dota_chatwheel_label_oracle_3"	"That was odd indeed!"
"dota_chatwheel_message_oracle_4"	"Bunun geldiğini senin bile görmen gerekirdi. Ama görmedin."
"[english]dota_chatwheel_message_oracle_4"	"Even you should've seen that coming. But you didn't."
"dota_chatwheel_label_oracle_4"	"Bunun geldiğini senin bile görmen gerekirdi"
"[english]dota_chatwheel_label_oracle_4"	"You should've seen that coming."
"dota_chatwheel_message_oracle_5"	"Bir ev yangınında öleceksin."
"[english]dota_chatwheel_message_oracle_5"	"You will die in a house fire."
"dota_chatwheel_label_oracle_5"	"Bir ev yangınında öleceksin."
"[english]dota_chatwheel_label_oracle_5"	"You will die in a house fire."
"dota_chatwheel_message_arc_warden_laugh"	"Hm hm hm hm hm hm hm hm hm hm hm hm hm hm hm."
"[english]dota_chatwheel_message_arc_warden_laugh"	"Hm hm hm hm hm hm hm hm hm hm hm hm hm hm hm."
"dota_chatwheel_message_arc_warden_thank"	"Nezaketiniz dikkate alındı."
"[english]dota_chatwheel_message_arc_warden_thank"	"Your grace is noted."
"dota_chatwheel_label_arc_warden_thank"	"Nezaketiniz dikkate alındı."
"[english]dota_chatwheel_label_arc_warden_thank"	"Your grace is noted."
"dota_chatwheel_message_arc_warden_deny"	"Bencil olma."
"[english]dota_chatwheel_message_arc_warden_deny"	"Do not be selfish."
"dota_chatwheel_label_arc_warden_deny"	"Bencil olma."
"[english]dota_chatwheel_label_arc_warden_deny"	"Do not be selfish."
"dota_chatwheel_message_arc_warden_2"	"Ne yaptın?"
"[english]dota_chatwheel_message_arc_warden_2"	"What have you done?"
"dota_chatwheel_label_arc_warden_2"	"Ne yaptın?"
"[english]dota_chatwheel_label_arc_warden_2"	"What have you done?"
"dota_chatwheel_message_arc_warden_3"	"Mutlak bir şaşırtma."
"[english]dota_chatwheel_message_arc_warden_3"	"A mere diversion."
"dota_chatwheel_label_arc_warden_3"	"Mutlak bir şaşırtma."
"[english]dota_chatwheel_label_arc_warden_3"	"A mere diversion."
"dota_chatwheel_message_arc_warden_4"	"Çatık surat."
"[english]dota_chatwheel_message_arc_warden_4"	"Frowny face."
"dota_chatwheel_label_arc_warden_4"	"Çatık surat."
"[english]dota_chatwheel_label_arc_warden_4"	"Frowny face."
"dota_chatwheel_message_arc_warden_5"	"Kızgın olmana gerek yok."
"[english]dota_chatwheel_message_arc_warden_5"	"You do not have to be mad."
"dota_chatwheel_label_arc_warden_5"	"Kızgın olmana gerek yok."
"[english]dota_chatwheel_label_arc_warden_5"	"You do not have to be mad."
"dota_chatwheel_message_winter_wyvern_laugh"	"Ah ha ha ha ha ha ha ha ha ha ha!"
"[english]dota_chatwheel_message_winter_wyvern_laugh"	"Ah ha ha ha ha ha ha ha ha ha ha!"
"dota_chatwheel_message_winter_wyvern_thank"	"Harikulade!"
"[english]dota_chatwheel_message_winter_wyvern_thank"	"Wonderful!"
"dota_chatwheel_label_winter_wyvern_thank"	"Harikulade."
"[english]dota_chatwheel_label_winter_wyvern_thank"	"Wonderful."
"dota_chatwheel_message_winter_wyvern_deny"	"Sakin ol bebeğim."
"[english]dota_chatwheel_message_winter_wyvern_deny"	"Chill, baby."
"dota_chatwheel_label_winter_wyvern_deny"	"Sakin ol bebeğim."
"[english]dota_chatwheel_label_winter_wyvern_deny"	"Chill, baby."
"dota_chatwheel_message_winter_wyvern_1"	"Bu pek akıllıca değildi!"
"[english]dota_chatwheel_message_winter_wyvern_1"	"That was not wise!"
"dota_chatwheel_label_winter_wyvern_1"	"Bu pek akıllıca değildi."
"[english]dota_chatwheel_label_winter_wyvern_1"	"That was not wise."
"dota_chatwheel_message_winter_wyvern_2"	"Zavallım."
"[english]dota_chatwheel_message_winter_wyvern_2"	"Poor dear."
"dota_chatwheel_label_winter_wyvern_2"	"Zavallım."
"[english]dota_chatwheel_label_winter_wyvern_2"	"Poor dear."
"dota_chatwheel_message_winter_wyvern_3"	"Bir Wyvern'e asla neden diye sorma."
"[english]dota_chatwheel_message_winter_wyvern_3"	"Never ask a wyvern why."
"dota_chatwheel_label_winter_wyvern_3"	"Bir Wyvern'e asla neden diye sorma."
"[english]dota_chatwheel_label_winter_wyvern_3"	"Never ask a wyvern why."
"dota_chatwheel_message_winter_wyvern_4"	"İyi hak ettin!"
"[english]dota_chatwheel_message_winter_wyvern_4"	"Well deserved!"
"dota_chatwheel_label_winter_wyvern_4"	"İyi hak ettin."
"[english]dota_chatwheel_label_winter_wyvern_4"	"Well deserved."
"dota_chatwheel_message_winter_wyvern_5"	"Ah, hiç bu kadar iyi hissetmemiştim! Ah ha ha ha ha!"
"[english]dota_chatwheel_message_winter_wyvern_5"	"Ah, I've never felt this good! Ah ha ha ha ha!"
"dota_chatwheel_label_winter_wyvern_5"	"Hiç bu kadar iyi hissetmemiştim!"
"[english]dota_chatwheel_label_winter_wyvern_5"	"Never felt this good!"
"dota_chatwheel_message_monkey_king_laugh"	"Ah ha ha ha ha ha. Voohoohoohoo. Ohhh heee."
"[english]dota_chatwheel_message_monkey_king_laugh"	"Ah ha ha ha ha ha. Woohoohoohoo. Ohhh heee."
"dota_chatwheel_message_monkey_king_thank"	"Bu iş görür."
"[english]dota_chatwheel_message_monkey_king_thank"	"This'll work."
"dota_chatwheel_label_monkey_king_thank"	"Bu iş görür."
"[english]dota_chatwheel_label_monkey_king_thank"	"This'll work."
"dota_chatwheel_message_monkey_king_deny"	"Şimdiden daha iyi hissediyorum."
"[english]dota_chatwheel_message_monkey_king_deny"	"I feel better already."
"dota_chatwheel_label_monkey_king_deny"	"Şimdiden daha iyi hissediyorum."
"[english]dota_chatwheel_label_monkey_king_deny"	"I feel better already."
"dota_chatwheel_message_monkey_king_1"	"Ohh, önden imzaları atacağım."
"[english]dota_chatwheel_message_monkey_king_1"	"Ohh, I'll be signing autographs out front."
"dota_chatwheel_message_monkey_king_2"	"Tamam, bunu beklemiyordum."
"[english]dota_chatwheel_message_monkey_king_2"	"Ok, that was unexpected."
"dota_chatwheel_label_monkey_king_2"	"Tamam, bunu beklemiyordum.."
"[english]dota_chatwheel_label_monkey_king_2"	"Ok, that was unexpected.."
"dota_chatwheel_message_monkey_king_4"	"Bundan zevk almıyormuş gibi davranacağım."
"[english]dota_chatwheel_message_monkey_king_4"	"I'll pretend I didn't enjoy this."
"dota_chatwheel_label_monkey_king_4"	"Bundan zevk almıyormuş gibi davranacağım."
"[english]dota_chatwheel_label_monkey_king_4"	"I'll pretend I didn't enjoy this."
"dota_chatwheel_message_monkey_king_5"	"Bu başlamadan önce zaten bitmişti."
"[english]dota_chatwheel_message_monkey_king_5"	"This was over before it started."
"dota_chatwheel_label_monkey_king_5"	"Başlamadan önce bitmişti."
"[english]dota_chatwheel_label_monkey_king_5"	"Over before it started."
"dota_chatwheel_message_dark_willow_laugh"	"Hahaha ahaha ahaha ahhahahahahaa!"
"[english]dota_chatwheel_message_dark_willow_laugh"	"Hahaha ahaha ahaha ahhahahahahaa!"
"dota_chatwheel_message_dark_willow_thank"	"Ben de tam bunu bekliyordum."
"[english]dota_chatwheel_message_dark_willow_thank"	"Just what I was waiting for."
"dota_chatwheel_label_dark_willow_thank"	"Ben de tam bunu bekliyordum."
"[english]dota_chatwheel_label_dark_willow_thank"	"Just what I was waiting for."
"dota_chatwheel_message_dark_willow_deny"	"Yalan söylemeyeceğim, bunu beklemiyordum..."
"[english]dota_chatwheel_message_dark_willow_deny"	"I won't lie, that was unexpected..."
"dota_chatwheel_label_dark_willow_deny"	"Bunu beklemiyordum"
"[english]dota_chatwheel_label_dark_willow_deny"	"That was unexpected"
"dota_chatwheel_message_dark_willow_1"	"Hayır. Sadece... hayır."
"[english]dota_chatwheel_message_dark_willow_1"	"No. Just... no."
"dota_chatwheel_label_dark_willow_1"	"Hayır. Sadece... hayır."
"[english]dota_chatwheel_label_dark_willow_1"	"No. Just... no."
"dota_chatwheel_message_dark_willow_2"	"Hiç şansın yok..."
"[english]dota_chatwheel_message_dark_willow_2"	"Never had a chance..."
"dota_chatwheel_label_dark_willow_2"	"Hiç şansın yok."
"[english]dota_chatwheel_label_dark_willow_2"	"Never had a chance."
"dota_chatwheel_message_dark_willow_3"	"Oh-ho. Bana aldırma. Sadece küçücük bir peri kendi işiyle ilgileniyor."
"[english]dota_chatwheel_message_dark_willow_3"	"Oh-ho. Don't mind me. Just a wee fairy going about her business."
"dota_chatwheel_label_dark_willow_3"	"Bana aldırma."
"[english]dota_chatwheel_label_dark_willow_3"	"Don't mind me."
"dota_chatwheel_message_dark_willow_4"	"Ne umduğumu ben de bilmiyorum."
"[english]dota_chatwheel_message_dark_willow_4"	"I don't know what I was expecting."
"dota_chatwheel_label_dark_willow_4"	"Ne umduğumu ben de bilmiyorum."
"[english]dota_chatwheel_label_dark_willow_4"	"Don't know what I was expecting."
"dota_chatwheel_message_dark_willow_5"	"Bunun hiçbir anlamı yok."
"[english]dota_chatwheel_message_dark_willow_5"	"This makes absolutely no sense."
"dota_chatwheel_label_dark_willow_5"	"Hiçbir anlamı yok."
"[english]dota_chatwheel_label_dark_willow_5"	"Makes no sense."
"dota_chatwheel_message_pangolier_laugh"	"Aaaah ha hahahaha hahahaaa huu."
"[english]dota_chatwheel_message_pangolier_laugh"	"Aaaah ha hahahaha hahahaaa huu."
"dota_chatwheel_message_pangolier_thank"	"Bu kasti miydi? Bana kasti gibi geldi."
"[english]dota_chatwheel_message_pangolier_thank"	"Was that intentional? It looked intentional."
"dota_chatwheel_label_pangolier_thank"	"Kasti miydi bu?"
"[english]dota_chatwheel_label_pangolier_thank"	"Was that intentional?"
"dota_chatwheel_label_pangolier_deny"	"İşte böyle yapılır."
"[english]dota_chatwheel_label_pangolier_deny"	"How it's done."
"dota_chatwheel_message_pangolier_1"	"Bir sonrakine daha çok çaba göster..."
"[english]dota_chatwheel_message_pangolier_1"	"Try a bit harder next time..."
"dota_chatwheel_label_pangolier_1"	"Daha Çok Çaba Göster"
"[english]dota_chatwheel_label_pangolier_1"	"Try Harder"
"dota_chatwheel_message_pangolier_2"	"Bu iyi görünmüyor."
"[english]dota_chatwheel_message_pangolier_2"	"That does not look good."
"dota_chatwheel_label_pangolier_2"	"İyi görünmüyor"
"[english]dota_chatwheel_label_pangolier_2"	"Not look good"
"dota_chatwheel_message_pangolier_3"	"Bip Bip!"
"[english]dota_chatwheel_message_pangolier_3"	"Beep Beep!"
"dota_chatwheel_label_pangolier_3"	"Bip Bip!"
"[english]dota_chatwheel_label_pangolier_3"	"Beep Beep!"
"dota_chatwheel_message_pangolier_4"	"Eh şimdi bu haksızlık."
"[english]dota_chatwheel_message_pangolier_4"	"Now it's just unfair."
"dota_chatwheel_label_pangolier_4"	"Eh şimdi bu haksızlık."
"[english]dota_chatwheel_label_pangolier_4"	"Now it's just unfair."
"dota_chatwheel_message_pangolier_5"	"Yani bütün bu karmaşa tamamen senin suçun mu?"
"[english]dota_chatwheel_message_pangolier_5"	"So this whole mess is all your fault?"
"dota_chatwheel_label_pangolier_5"	"Tamamen senin suçun mu?"
"[english]dota_chatwheel_label_pangolier_5"	"All your fault?"
}
