"hero_chat_wheel"
{
"dota_chatwheel_message_ancient_apparition_laugh"	"음흐흐흐흐흐흐하하하하하하!"
"[english]dota_chatwheel_message_ancient_apparition_laugh"	"Hm hm hm ha ha ha ha ha ha ha!"
"dota_chatwheel_label_ancient_apparition_laugh"	"웃음"
"[english]dota_chatwheel_label_ancient_apparition_laugh"	"Laugh"
"dota_chatwheel_message_ancient_apparition_thank"	"흥미롭군."
"[english]dota_chatwheel_message_ancient_apparition_thank"	"Interesting."
"dota_chatwheel_label_ancient_apparition_thank"	"흥미롭군."
"[english]dota_chatwheel_label_ancient_apparition_thank"	"Interesting."
"dota_chatwheel_message_ancient_apparition_deny"	"차가운 바람이 불어오는군."
"[english]dota_chatwheel_message_ancient_apparition_deny"	"A cold wind blows."
"dota_chatwheel_label_ancient_apparition_deny"	"차가운 바람이 불어오는군."
"[english]dota_chatwheel_label_ancient_apparition_deny"	"A cold wind blows."
"dota_chatwheel_message_ancient_apparition_1"	"네 피도 얼어붙었구나."
"[english]dota_chatwheel_message_ancient_apparition_1"	"Your blood runs cold."
"dota_chatwheel_label_ancient_apparition_1"	"네 피도 얼어붙었구나."
"[english]dota_chatwheel_label_ancient_apparition_1"	"Your blood runs cold."
"dota_chatwheel_message_ancient_apparition_2"	"너무 늙은 것인가!"
"[english]dota_chatwheel_message_ancient_apparition_2"	"I'm too old for this!"
"dota_chatwheel_label_ancient_apparition_2"	"너무 늙은 것인가."
"[english]dota_chatwheel_label_ancient_apparition_2"	"I'm too old for this."
"dota_chatwheel_message_ancient_apparition_3"	"오랜 기다림이 보상받는구나."
"[english]dota_chatwheel_message_ancient_apparition_3"	"I waited ages but it was worth it."
"dota_chatwheel_label_ancient_apparition_3"	"오랜 기다림이..."
"[english]dota_chatwheel_label_ancient_apparition_3"	"I waited ages..."
"dota_chatwheel_message_ancient_apparition_4"	"얼음의 세상이 펼쳐지리라!"
"[english]dota_chatwheel_message_ancient_apparition_4"	"Time to break the ice!"
"dota_chatwheel_label_ancient_apparition_4"	"얼음의 세상."
"[english]dota_chatwheel_label_ancient_apparition_4"	"Break the ice."
"dota_chatwheel_message_ancient_apparition_5"	"얼음의 안개가 서리는구나!"
"[english]dota_chatwheel_message_ancient_apparition_5"	"Icefog!"
"dota_chatwheel_label_ancient_apparition_5"	"얼음의 안개가 서리는구나!"
"[english]dota_chatwheel_label_ancient_apparition_5"	"Icefog!"
"dota_chatwheel_message_alchemist_laugh"	"브하하하하하!"
"[english]dota_chatwheel_message_alchemist_laugh"	"Ha ha ha ha ha!"
"dota_chatwheel_label_alchemist_laugh"	"웃음"
"[english]dota_chatwheel_label_alchemist_laugh"	"Laugh"
"dota_chatwheel_message_alchemist_thank"	"우린 환상의 짝꿍이야."
"[english]dota_chatwheel_message_alchemist_thank"	"We've got pretty good chemistry."
"dota_chatwheel_label_alchemist_thank"	"환상의 짝꿍!"
"[english]dota_chatwheel_label_alchemist_thank"	"Good chemistry!"
"dota_chatwheel_message_alchemist_deny"	"천잰데!"
"[english]dota_chatwheel_message_alchemist_deny"	"That was genius!"
"dota_chatwheel_label_alchemist_deny"	"천잰데!"
"[english]dota_chatwheel_label_alchemist_deny"	"That was genius!"
"dota_chatwheel_message_alchemist_1"	"이봐, 여기야!"
"[english]dota_chatwheel_message_alchemist_1"	"Hey, everybody!"
"dota_chatwheel_label_alchemist_1"	"이봐, 여기야."
"[english]dota_chatwheel_label_alchemist_1"	"Hey everybody."
"dota_chatwheel_message_alchemist_2"	"과민반응이 따로 없군."
"[english]dota_chatwheel_message_alchemist_2"	"Talk about overreacting."
"dota_chatwheel_label_alchemist_2"	"과민반응이 따로 없군."
"[english]dota_chatwheel_label_alchemist_2"	"Talk about overreacting."
"dota_chatwheel_message_alchemist_3"	"보고도 못 믿을 광경이야!"
"[english]dota_chatwheel_message_alchemist_3"	"I can't believe I'm seeing this with my own eyes!"
"dota_chatwheel_label_alchemist_3"	"보고도 못 믿을 광경이야."
"[english]dota_chatwheel_label_alchemist_3"	"Can't believe I'm seeing this."
"dota_chatwheel_message_alchemist_4"	"이런, 엉망진창이야!"
"[english]dota_chatwheel_message_alchemist_4"	"What a mess!"
"dota_chatwheel_label_alchemist_4"	"이런, 엉망진창이야!"
"[english]dota_chatwheel_label_alchemist_4"	"What a mess!"
"dota_chatwheel_message_alchemist_5"	"실수는 성공의 어머니야. 물론 다 좋은 어머니만 있는 건 아니지만."
"[english]dota_chatwheel_message_alchemist_5"	"Failure is just another kind of success. The wrong kind."
"dota_chatwheel_label_alchemist_5"	"실패는 성공의 어머니!"
"[english]dota_chatwheel_label_alchemist_5"	"Wrong kind of success!"
"dota_chatwheel_message_abaddon_laugh"	"아하하하하하하."
"[english]dota_chatwheel_message_abaddon_laugh"	"Ha ha ha ha ha ha ha ha ha."
"dota_chatwheel_label_abaddon_laugh"	"웃음"
"[english]dota_chatwheel_label_abaddon_laugh"	"Laugh"
"dota_chatwheel_message_abaddon_thank"	"아베르누스가에서 날 내치겠구나."
"[english]dota_chatwheel_message_abaddon_thank"	"The House Avernus will disown me for that."
"dota_chatwheel_label_abaddon_thank"	"가문에서 내쳐지겠구나."
"[english]dota_chatwheel_label_abaddon_thank"	"I will be disowned."
"dota_chatwheel_message_abaddon_deny"	"안 될 일이지."
"[english]dota_chatwheel_message_abaddon_deny"	"Never."
"dota_chatwheel_label_abaddon_deny"	"안 될 일이지."
"[english]dota_chatwheel_label_abaddon_deny"	"Never."
"dota_chatwheel_message_abaddon_1"	"네 군주를 섬겨라."
"[english]dota_chatwheel_message_abaddon_1"	"Bow to your lord."
"dota_chatwheel_label_abaddon_1"	"네 군주를 섬겨라."
"[english]dota_chatwheel_label_abaddon_1"	"Bow to your lord."
"dota_chatwheel_message_abaddon_2"	"어떻게 이럴 수가?"
"[english]dota_chatwheel_message_abaddon_2"	"How can such a thing be?"
"dota_chatwheel_label_abaddon_2"	"어떻게 이럴..."
"[english]dota_chatwheel_label_abaddon_2"	"How can such..."
"dota_chatwheel_message_abaddon_3"	"시간의 안갯속에서 그저 흐릿한 존재일 뿐이로구나."
"[english]dota_chatwheel_message_abaddon_3"	"In the mists of time you are but a blur."
"dota_chatwheel_label_abaddon_3"	"시간의 안갯속에서..."
"[english]dota_chatwheel_label_abaddon_3"	"In the mists of time..."
"dota_chatwheel_message_abaddon_4"	"무슨 권리로 이 땅을 밟는가?"
"[english]dota_chatwheel_message_abaddon_4"	"By what right do you tread here?"
"dota_chatwheel_label_abaddon_4"	"무슨 권리로..."
"[english]dota_chatwheel_label_abaddon_4"	"By what right..."
"dota_chatwheel_message_abaddon_5"	"전장의 안개는 운명의 안개에 맞설 수 없다."
"[english]dota_chatwheel_message_abaddon_5"	"The fog of war is no match for the mist of fate."
"dota_chatwheel_label_abaddon_5"	"전장의 안개는..."
"[english]dota_chatwheel_label_abaddon_5"	"The fog of war..."
}
