"hero_chat_wheel"
{
"dota_chatwheel_message_antimage_laugh"	"Ha ha ha ha ha ha ha ha ha ha ha ha!"
"[english]dota_chatwheel_message_antimage_laugh"	"Ha ha ha ha ha ha ha ha ha ha ha ha!"
"dota_chatwheel_label_antimage_laugh"	"[Skratta]"
"[english]dota_chatwheel_label_antimage_laugh"	"Laugh"
"dota_chatwheel_message_antimage_thank"	"Jag ska ge dem ett kok stryk som de sällan kommer att glömma!"
"[english]dota_chatwheel_message_antimage_thank"	"I'll give them a drubbing they'll not soon forget!"
"dota_chatwheel_label_antimage_thank"	"Jag ska ge dem ett kok stryk..."
"[english]dota_chatwheel_label_antimage_thank"	"I'll give them a drubbing..."
"dota_chatwheel_message_antimage_deny"	"Försöker du ens?"
"[english]dota_chatwheel_message_antimage_deny"	"Are you even trying?"
"dota_chatwheel_label_antimage_deny"	"Försöker du ens?"
"[english]dota_chatwheel_label_antimage_deny"	"Are you even trying?"
"dota_chatwheel_message_antimage_1"	"Magi är en styggelse."
"[english]dota_chatwheel_message_antimage_1"	"Magic is an abomination."
"dota_chatwheel_label_antimage_1"	"Magi är en styggelse."
"[english]dota_chatwheel_label_antimage_1"	"Magic is an abomination."
"dota_chatwheel_message_antimage_2"	"En besvikelse."
"[english]dota_chatwheel_message_antimage_2"	"A disappointment."
"dota_chatwheel_label_antimage_2"	"En besvikelse."
"[english]dota_chatwheel_label_antimage_2"	"A disappointment."
"dota_chatwheel_message_antimage_3"	"Trolla bort dig från det där om du kan."
"[english]dota_chatwheel_message_antimage_3"	"Magic thyself out of that."
"dota_chatwheel_label_antimage_3"	"Trolla bort dig från det där om du kan."
"[english]dota_chatwheel_label_antimage_3"	"Magic thyself out of that."
"dota_chatwheel_message_antimage_4"	"Du är fördömd!"
"[english]dota_chatwheel_message_antimage_4"	"Thou art damned!"
"dota_chatwheel_label_antimage_4"	"Du är fördömd."
"[english]dota_chatwheel_label_antimage_4"	"Thou art damned."
"dota_chatwheel_message_antimage_5"	"Skicka den Döda gudens legioner, jag kommer dräpa dem alla."
"[english]dota_chatwheel_message_antimage_5"	"Send thy Dead God's legions, I will put them all to death."
"dota_chatwheel_label_antimage_5"	"Skicka din Döda guds legioner..."
"[english]dota_chatwheel_label_antimage_5"	"Send thy Dead God's legions..."
"dota_chatwheel_message_axe_laugh"	"Ha ha ha ha ha ha!"
"[english]dota_chatwheel_message_axe_laugh"	"Ha ha ha ha ha ha!"
"dota_chatwheel_label_axe_laugh"	"[Skratta]"
"[english]dota_chatwheel_label_axe_laugh"	"Laugh"
"dota_chatwheel_message_axe_thank"	"Axe gillar detta väldigt mycket."
"[english]dota_chatwheel_message_axe_thank"	"Axe likes this very much."
"dota_chatwheel_label_axe_thank"	"Axe gillar detta väldigt mycket."
"[english]dota_chatwheel_label_axe_thank"	"Axe likes this very much."
"dota_chatwheel_message_axe_deny"	"Du förtjänar inget!"
"[english]dota_chatwheel_message_axe_deny"	"You deserve nothing!"
"dota_chatwheel_label_axe_deny"	"Du förtjänar inget!"
"[english]dota_chatwheel_label_axe_deny"	"You deserve nothing!"
"dota_chatwheel_message_axe_1"	"Du stred illa -- och dog ännu värre."
"[english]dota_chatwheel_message_axe_1"	"You fought badly--died worse."
"dota_chatwheel_label_axe_1"	"Du stred illa"
"[english]dota_chatwheel_label_axe_1"	"You fought badly"
"dota_chatwheel_message_axe_2"	"Jag sa goddag, min herre!"
"[english]dota_chatwheel_message_axe_2"	"I said good day, sir!"
"dota_chatwheel_label_axe_2"	"Jag sa goddag, min herre!"
"[english]dota_chatwheel_label_axe_2"	"I said good day, sir!"
"dota_chatwheel_message_axe_3"	"Axe felbedömde?"
"[english]dota_chatwheel_message_axe_3"	"Axe misjudged?"
"dota_chatwheel_label_axe_3"	"Axe felbedömde?"
"[english]dota_chatwheel_label_axe_3"	"Axe misjudged?"
"dota_chatwheel_message_axe_4"	"Axe har inte tid för allt detta pladder."
"[english]dota_chatwheel_message_axe_4"	"Axe has no time for all this jibber-jabber."
"dota_chatwheel_label_axe_4"	"Axe har inte tid för allt detta pladder."
"[english]dota_chatwheel_label_axe_4"	"Axe has no time for all this jibber-jabber."
"dota_chatwheel_message_axe_5"	"Vad hände? Axe hände!"
"[english]dota_chatwheel_message_axe_5"	"What happened? Axe happened!"
"dota_chatwheel_label_axe_5"	"Vad hände? Axe hände!"
"[english]dota_chatwheel_label_axe_5"	"What happened? Axe happened!"
"dota_chatwheel_message_bane_laugh"	"Ha ha ha ha ha ha ha ha ha!"
"[english]dota_chatwheel_message_bane_laugh"	"Ha ha ha ha ha ha ha ha ha!"
"dota_chatwheel_label_bane_laugh"	"[Skratta]"
"[english]dota_chatwheel_label_bane_laugh"	"Laugh"
"dota_chatwheel_message_bane_thank"	"Du är så snäll."
"[english]dota_chatwheel_message_bane_thank"	"You're so nice."
"dota_chatwheel_label_bane_thank"	"Du är så snäll."
"[english]dota_chatwheel_label_bane_thank"	"You're so nice."
"dota_chatwheel_message_bane_deny"	"Bättre lycka nästa gång."
"[english]dota_chatwheel_message_bane_deny"	"Better luck next time."
"dota_chatwheel_label_bane_deny"	"Bättre lycka nästa gång."
"[english]dota_chatwheel_label_bane_deny"	"Better luck next time."
"dota_chatwheel_message_bane_2"	"Jag har drömt om detta ögonblick."
"[english]dota_chatwheel_message_bane_2"	"I've been dreaming of this moment."
"dota_chatwheel_label_bane_2"	"Jag har drömt om detta ögonblick."
"[english]dota_chatwheel_label_bane_2"	"I've been dreaming of this moment."
"dota_chatwheel_message_bane_3"	"Ett rättvist utbyte."
"[english]dota_chatwheel_message_bane_3"	"Fair exchange."
"dota_chatwheel_label_bane_3"	"Ett rättvist utbyte."
"[english]dota_chatwheel_label_bane_3"	"Fair exchange."
"dota_chatwheel_message_bane_4"	"Nu varar din mardröm för evigt."
"[english]dota_chatwheel_message_bane_4"	"Now your nightmare lasts forever."
"dota_chatwheel_label_bane_4"	"Nu varar din mardröm för evigt."
"[english]dota_chatwheel_label_bane_4"	"Now your nightmare lasts forever."
"dota_chatwheel_message_bane_5"	"Ah ya ya ya ya ya yai eeyas!"
"[english]dota_chatwheel_message_bane_5"	"Ah ya ya ya ya ya yai eeyas!"
"dota_chatwheel_label_bane_5"	"Ah ya ya ya ya ya yai eeyas!"
"[english]dota_chatwheel_label_bane_5"	"Ah ya ya ya ya ya yai eeyas!"
"dota_chatwheel_message_bloodseeker_laugh"	"Hmm-heh-heh-heh-heh-ha!"
"[english]dota_chatwheel_message_bloodseeker_laugh"	"Hmm-heh-heh-heh-heh-ha!"
"dota_chatwheel_label_bloodseeker_laugh"	"[Skratt]"
"[english]dota_chatwheel_label_bloodseeker_laugh"	"Laugh"
"dota_chatwheel_message_bloodseeker_thank"	"Så mycket blod."
"[english]dota_chatwheel_message_bloodseeker_thank"	"So much blood."
"dota_chatwheel_label_bloodseeker_thank"	"Så mycket blod."
"[english]dota_chatwheel_label_bloodseeker_thank"	"So much blood."
"dota_chatwheel_message_bloodseeker_deny"	"Inget blod för dig."
"[english]dota_chatwheel_message_bloodseeker_deny"	"No blood for you."
"dota_chatwheel_label_bloodseeker_deny"	"Inget blod för dig."
"[english]dota_chatwheel_label_bloodseeker_deny"	"No blood for you."
"dota_chatwheel_message_bloodseeker_1"	"Jag ser rött... och det är fantastiskt!"
"[english]dota_chatwheel_message_bloodseeker_1"	"I'm seeing red...and it's amazing!"
"dota_chatwheel_label_bloodseeker_1"	"Jag ser rött... och det är fantastiskt!"
"[english]dota_chatwheel_label_bloodseeker_1"	"I'm seeing red...and it's amazing!"
"dota_chatwheel_message_bloodseeker_2"	"Var inte negativ... var positiv."
"[english]dota_chatwheel_message_bloodseeker_2"	"Don't be negative...be positive."
"dota_chatwheel_label_bloodseeker_2"	"Var inte negativ..."
"[english]dota_chatwheel_label_bloodseeker_2"	"Don't be negative..."
"dota_chatwheel_message_bloodseeker_3"	"Varsågod... spring."
"[english]dota_chatwheel_message_bloodseeker_3"	"Go ahead...run."
"dota_chatwheel_label_bloodseeker_3"	"Varsågod... spring."
"[english]dota_chatwheel_label_bloodseeker_3"	"Go ahead...run."
"dota_chatwheel_message_bloodseeker_4"	"Lägg dig ner... ta en kaka."
"[english]dota_chatwheel_message_bloodseeker_4"	"Lie down...have a cookie."
"dota_chatwheel_label_bloodseeker_4"	"Lägg dig ner... ta en kaka."
"[english]dota_chatwheel_label_bloodseeker_4"	"Lie down...have a cookie."
"dota_chatwheel_message_crystal_maiden_laugh"	"Ah ha ha ha ha ha."
"[english]dota_chatwheel_message_crystal_maiden_laugh"	"Ah ha ha ha ha ha."
"dota_chatwheel_label_crystal_maiden_laugh"	"[Skratt]"
"[english]dota_chatwheel_label_crystal_maiden_laugh"	"Laugh"
"dota_chatwheel_message_crystal_maiden_deny"	"Nu vinner ingen!"
"[english]dota_chatwheel_message_crystal_maiden_deny"	"Now nobody wins!"
"dota_chatwheel_label_crystal_maiden_deny"	"Nu vinner ingen!"
"[english]dota_chatwheel_label_crystal_maiden_deny"	"Now nobody wins!"
"dota_chatwheel_message_drow_ranger_laugh"	"Ah ha ha ha ha ha ha ha ha ha ha ha ha ha!"
"[english]dota_chatwheel_message_drow_ranger_laugh"	"Ah ha ha ha ha ha ha ha ha ha ha ha ha ha!"
"dota_chatwheel_label_drow_ranger_laugh"	"[Skratta]"
"[english]dota_chatwheel_label_drow_ranger_laugh"	"Laugh"
"dota_chatwheel_message_drow_ranger_thank"	"Ännu en triumf!"
"[english]dota_chatwheel_message_drow_ranger_thank"	"Another triumph!"
"dota_chatwheel_label_drow_ranger_thank"	"Ännu en triumf!"
"[english]dota_chatwheel_label_drow_ranger_thank"	"Another triumph!"
"dota_chatwheel_message_drow_ranger_2"	"Amatör."
"[english]dota_chatwheel_message_drow_ranger_2"	"Amateur."
"dota_chatwheel_label_drow_ranger_2"	"Amatör."
"[english]dota_chatwheel_label_drow_ranger_2"	"Amateur."
"dota_chatwheel_message_earthshaker_laugh"	"Ha ha ha ha ha ha ha ha ha."
"[english]dota_chatwheel_message_earthshaker_laugh"	"Ha ha ha ha ha ha ha ha ha."
"dota_chatwheel_label_earthshaker_laugh"	"[Skratt]"
"[english]dota_chatwheel_label_earthshaker_laugh"	"Laugh"
"dota_chatwheel_message_earthshaker_deny"	"Chockerande..."
"[english]dota_chatwheel_message_earthshaker_deny"	"Shocking..."
"dota_chatwheel_label_earthshaker_deny"	"Chockerande..."
"[english]dota_chatwheel_label_earthshaker_deny"	"Shocking..."
"dota_chatwheel_message_juggernaut_laugh"	"Ha ha ha ha ha!"
"[english]dota_chatwheel_message_juggernaut_laugh"	"Ha ha ha ha ha!"
"dota_chatwheel_label_juggernaut_laugh"	"[Skratta]"
"[english]dota_chatwheel_label_juggernaut_laugh"	"Laugh"
"dota_chatwheel_message_mirana_laugh"	"Ha ha ha ha ha ha!"
"[english]dota_chatwheel_message_mirana_laugh"	"Ha ha ha ha ha ha!"
"dota_chatwheel_label_mirana_laugh"	"[Skratta]"
"[english]dota_chatwheel_label_mirana_laugh"	"Laugh"
"dota_chatwheel_message_mirana_thank"	"En gåva från natten!"
"[english]dota_chatwheel_message_mirana_thank"	"A gift from the night!"
"dota_chatwheel_label_mirana_thank"	"En gåva från natten!"
"[english]dota_chatwheel_label_mirana_thank"	"A gift from the night!"
"dota_chatwheel_message_mirana_deny"	"Fånga oss om du kan!"
"[english]dota_chatwheel_message_mirana_deny"	"Catch us if you can!"
"dota_chatwheel_label_mirana_deny"	"Fånga oss om du kan!"
"[english]dota_chatwheel_label_mirana_deny"	"Catch us if you can!"
"dota_chatwheel_message_mirana_2"	"Snyggt gjort!"
"[english]dota_chatwheel_message_mirana_2"	"Nicely done!"
"dota_chatwheel_label_mirana_2"	"Snyggt gjort!"
"[english]dota_chatwheel_label_mirana_2"	"Nicely done!"
"dota_chatwheel_message_morphling_laugh"	"Ha ha ha ha ha ha ha ha ha ha!"
"[english]dota_chatwheel_message_morphling_laugh"	"Ha ha ha ha ha ha ha ha ha ha!"
"dota_chatwheel_label_morphling_laugh"	"[Skratta]"
"[english]dota_chatwheel_label_morphling_laugh"	"Laugh"
"dota_chatwheel_message_morphling_1"	"Kokande ilska!"
"[english]dota_chatwheel_message_morphling_1"	"Boiling rage!"
"dota_chatwheel_label_morphling_1"	"Kokande ilska!"
"[english]dota_chatwheel_label_morphling_1"	"Boiling rage!"
"dota_chatwheel_message_morphling_2"	"Alltid uppfriskande."
"[english]dota_chatwheel_message_morphling_2"	"Always refreshing."
"dota_chatwheel_label_morphling_2"	"Alltid uppfriskande."
"[english]dota_chatwheel_label_morphling_2"	"Always refreshing."
"dota_chatwheel_label_morphling_4"	"Såg du mig inte vinka?"
"[english]dota_chatwheel_label_morphling_4"	"Didn't you see me waving?"
"dota_chatwheel_message_nevermore_laugh"	"Ah ha ha ha ha ha!"
"[english]dota_chatwheel_message_nevermore_laugh"	"Ah ha ha ha ha ha!"
"dota_chatwheel_label_nevermore_laugh"	"[Skratta]"
"[english]dota_chatwheel_label_nevermore_laugh"	"Laugh"
"dota_chatwheel_message_nevermore_deny"	"Utklassad."
"[english]dota_chatwheel_message_nevermore_deny"	"Outplayed."
"dota_chatwheel_label_nevermore_deny"	"Utklassad."
"[english]dota_chatwheel_label_nevermore_deny"	"Outplayed."
"dota_chatwheel_message_nevermore_1"	"En vacker själ för min samling."
"[english]dota_chatwheel_message_nevermore_1"	"A beautiful soul for my collection."
"dota_chatwheel_label_nevermore_1"	"En vacker själ för min samling."
"[english]dota_chatwheel_label_nevermore_1"	"A beautiful soul for my collection."
"dota_chatwheel_message_phantom_lancer_laugh"	"Ha ha ha ha ha ha ha ha ha ha ha ha ha!"
"[english]dota_chatwheel_message_phantom_lancer_laugh"	"Ha ha ha ha ha ha ha ha ha ha ha ha ha!"
"dota_chatwheel_label_phantom_lancer_laugh"	"[Skratta]"
"[english]dota_chatwheel_label_phantom_lancer_laugh"	"Laugh"
"dota_chatwheel_message_puck_laugh"	"Ha ha!"
"[english]dota_chatwheel_message_puck_laugh"	"Ha ha!"
"dota_chatwheel_label_puck_laugh"	"[Skratta]"
"[english]dota_chatwheel_label_puck_laugh"	"Laugh"
"dota_chatwheel_message_puck_thank"	"Intressant."
"[english]dota_chatwheel_message_puck_thank"	"Interesting."
"dota_chatwheel_label_puck_thank"	"Intressant."
"[english]dota_chatwheel_label_puck_thank"	"Interesting."
"dota_chatwheel_message_pudge_laugh"	"Hm hm hm hm ha ha ha."
"[english]dota_chatwheel_message_pudge_laugh"	"Hm hm hm hm ha ha ha."
"dota_chatwheel_label_pudge_laugh"	"[Skratta]"
"[english]dota_chatwheel_label_pudge_laugh"	"Laugh"
"dota_chatwheel_message_pudge_3"	"Jaja."
"[english]dota_chatwheel_message_pudge_3"	"Whateva."
"dota_chatwheel_label_pudge_3"	"Jaja."
"[english]dota_chatwheel_label_pudge_3"	"Whateva."
"dota_chatwheel_message_pudge_4"	"Utsökt..."
"[english]dota_chatwheel_message_pudge_4"	"Delicious..."
"dota_chatwheel_label_pudge_4"	"Utsökt..."
"[english]dota_chatwheel_label_pudge_4"	"Delicious..."
"dota_chatwheel_message_razor_laugh"	"Ah ha ha ha ha ha ha ha ha."
"[english]dota_chatwheel_message_razor_laugh"	"Ah ha ha ha ha ha ha ha ha."
"dota_chatwheel_label_razor_laugh"	"[Skratta]"
"[english]dota_chatwheel_label_razor_laugh"	"Laugh"
"dota_chatwheel_message_razor_3"	"Chockerande."
"[english]dota_chatwheel_message_razor_3"	"Shocking."
"dota_chatwheel_label_razor_3"	"Chockerande."
"[english]dota_chatwheel_label_razor_3"	"Shocking."
"dota_chatwheel_message_sand_king_laugh"	"Ha ha ha ha ha ha ha!"
"[english]dota_chatwheel_message_sand_king_laugh"	"Ha ha ha ha ha ha ha!"
"dota_chatwheel_label_sand_king_laugh"	"[Skratta]"
"[english]dota_chatwheel_label_sand_king_laugh"	"Laugh"
"dota_chatwheel_message_sand_king_1"	"Buga er för er herre."
"[english]dota_chatwheel_message_sand_king_1"	"Bow to your liege."
"dota_chatwheel_label_sand_king_1"	"Buga er för er herre."
"[english]dota_chatwheel_label_sand_king_1"	"Bow to your liege."
"dota_chatwheel_message_sand_king_2"	"En sandig s-s-seger!"
"[english]dota_chatwheel_message_sand_king_2"	"A Sandy V-V-Victory!"
"dota_chatwheel_label_sand_king_2"	"En sandig s-s-seger!"
"[english]dota_chatwheel_label_sand_king_2"	"A Sandy V-V-Victory!"
"dota_chatwheel_message_storm_spirit_laugh"	"Hm hm hm hm hee hee hee ha ha."
"[english]dota_chatwheel_message_storm_spirit_laugh"	"Hm hm hm hm hee hee hee ha ha."
"dota_chatwheel_label_storm_spirit_laugh"	"[Skratta]"
"[english]dota_chatwheel_label_storm_spirit_laugh"	"Laugh"
"dota_chatwheel_message_storm_spirit_2"	"Letar ni efter mig?"
"[english]dota_chatwheel_message_storm_spirit_2"	"Lookin for me?"
"dota_chatwheel_label_storm_spirit_2"	"Letar ni efter mig?"
"[english]dota_chatwheel_label_storm_spirit_2"	"Lookin for me?"
"dota_chatwheel_message_storm_spirit_5"	"Härligt!"
"[english]dota_chatwheel_message_storm_spirit_5"	"Glorious!"
"dota_chatwheel_label_storm_spirit_5"	"Härligt!"
"[english]dota_chatwheel_label_storm_spirit_5"	"Glorious!"
"dota_chatwheel_message_sven_laugh"	"Ahh ha ha ha! Ha ha ha ha!"
"[english]dota_chatwheel_message_sven_laugh"	"Ahh ha ha ha! Ha ha ha ha!"
"dota_chatwheel_label_sven_laugh"	"[Skratta]"
"[english]dota_chatwheel_label_sven_laugh"	"Laugh"
"dota_chatwheel_message_sven_4"	"Ett förväntat resultat."
"[english]dota_chatwheel_message_sven_4"	"An expected outcome."
"dota_chatwheel_label_sven_4"	"Ett förväntat resultat."
"[english]dota_chatwheel_label_sven_4"	"An expected outcome."
"dota_chatwheel_message_tiny_laugh"	"Hehehehehuhhehehe."
"[english]dota_chatwheel_message_tiny_laugh"	"Hehehehehuhhehehe."
"dota_chatwheel_label_tiny_laugh"	"[Skratta]"
"[english]dota_chatwheel_label_tiny_laugh"	"Laugh"
"dota_chatwheel_message_vengefulspirit_laugh"	"Hm ha ha ha ha ha ha!"
"[english]dota_chatwheel_message_vengefulspirit_laugh"	"Hm ha ha ha ha ha ha!"
"dota_chatwheel_label_vengefulspirit_laugh"	"[Skratta]"
"[english]dota_chatwheel_label_vengefulspirit_laugh"	"Laugh"
"dota_chatwheel_message_vengefulspirit_thank"	"Så rart..."
"[english]dota_chatwheel_message_vengefulspirit_thank"	"So sweet..."
"dota_chatwheel_label_vengefulspirit_thank"	"Så rart..."
"[english]dota_chatwheel_label_vengefulspirit_thank"	"So sweet..."
"dota_chatwheel_message_vengefulspirit_deny"	"Va...?"
"[english]dota_chatwheel_message_vengefulspirit_deny"	"What...?"
"dota_chatwheel_label_vengefulspirit_deny"	"Va...?"
"[english]dota_chatwheel_label_vengefulspirit_deny"	"What...?"
"dota_chatwheel_message_vengefulspirit_2"	"Bytt är bytt!"
"[english]dota_chatwheel_message_vengefulspirit_2"	"Swapsies!"
"dota_chatwheel_label_vengefulspirit_2"	"Bytt är bytt!"
"[english]dota_chatwheel_label_vengefulspirit_2"	"Swapsies!"
"dota_chatwheel_message_vengefulspirit_3"	"Mwahahhahahahahahaha!"
"[english]dota_chatwheel_message_vengefulspirit_3"	"Mwahahhahahahahahaha!"
"dota_chatwheel_label_vengefulspirit_3"	"Mwahahhahahahahahaha!"
"[english]dota_chatwheel_label_vengefulspirit_3"	"Mwahahhahahahahahaha!"
"dota_chatwheel_message_windrunner_laugh"	"Hah-ha-ha-ha-ha!"
"[english]dota_chatwheel_message_windrunner_laugh"	"Hah-ha-ha-ha-ha!"
"dota_chatwheel_label_windrunner_laugh"	"[Skratta]"
"[english]dota_chatwheel_label_windrunner_laugh"	"Laugh"
"dota_chatwheel_message_windrunner_thank"	"Lätt som en plätt"
"[english]dota_chatwheel_message_windrunner_thank"	"Easy breezy"
"dota_chatwheel_label_windrunner_thank"	"Lätt som en plätt"
"[english]dota_chatwheel_label_windrunner_thank"	"Easy breezy"
"dota_chatwheel_message_windrunner_1"	"Kunde vara värre. Eller nej, det kunde det inte."
"[english]dota_chatwheel_message_windrunner_1"	"Could be worse. Oh, wait, no it couldn't."
"dota_chatwheel_label_windrunner_1"	"Kunde vara värre..."
"[english]dota_chatwheel_label_windrunner_1"	"Could be worse..."
"dota_chatwheel_message_zuus_laugh"	"Ha ha ha ha ha ha ha ha ha!"
"[english]dota_chatwheel_message_zuus_laugh"	"Ha ha ha ha ha ha ha ha ha!"
"dota_chatwheel_label_zuus_laugh"	"[Skratta]"
"[english]dota_chatwheel_label_zuus_laugh"	"Laugh"
"dota_chatwheel_message_zuus_1"	"Vänta på det!"
"[english]dota_chatwheel_message_zuus_1"	"Wait for it!"
"dota_chatwheel_label_zuus_1"	"Vänta på det!"
"[english]dota_chatwheel_label_zuus_1"	"Wait for it!"
"dota_chatwheel_message_kunkka_laugh"	"He-hu-hu-hu-hu-huhhuha!"
"[english]dota_chatwheel_message_kunkka_laugh"	"He-hu-hu-hu-hu-huhhuha!"
"dota_chatwheel_label_kunkka_laugh"	"[Skratta]"
"[english]dota_chatwheel_label_kunkka_laugh"	"Laugh"
"dota_chatwheel_message_lina_laugh"	"Ha ha ha ha ha ha ha!"
"[english]dota_chatwheel_message_lina_laugh"	"Ha ha ha ha ha ha ha!"
"dota_chatwheel_label_lina_laugh"	"[Skratta]"
"[english]dota_chatwheel_label_lina_laugh"	"Laugh"
"dota_chatwheel_message_lina_5"	"Kom till mamma!"
"[english]dota_chatwheel_message_lina_5"	"Come to mama!"
"dota_chatwheel_label_lina_5"	"Kom till mamma!"
"[english]dota_chatwheel_label_lina_5"	"Come to mama!"
"dota_chatwheel_label_lion_laugh"	"[Skratta]"
"[english]dota_chatwheel_label_lion_laugh"	"Laugh"
"dota_chatwheel_message_lion_deny"	"Ah, ledsen att göra dig besviken."
"[english]dota_chatwheel_message_lion_deny"	"Ah, sorry to disappoint you."
"dota_chatwheel_label_lion_deny"	"Ah, ledsen att göra dig besviken."
"[english]dota_chatwheel_label_lion_deny"	"Ah, sorry to disappoint you."
"dota_chatwheel_message_shadow_shaman_laugh"	"Ha ha ha!"
"[english]dota_chatwheel_message_shadow_shaman_laugh"	"Ha ha ha!"
"dota_chatwheel_label_shadow_shaman_laugh"	"[Skratta]"
"[english]dota_chatwheel_label_shadow_shaman_laugh"	"Laugh"
"dota_chatwheel_message_shadow_shaman_deny"	"Bukaw, bukaw!"
"[english]dota_chatwheel_message_shadow_shaman_deny"	"Bukaw, bukaw!"
"dota_chatwheel_label_shadow_shaman_deny"	"Bukaw, bukaw!"
"[english]dota_chatwheel_label_shadow_shaman_deny"	"Bukaw, bukaw!"
"dota_chatwheel_message_shadow_shaman_5"	"Au-mosu-atikanu!"
"[english]dota_chatwheel_message_shadow_shaman_5"	"Au-mosu-atikanu!"
"dota_chatwheel_label_shadow_shaman_5"	"Au-mosu-atikanu!"
"[english]dota_chatwheel_label_shadow_shaman_5"	"Au-mosu-atikanu!"
"dota_chatwheel_label_slardar_laugh"	"[Skratta]"
"[english]dota_chatwheel_label_slardar_laugh"	"Laugh"
"dota_chatwheel_message_slardar_3"	"Du är avslöjad."
"[english]dota_chatwheel_message_slardar_3"	"Jig's up."
"dota_chatwheel_label_slardar_3"	"Du är avslöjad."
"[english]dota_chatwheel_label_slardar_3"	"Jig's up."
"dota_chatwheel_message_tidehunter_laugh"	"Ah ha ha ha!"
"[english]dota_chatwheel_message_tidehunter_laugh"	"Ah ha ha ha!"
"dota_chatwheel_label_tidehunter_laugh"	"[Skratta]"
"[english]dota_chatwheel_label_tidehunter_laugh"	"Laugh"
"dota_chatwheel_message_tidehunter_2"	"Ha ha jag kan äta en valross."
"[english]dota_chatwheel_message_tidehunter_2"	"Ha ha I could eat a walrus."
"dota_chatwheel_label_tidehunter_2"	"Ha ha jag kan äta en valross."
"[english]dota_chatwheel_label_tidehunter_2"	"Ha ha I could eat a walrus."
"dota_chatwheel_message_tidehunter_4"	"Trodde du att jag skulle tabba mig? Du måste ha misstagit mig för Kunkka."
"[english]dota_chatwheel_message_tidehunter_4"	"Did you think I'd blunder? You must have mistaken me for Kunkka."
"dota_chatwheel_label_tidehunter_4"	"Trodde du att jag skulle tabba mig..?"
"[english]dota_chatwheel_label_tidehunter_4"	"Did you think I'd blunder?..."
"dota_chatwheel_label_witch_doctor_laugh"	"[Skratta]"
"[english]dota_chatwheel_label_witch_doctor_laugh"	"Laugh"
"dota_chatwheel_message_witch_doctor_1"	"Det blev en stor röra."
"[english]dota_chatwheel_message_witch_doctor_1"	"Dat make a big mess."
"dota_chatwheel_label_witch_doctor_1"	"Det blev en stor röra."
"[english]dota_chatwheel_label_witch_doctor_1"	"Dat make a big mess."
"dota_chatwheel_message_witch_doctor_5"	"Oyeaaaaah."
"[english]dota_chatwheel_message_witch_doctor_5"	"Oyeaaaaah."
"dota_chatwheel_label_witch_doctor_5"	"Oyeaaaaah."
"[english]dota_chatwheel_label_witch_doctor_5"	"Oyeaaaaah."
"dota_chatwheel_message_lich_laugh"	"Ha ha ha ha ha ha ha ha!"
"[english]dota_chatwheel_message_lich_laugh"	"Ha ha ha ha ha ha ha ha!"
"dota_chatwheel_label_lich_laugh"	"[Skratta]"
"[english]dota_chatwheel_label_lich_laugh"	"Laugh"
"dota_chatwheel_message_lich_1"	"Kan inte döda de döda."
"[english]dota_chatwheel_message_lich_1"	"Can't kill the dead."
"dota_chatwheel_label_lich_1"	"Kan inte döda de döda."
"[english]dota_chatwheel_label_lich_1"	"Can't kill the dead."
"dota_chatwheel_message_lich_2"	"Kittlar det?"
"[english]dota_chatwheel_message_lich_2"	"Does it tingle?"
"dota_chatwheel_label_lich_2"	"Kittlar det?"
"[english]dota_chatwheel_label_lich_2"	"Does it tingle?"
"dota_chatwheel_message_lich_5"	"Ah, Ice Frog!"
"[english]dota_chatwheel_message_lich_5"	"Ah, Ice Frog!"
"dota_chatwheel_label_lich_5"	"Ah, Ice Frog!"
"[english]dota_chatwheel_label_lich_5"	"Ah, Ice Frog!"
"dota_chatwheel_message_riki_laugh"	"hoo hoo hoo hoo hoo hoo hoo."
"[english]dota_chatwheel_message_riki_laugh"	"hoo hoo hoo hoo hoo hoo hoo."
"dota_chatwheel_label_riki_laugh"	"[Skratta]"
"[english]dota_chatwheel_label_riki_laugh"	"Laugh"
"dota_chatwheel_message_riki_thank"	"Kontrakt slutfört."
"[english]dota_chatwheel_message_riki_thank"	"Contract complete."
"dota_chatwheel_label_riki_thank"	"Kontrakt slutfört."
"[english]dota_chatwheel_label_riki_thank"	"Contract complete."
"dota_chatwheel_message_riki_2"	"Tittut."
"[english]dota_chatwheel_message_riki_2"	"Peek-a-boo."
"dota_chatwheel_label_riki_2"	"Tittut."
"[english]dota_chatwheel_label_riki_2"	"Peek-aboo."
"dota_chatwheel_message_enigma_laugh"	"He-he-huh-heh-heh."
"[english]dota_chatwheel_message_enigma_laugh"	"He-he-huh-heh-heh."
"dota_chatwheel_label_enigma_laugh"	"[Skratta]"
"[english]dota_chatwheel_label_enigma_laugh"	"Laugh"
"dota_chatwheel_message_enigma_deny"	"Ett astronomiskt pris."
"[english]dota_chatwheel_message_enigma_deny"	"An astronomical price."
"dota_chatwheel_label_enigma_deny"	"Ett astronomiskt pris."
"[english]dota_chatwheel_label_enigma_deny"	"An astronomical price."
"dota_chatwheel_message_enigma_4"	"En välkommen manifestation av slumpmässighet."
"[english]dota_chatwheel_message_enigma_4"	"A welcome manifestation of randomness."
"dota_chatwheel_label_enigma_4"	"En välkommen manifestation av slumpmässighet."
"[english]dota_chatwheel_label_enigma_4"	"A welcome manifestation of randomness."
"dota_chatwheel_message_tinker_laugh"	"Ah ha ha ha ha!"
"[english]dota_chatwheel_message_tinker_laugh"	"Ah ha ha ha ha!"
"dota_chatwheel_label_tinker_laugh"	"[Skratta]"
"[english]dota_chatwheel_label_tinker_laugh"	"Laugh"
"dota_chatwheel_label_sniper_laugh"	"[Skratta]"
"[english]dota_chatwheel_label_sniper_laugh"	"Laugh"
"dota_chatwheel_message_sniper_deny"	"Vad i---?"
"[english]dota_chatwheel_message_sniper_deny"	"What the---?"
"dota_chatwheel_label_sniper_deny"	"Vad i---?"
"[english]dota_chatwheel_label_sniper_deny"	"What the---?"
"dota_chatwheel_message_sniper_2"	"Dansa! Ha ha ha ha! Dansa!"
"[english]dota_chatwheel_message_sniper_2"	"Dance! Ha ha ha ha! Dance!"
"dota_chatwheel_label_sniper_2"	"Dansa! Ha ha ha ha! Dansa!"
"[english]dota_chatwheel_label_sniper_2"	"Dance! Ha ha ha ha! Dance!"
"dota_chatwheel_message_sniper_5"	"Ho ho ha ha!"
"[english]dota_chatwheel_message_sniper_5"	"Ho ho ha ha!"
"dota_chatwheel_label_sniper_5"	"Ho ho ha ha!"
"[english]dota_chatwheel_label_sniper_5"	"Ho ho ha ha!"
"dota_chatwheel_message_necrolyte_laugh"	"Ha ha ha ha ha ha ha ha ha ha ha ha!"
"[english]dota_chatwheel_message_necrolyte_laugh"	"Ha ha ha ha ha ha ha ha ha ha ha ha!"
"dota_chatwheel_label_necrolyte_laugh"	"[Skratta]"
"[english]dota_chatwheel_label_necrolyte_laugh"	"Laugh"
"dota_chatwheel_message_necrolyte_thank"	"Andas in det."
"[english]dota_chatwheel_message_necrolyte_thank"	"Breathe it in."
"dota_chatwheel_label_necrolyte_thank"	"Andas in det."
"[english]dota_chatwheel_label_necrolyte_thank"	"Breathe it in."
"dota_chatwheel_message_warlock_laugh"	"Ho ha ha ha ha ha ha ha ha!"
"[english]dota_chatwheel_message_warlock_laugh"	"Ho ha ha ha ha ha ha ha ha!"
"dota_chatwheel_label_warlock_laugh"	"[Skratta]"
"[english]dota_chatwheel_label_warlock_laugh"	"Laugh"
"dota_chatwheel_message_warlock_3"	"Ännu ett namn i min svartkonstbok."
"[english]dota_chatwheel_message_warlock_3"	"Another name in my grimoire."
"dota_chatwheel_label_warlock_3"	"Ännu ett namn i min svartkonstbok."
"[english]dota_chatwheel_label_warlock_3"	"Another name in my grimoire."
"dota_chatwheel_label_beastmaster_laugh"	"[Skratta]"
"[english]dota_chatwheel_label_beastmaster_laugh"	"Laugh"
"dota_chatwheel_message_beastmaster_thank"	"Buss på!"
"[english]dota_chatwheel_message_beastmaster_thank"	"Sic 'em!"
"dota_chatwheel_label_beastmaster_thank"	"Buss på!"
"[english]dota_chatwheel_label_beastmaster_thank"	"Sic 'em!"
"dota_chatwheel_message_beastmaster_2"	"En strikt No kill-policy."
"[english]dota_chatwheel_message_beastmaster_2"	"A strict no-kill policy."
"dota_chatwheel_label_beastmaster_2"	"En strikt No kill-policy."
"[english]dota_chatwheel_label_beastmaster_2"	"A strict no-kill policy."
"dota_chatwheel_message_beastmaster_3"	"Aroo arooew!"
"[english]dota_chatwheel_message_beastmaster_3"	"Aroo arooew!"
"dota_chatwheel_label_beastmaster_3"	"Aroo arooew!"
"[english]dota_chatwheel_label_beastmaster_3"	"Aroo arooew!"
"dota_chatwheel_message_beastmaster_5"	"Hoo hoo hoo."
"[english]dota_chatwheel_message_beastmaster_5"	"Hoo hoo hoo."
"dota_chatwheel_label_beastmaster_5"	"Hoo hoo hoo."
"[english]dota_chatwheel_label_beastmaster_5"	"Hoo hoo hoo."
"dota_chatwheel_message_queenofpain_laugh"	"Uh ha ha ha ha ha ha ha ha ha ha ha!"
"[english]dota_chatwheel_message_queenofpain_laugh"	"Uh ha ha ha ha ha ha ha ha ha ha ha!"
"dota_chatwheel_label_queenofpain_laugh"	"[Skratta]"
"[english]dota_chatwheel_label_queenofpain_laugh"	"Laugh"
"dota_chatwheel_message_queenofpain_2"	"Gör detta ont?"
"[english]dota_chatwheel_message_queenofpain_2"	"Does this hurt?"
"dota_chatwheel_label_queenofpain_2"	"Gör detta ont?"
"[english]dota_chatwheel_label_queenofpain_2"	"Does this hurt?"
"dota_chatwheel_label_venomancer_laugh"	"[Skratta]"
"[english]dota_chatwheel_label_venomancer_laugh"	"Laugh"
"dota_chatwheel_message_venomancer_deny"	"Åh, kostsamt."
"[english]dota_chatwheel_message_venomancer_deny"	"Oh, costly."
"dota_chatwheel_label_venomancer_deny"	"Åh, kostsamt."
"[english]dota_chatwheel_label_venomancer_deny"	"Oh, costly."
"dota_chatwheel_message_venomancer_5"	"Ah, söta giftighet!"
"[english]dota_chatwheel_message_venomancer_5"	"Ah, sweet toxicity!"
"dota_chatwheel_label_venomancer_5"	"Ah, söta giftighet!"
"[english]dota_chatwheel_label_venomancer_5"	"Ah, sweet toxicity!"
"dota_chatwheel_label_faceless_void_laugh"	"[Skratta]"
"[english]dota_chatwheel_label_faceless_void_laugh"	"Laugh"
"dota_chatwheel_label_faceless_void_deny"	"...var aldrig menade att vara."
"[english]dota_chatwheel_label_faceless_void_deny"	"...just not meant to be."
"dota_chatwheel_message_faceless_void_4"	"Jag må vara ansiktslös, men jag är inte vapenlös."
"[english]dota_chatwheel_message_faceless_void_4"	"I may be faceless, but I'm not maceless."
"dota_chatwheel_message_skeleton_king_laugh"	"AH HA HA HA HA!"
"[english]dota_chatwheel_message_skeleton_king_laugh"	"AH HA HA HA HA!"
"dota_chatwheel_label_skeleton_king_laugh"	"AH HA HA HA HA!"
"[english]dota_chatwheel_label_skeleton_king_laugh"	"AH HA HA HA HA!"
"dota_chatwheel_label_skeleton_king_thank"	"...SVAGA OCH YNKLIGA ALLIERADE..."
"[english]dota_chatwheel_label_skeleton_king_thank"	"...WEAK AND PUNY ALLIES..."
"dota_chatwheel_message_skeleton_king_2"	"MYCKET TREVLIGT."
"[english]dota_chatwheel_message_skeleton_king_2"	"VERY NICE."
"dota_chatwheel_label_skeleton_king_2"	"MYCKET TREVLIGT."
"[english]dota_chatwheel_label_skeleton_king_2"	"VERY NICE."
"dota_chatwheel_message_death_prophet_laugh"	"Oh ah ha ha ha ha ha ho ho haa! Ha ha ha ha ha ha!"
"[english]dota_chatwheel_message_death_prophet_laugh"	"Oh ah ha ha ha ha ha ho ho haa! Ha ha ha ha ha ha!"
"dota_chatwheel_label_death_prophet_laugh"	"[Skratta]"
"[english]dota_chatwheel_label_death_prophet_laugh"	"Laugh"
"dota_chatwheel_message_death_prophet_3"	"Kom tillbaka! Kom tillbaka!"
"[english]dota_chatwheel_message_death_prophet_3"	"Come back to me! Come back to me!"
"dota_chatwheel_label_death_prophet_3"	"Kom tillbaka!"
"[english]dota_chatwheel_label_death_prophet_3"	"Come back to me!"
"dota_chatwheel_message_phantom_assassin_laugh"	"Ho ho ho ho ho ha ha ha"
"[english]dota_chatwheel_message_phantom_assassin_laugh"	"Ho ho ho ho ho ha ha ha"
"dota_chatwheel_label_phantom_assassin_laugh"	"[Skratta]"
"[english]dota_chatwheel_label_phantom_assassin_laugh"	"Laugh"
"dota_chatwheel_message_phantom_assassin_thank"	"Mmm, gudomligt."
"[english]dota_chatwheel_message_phantom_assassin_thank"	"Mmm, divine."
"dota_chatwheel_label_phantom_assassin_thank"	"Mmm, gudomligt."
"[english]dota_chatwheel_label_phantom_assassin_thank"	"Mmm, divine."
"dota_chatwheel_message_phantom_assassin_deny"	"Allt enligt planen."
"[english]dota_chatwheel_message_phantom_assassin_deny"	"All according to plan."
"dota_chatwheel_label_phantom_assassin_deny"	"Allt enligt planen."
"[english]dota_chatwheel_label_phantom_assassin_deny"	"All according to plan."
"dota_chatwheel_message_phantom_assassin_1"	"Att dödas av mig är en ära."
"[english]dota_chatwheel_message_phantom_assassin_1"	"Death at my hands is an honor."
"dota_chatwheel_label_phantom_assassin_1"	"Att dödas av mig är en ära."
"[english]dota_chatwheel_label_phantom_assassin_1"	"Death at my hands is an honor."
"dota_chatwheel_label_phantom_assassin_4"	"[Skratta]...nej nej nej."
"[english]dota_chatwheel_label_phantom_assassin_4"	"Laugh...no no no."
"dota_chatwheel_message_pugna_laugh"	"Ha ha ha ha ha ha."
"[english]dota_chatwheel_message_pugna_laugh"	"Ha ha ha ha ha ha."
"dota_chatwheel_label_pugna_laugh"	"[Skratta]"
"[english]dota_chatwheel_label_pugna_laugh"	"Laugh"
"dota_chatwheel_message_pugna_thank"	"Detta kommer bli bra."
"[english]dota_chatwheel_message_pugna_thank"	"Ah, this is going to be good."
"dota_chatwheel_label_pugna_thank"	"Detta kommer bli bra."
"[english]dota_chatwheel_label_pugna_thank"	"Ah, this is going to be good."
"dota_chatwheel_message_pugna_1"	"Gjorde jag det där?"
"[english]dota_chatwheel_message_pugna_1"	"Aw, did I do that?"
"dota_chatwheel_label_pugna_1"	"Gjorde jag det där?"
"[english]dota_chatwheel_label_pugna_1"	"Aw, did I do that?"
"dota_chatwheel_message_pugna_2"	"Någon som saknat mig?"
"[english]dota_chatwheel_message_pugna_2"	"Anyone miss me?"
"dota_chatwheel_label_pugna_2"	"Någon som saknat mig?"
"[english]dota_chatwheel_label_pugna_2"	"Anyone miss me?"
"dota_chatwheel_message_templar_assassin_laugh"	"Ha ha ha ha ha ha ha!"
"[english]dota_chatwheel_message_templar_assassin_laugh"	"Ha ha ha ha ha ha ha!"
"dota_chatwheel_label_templar_assassin_laugh"	"[Skratta]"
"[english]dota_chatwheel_label_templar_assassin_laugh"	"Laugh"
"dota_chatwheel_message_templar_assassin_2"	"Det är en fälla!"
"[english]dota_chatwheel_message_templar_assassin_2"	"It's a trap!"
"dota_chatwheel_label_templar_assassin_2"	"Det är en fälla!"
"[english]dota_chatwheel_label_templar_assassin_2"	"It's a trap!"
"dota_chatwheel_message_viper_laugh"	"Tehehehehar."
"[english]dota_chatwheel_message_viper_laugh"	"Tehehehehar."
"dota_chatwheel_label_viper_laugh"	"[Skratta]"
"[english]dota_chatwheel_label_viper_laugh"	"Laugh"
"dota_chatwheel_message_viper_thank"	"Luftunderstöd ankommer."
"[english]dota_chatwheel_message_viper_thank"	"Air support arrives."
"dota_chatwheel_label_viper_thank"	"Luftunderstöd ankommer."
"[english]dota_chatwheel_label_viper_thank"	"Air support arrives."
"dota_chatwheel_message_viper_deny"	"Nära men ändå inte."
"[english]dota_chatwheel_message_viper_deny"	"Close but not quite."
"dota_chatwheel_label_viper_deny"	"Nära men ändå inte."
"[english]dota_chatwheel_label_viper_deny"	"Close but not quite."
"dota_chatwheel_message_viper_1"	"Död... från ovan."
"[english]dota_chatwheel_message_viper_1"	"Death...from above."
"dota_chatwheel_label_viper_1"	"Död... från ovan."
"[english]dota_chatwheel_label_viper_1"	"Death...from above."
"dota_chatwheel_message_luna_laugh"	"Ah ha ha ha ha ha ha!"
"[english]dota_chatwheel_message_luna_laugh"	"Ah ha ha ha ha ha ha!"
"dota_chatwheel_label_luna_laugh"	"[Skratta]"
"[english]dota_chatwheel_label_luna_laugh"	"Laugh"
"dota_chatwheel_message_luna_deny"	"Intressant!"
"[english]dota_chatwheel_message_luna_deny"	"Interesting!"
"dota_chatwheel_label_luna_deny"	"Intressant!"
"[english]dota_chatwheel_label_luna_deny"	"Interesting!"
"dota_chatwheel_label_dragon_knight_laugh"	"[Skratta]"
"[english]dota_chatwheel_label_dragon_knight_laugh"	"Laugh"
"dota_chatwheel_message_dragon_knight_4"	"Självklart."
"[english]dota_chatwheel_message_dragon_knight_4"	"Of course."
"dota_chatwheel_label_dragon_knight_4"	"Självklart."
"[english]dota_chatwheel_label_dragon_knight_4"	"Of course."
"dota_chatwheel_message_dazzle_laugh"	"Ha ha har ha ha ha!"
"[english]dota_chatwheel_message_dazzle_laugh"	"Ha ha har ha ha ha!"
"dota_chatwheel_label_dazzle_laugh"	"[Skratta]"
"[english]dota_chatwheel_label_dazzle_laugh"	"Laugh"
"dota_chatwheel_message_dazzle_2"	"Det var barmhärtigt av dig."
"[english]dota_chatwheel_message_dazzle_2"	"Charitable of you."
"dota_chatwheel_label_dazzle_2"	"Det var barmhärtigt av dig."
"[english]dota_chatwheel_label_dazzle_2"	"Charitable of you."
"dota_chatwheel_message_dazzle_3"	"Jzap!"
"[english]dota_chatwheel_message_dazzle_3"	"Jzap!"
"dota_chatwheel_label_dazzle_3"	"Jzap!"
"[english]dota_chatwheel_label_dazzle_3"	"Jzap!"
"dota_chatwheel_message_dazzle_4"	"Lurade dig."
"[english]dota_chatwheel_message_dazzle_4"	"Tricked you."
"dota_chatwheel_label_dazzle_4"	"Lurade dig."
"[english]dota_chatwheel_label_dazzle_4"	"Tricked you."
"dota_chatwheel_message_rattletrap_laugh"	"Ha ha ha ha ha ha!"
"[english]dota_chatwheel_message_rattletrap_laugh"	"Ha ha ha ha ha ha!"
"dota_chatwheel_label_rattletrap_laugh"	"[Skratta]"
"[english]dota_chatwheel_label_rattletrap_laugh"	"Laugh"
"dota_chatwheel_message_rattletrap_3"	"Whoa!"
"[english]dota_chatwheel_message_rattletrap_3"	"Whoa!"
"dota_chatwheel_label_rattletrap_3"	"Whoa!"
"[english]dota_chatwheel_label_rattletrap_3"	"Whoa!"
"dota_chatwheel_message_rattletrap_4"	"Bleep bloop, jag är en robot. Skojar bara."
"[english]dota_chatwheel_message_rattletrap_4"	"Bleep bloop, I am a robot. Eh, just kidding."
"dota_chatwheel_label_rattletrap_4"	"Bleep bloop, jag är en robot..."
"[english]dota_chatwheel_label_rattletrap_4"	"Bleep bloop, I am a robot..."
"dota_chatwheel_message_leshrac_laugh"	"Ha ha ha ha ha ha ha!"
"[english]dota_chatwheel_message_leshrac_laugh"	"Ha ha ha ha ha ha ha!"
"dota_chatwheel_label_leshrac_laugh"	"[Skratta]"
"[english]dota_chatwheel_label_leshrac_laugh"	"Laugh"
"dota_chatwheel_message_leshrac_3"	"Allt i obalansens tjänst."
"[english]dota_chatwheel_message_leshrac_3"	"Ah, all in service to imbalance."
"dota_chatwheel_label_leshrac_3"	"...i obalansens tjänst."
"[english]dota_chatwheel_label_leshrac_3"	"...in service to imbalance."
"dota_chatwheel_message_leshrac_4"	"En utebliven slutsats."
"[english]dota_chatwheel_message_leshrac_4"	"A foregone conclusion."
"dota_chatwheel_label_leshrac_4"	"En utebliven slutsats."
"[english]dota_chatwheel_label_leshrac_4"	"A foregone conclusion."
"dota_chatwheel_message_leshrac_5"	"Tusen av ditt slag har jag fällt."
"[english]dota_chatwheel_message_leshrac_5"	"A thousand of your kind have fallen before me."
"dota_chatwheel_label_leshrac_5"	"Tusen av ditt slag..."
"[english]dota_chatwheel_label_leshrac_5"	"A thousand of your kind..."
"dota_chatwheel_label_furion_laugh"	"[Skratta]"
"[english]dota_chatwheel_label_furion_laugh"	"Laugh"
"dota_chatwheel_message_furion_thank"	"Beundransvärt."
"[english]dota_chatwheel_message_furion_thank"	"Admirable."
"dota_chatwheel_label_furion_thank"	"Beundransvärt."
"[english]dota_chatwheel_label_furion_thank"	"Admirable."
"dota_chatwheel_message_furion_3"	"Mycket trevligt."
"[english]dota_chatwheel_message_furion_3"	"Very nice."
"dota_chatwheel_label_furion_3"	"Mycket trevligt."
"[english]dota_chatwheel_label_furion_3"	"Very nice."
"dota_chatwheel_message_furion_4"	"Aww, synd."
"[english]dota_chatwheel_message_furion_4"	"Aww, too bad."
"dota_chatwheel_label_furion_4"	"Aww, synd."
"[english]dota_chatwheel_label_furion_4"	"Aww, too bad."
"dota_chatwheel_message_life_stealer_laugh"	"Ha! Ha ha ha ha!"
"[english]dota_chatwheel_message_life_stealer_laugh"	"Ha! Ha ha ha ha!"
"dota_chatwheel_label_life_stealer_laugh"	"[Skratta]"
"[english]dota_chatwheel_label_life_stealer_laugh"	"Laugh"
"dota_chatwheel_message_life_stealer_deny"	"Överraskning!"
"[english]dota_chatwheel_message_life_stealer_deny"	"Surprise!"
"dota_chatwheel_label_life_stealer_deny"	"Överraskning!"
"[english]dota_chatwheel_label_life_stealer_deny"	"Surprise!"
"dota_chatwheel_message_life_stealer_2"	"Ensam med min ilska!"
"[english]dota_chatwheel_message_life_stealer_2"	"Alone with my rage!"
"dota_chatwheel_label_life_stealer_2"	"Ensam med min ilska!"
"[english]dota_chatwheel_label_life_stealer_2"	"Alone with my rage!"
"dota_chatwheel_message_life_stealer_5"	"Ta-da!"
"[english]dota_chatwheel_message_life_stealer_5"	"Ta-da!"
"dota_chatwheel_label_life_stealer_5"	"Ta-da!"
"[english]dota_chatwheel_label_life_stealer_5"	"Ta-da!"
"dota_chatwheel_message_dark_seer_laugh"	"Heheh yeheheh hey heehhhe yehhey yehe heheh eheh yeh."
"[english]dota_chatwheel_message_dark_seer_laugh"	"Heheh yeheheh hey heehhhe yehhey yehe heheh eheh yeh."
"dota_chatwheel_label_dark_seer_laugh"	"[Skratta]"
"[english]dota_chatwheel_label_dark_seer_laugh"	"Laugh"
"dota_chatwheel_message_dark_seer_thank"	"Mycket bra."
"[english]dota_chatwheel_message_dark_seer_thank"	"Very good."
"dota_chatwheel_label_dark_seer_thank"	"Mycket bra."
"[english]dota_chatwheel_label_dark_seer_thank"	"Very good."
"dota_chatwheel_label_dark_seer_deny"	"Det där förutsåg du inte, eller hur?"
"[english]dota_chatwheel_label_dark_seer_deny"	"Didn't see that coming, did you?"
"dota_chatwheel_message_dark_seer_3"	"Hoooahahaaaheeh."
"[english]dota_chatwheel_message_dark_seer_3"	"Hoooahahaaaheeh."
"dota_chatwheel_label_dark_seer_3"	"Hoooahahaaaheeh."
"[english]dota_chatwheel_label_dark_seer_3"	"Hoooahahaaaheeh."
"dota_chatwheel_message_clinkz_laugh"	"Ah ha ha ha ha."
"[english]dota_chatwheel_message_clinkz_laugh"	"Ah ha ha ha ha."
"dota_chatwheel_label_clinkz_laugh"	"[Skratta]"
"[english]dota_chatwheel_label_clinkz_laugh"	"Laugh"
"dota_chatwheel_message_clinkz_thank"	"Bra gjort."
"[english]dota_chatwheel_message_clinkz_thank"	"Well done."
"dota_chatwheel_label_clinkz_thank"	"Bra gjort."
"[english]dota_chatwheel_label_clinkz_thank"	"Well done."
"dota_chatwheel_message_clinkz_4"	"Ja!"
"[english]dota_chatwheel_message_clinkz_4"	"Yes!"
"dota_chatwheel_label_clinkz_4"	"Ja!"
"[english]dota_chatwheel_label_clinkz_4"	"Yes!"
"dota_chatwheel_label_omniknight_laugh"	"[Skratta]"
"[english]dota_chatwheel_label_omniknight_laugh"	"Laugh"
"dota_chatwheel_message_omniknight_thank"	"Vackert."
"[english]dota_chatwheel_message_omniknight_thank"	"Beautiful."
"dota_chatwheel_label_omniknight_thank"	"Vackert."
"[english]dota_chatwheel_label_omniknight_thank"	"Beautiful."
"dota_chatwheel_message_omniknight_deny"	"Där satt den."
"[english]dota_chatwheel_message_omniknight_deny"	"Nailed it."
"dota_chatwheel_label_omniknight_deny"	"Där satt den."
"[english]dota_chatwheel_label_omniknight_deny"	"Nailed it."
"dota_chatwheel_message_omniknight_1"	"Ännu en fläck på slagfältet."
"[english]dota_chatwheel_message_omniknight_1"	"Another stain on the battlefield."
"dota_chatwheel_label_omniknight_1"	"Ännu en fläck på slagfältet."
"[english]dota_chatwheel_label_omniknight_1"	"Another stain on the battlefield."
"dota_chatwheel_message_omniknight_3"	"Vila i frid din usla dåre."
"[english]dota_chatwheel_message_omniknight_3"	"Be at peace you wretched fool."
"dota_chatwheel_label_omniknight_3"	"Vila i frid din usla dåre."
"[english]dota_chatwheel_label_omniknight_3"	"Be at peace you wretched fool."
"dota_chatwheel_message_enchantress_laugh"	"Ha ha ha ha ha ha ha!"
"[english]dota_chatwheel_message_enchantress_laugh"	"Ha ha ha ha ha ha ha!"
"dota_chatwheel_label_enchantress_laugh"	"[Skratta]"
"[english]dota_chatwheel_label_enchantress_laugh"	"Laugh"
"dota_chatwheel_message_enchantress_deny"	"Var inte arg."
"[english]dota_chatwheel_message_enchantress_deny"	"Don't be mad."
"dota_chatwheel_label_enchantress_deny"	"Var inte arg."
"[english]dota_chatwheel_label_enchantress_deny"	"Don't be mad."
"dota_chatwheel_message_enchantress_4"	"Sproink."
"[english]dota_chatwheel_message_enchantress_4"	"Sproink."
"dota_chatwheel_label_enchantress_4"	"Sproink."
"[english]dota_chatwheel_label_enchantress_4"	"Sproink."
"dota_chatwheel_message_huskar_laugh"	"Heh heh heeh."
"[english]dota_chatwheel_message_huskar_laugh"	"Heh heh heeh."
"dota_chatwheel_label_huskar_laugh"	"[Skratta]"
"[english]dota_chatwheel_label_huskar_laugh"	"Laugh"
"dota_chatwheel_message_huskar_thank"	"Detta kommer blidka gudarna."
"[english]dota_chatwheel_message_huskar_thank"	"Ahh, this will please the gods."
"dota_chatwheel_label_huskar_thank"	"Detta kommer blidka gudarna."
"[english]dota_chatwheel_label_huskar_thank"	"Ahh, this will please the gods."
"dota_chatwheel_message_huskar_1"	"Ännu ett bortkastat liv."
"[english]dota_chatwheel_message_huskar_1"	"Another life squandered."
"dota_chatwheel_label_huskar_1"	"Ännu ett bortkastat liv."
"[english]dota_chatwheel_label_huskar_1"	"Another life squandered."
"dota_chatwheel_message_huskar_2"	"Ett rättvist byte!"
"[english]dota_chatwheel_message_huskar_2"	"A fair trade!"
"dota_chatwheel_label_huskar_2"	"Ett rättvist byte!"
"[english]dota_chatwheel_label_huskar_2"	"A fair trade!"
"dota_chatwheel_message_huskar_4"	"Är det allt?"
"[english]dota_chatwheel_message_huskar_4"	"Is that all?"
"dota_chatwheel_label_huskar_4"	"Är det allt?"
"[english]dota_chatwheel_label_huskar_4"	"Is that all?"
"dota_chatwheel_message_night_stalker_laugh"	"Heh heh heh hah heh hehhhh."
"[english]dota_chatwheel_message_night_stalker_laugh"	"Heh heh heh hah heh hehhhh."
"dota_chatwheel_label_night_stalker_laugh"	"[Skratta]"
"[english]dota_chatwheel_label_night_stalker_laugh"	"Laugh"
"dota_chatwheel_message_broodmother_laugh"	"Ha ha ha ha ha."
"[english]dota_chatwheel_message_broodmother_laugh"	"Ha ha ha ha ha."
"dota_chatwheel_label_broodmother_laugh"	"[Skratta]"
"[english]dota_chatwheel_label_broodmother_laugh"	"Laugh"
"dota_chatwheel_label_broodmother_thank"	"Vilken härlig kull."
"[english]dota_chatwheel_label_broodmother_thank"	"A lovely brood."
"dota_chatwheel_message_broodmother_1"	"Utsökt."
"[english]dota_chatwheel_message_broodmother_1"	"Delicious."
"dota_chatwheel_label_broodmother_1"	"Utsökt."
"[english]dota_chatwheel_label_broodmother_1"	"Delicious."
"dota_chatwheel_message_broodmother_3"	"Dö inte, mina raringar."
"[english]dota_chatwheel_message_broodmother_3"	"Don't die, my darlings."
"dota_chatwheel_label_broodmother_3"	"Dö inte, mina raringar."
"[english]dota_chatwheel_label_broodmother_3"	"Don't die, my darlings."
"dota_chatwheel_label_broodmother_5"	"Slurp."
"[english]dota_chatwheel_label_broodmother_5"	"Slurp."
"dota_chatwheel_message_bounty_hunter_laugh"	"Ah ha ha ha ha ha ha ha ha."
"[english]dota_chatwheel_message_bounty_hunter_laugh"	"Ah ha ha ha ha ha ha ha ha."
"dota_chatwheel_label_bounty_hunter_laugh"	"[Skratta]"
"[english]dota_chatwheel_label_bounty_hunter_laugh"	"Laugh"
"dota_chatwheel_message_bounty_hunter_2"	"En vis jägare har tålamod."
"[english]dota_chatwheel_message_bounty_hunter_2"	"A wise hunter knows patience."
"dota_chatwheel_label_bounty_hunter_2"	"En vis jägare har tålamod."
"[english]dota_chatwheel_label_bounty_hunter_2"	"A wise hunter knows patience."
"dota_chatwheel_message_weaver_laugh"	"Hehehhehah!"
"[english]dota_chatwheel_message_weaver_laugh"	"Hehehhehah!"
"dota_chatwheel_label_weaver_laugh"	"[Skratta]"
"[english]dota_chatwheel_label_weaver_laugh"	"Laugh"
"dota_chatwheel_message_weaver_3"	"Ett mönster upprepas."
"[english]dota_chatwheel_message_weaver_3"	"A pattern repeats."
"dota_chatwheel_label_weaver_3"	"Ett mönster upprepas."
"[english]dota_chatwheel_label_weaver_3"	"A pattern repeats."
"dota_chatwheel_message_weaver_4"	"En festmåltid för mina skalbaggar."
"[english]dota_chatwheel_message_weaver_4"	"A feast for my beetles."
"dota_chatwheel_label_weaver_4"	"En festmåltid för mina skalbaggar."
"[english]dota_chatwheel_label_weaver_4"	"A feast for my beetles."
"dota_chatwheel_message_weaver_5"	"Ho, snap!"
"[english]dota_chatwheel_message_weaver_5"	"Ho, snap!"
"dota_chatwheel_label_weaver_5"	"Ho, snap!"
"[english]dota_chatwheel_label_weaver_5"	"Ho, snap!"
"dota_chatwheel_label_jakiro_laugh"	"[Skratta]"
"[english]dota_chatwheel_label_jakiro_laugh"	"Laugh"
"dota_chatwheel_message_jakiro_1"	"Bränd."
"[english]dota_chatwheel_message_jakiro_1"	"Burninated."
"dota_chatwheel_label_jakiro_1"	"BRÄND!"
"[english]dota_chatwheel_label_jakiro_1"	"Burninated!"
"dota_chatwheel_message_batrider_laugh"	"He ha ha!"
"[english]dota_chatwheel_message_batrider_laugh"	"He ha ha!"
"dota_chatwheel_label_batrider_laugh"	"[Skratta]"
"[english]dota_chatwheel_label_batrider_laugh"	"Laugh"
"dota_chatwheel_message_chen_laugh"	"Hehehmehmehmmm."
"[english]dota_chatwheel_message_chen_laugh"	"Hehehmehmehmmm."
"dota_chatwheel_label_chen_laugh"	"[Skratta]"
"[english]dota_chatwheel_label_chen_laugh"	"Laugh"
"dota_chatwheel_message_chen_5"	"En uppfyllelse av profetian."
"[english]dota_chatwheel_message_chen_5"	"A fulfillment of the prophecy."
"dota_chatwheel_label_chen_5"	"En uppfyllelse av profetian."
"[english]dota_chatwheel_label_chen_5"	"A fulfillment of the prophecy."
"dota_chatwheel_label_spectre_laugh"	"[Skratta]"
"[english]dota_chatwheel_label_spectre_laugh"	"[Laugh]"
"dota_chatwheel_message_spectre_1"	"En användbar förmåga."
"[english]dota_chatwheel_message_spectre_1"	"I do not understand."
"dota_chatwheel_label_spectre_1"	"En användbar förmåga."
"[english]dota_chatwheel_label_spectre_1"	"I do not understand."
"dota_chatwheel_message_spectre_2"	"Nonsens."
"[english]dota_chatwheel_message_spectre_2"	"What is this?"
"dota_chatwheel_label_spectre_2"	"Nonsens."
"[english]dota_chatwheel_label_spectre_2"	"What is this?"
"dota_chatwheel_message_spectre_4"	"Så verkar det."
"[english]dota_chatwheel_message_spectre_4"	"Can no one understand me?"
"dota_chatwheel_label_spectre_4"	"Så verkar det."
"[english]dota_chatwheel_label_spectre_4"	"Can no one understand me?"
"dota_chatwheel_message_ancient_apparition_laugh"	"Hm hm hm ha ha ha ha ha ha ha!"
"[english]dota_chatwheel_message_ancient_apparition_laugh"	"Hm hm hm ha ha ha ha ha ha ha!"
"dota_chatwheel_label_ancient_apparition_laugh"	"[Skratta]"
"[english]dota_chatwheel_label_ancient_apparition_laugh"	"Laugh"
"dota_chatwheel_message_ancient_apparition_thank"	"Intressant."
"[english]dota_chatwheel_message_ancient_apparition_thank"	"Interesting."
"dota_chatwheel_label_ancient_apparition_thank"	"Intressant."
"[english]dota_chatwheel_label_ancient_apparition_thank"	"Interesting."
"dota_chatwheel_message_ancient_apparition_deny"	"Det blåser en kall vind."
"[english]dota_chatwheel_message_ancient_apparition_deny"	"A cold wind blows."
"dota_chatwheel_label_ancient_apparition_deny"	"Det blåser en kall vind."
"[english]dota_chatwheel_label_ancient_apparition_deny"	"A cold wind blows."
"dota_chatwheel_label_ancient_apparition_4"	"Bryta isen."
"[english]dota_chatwheel_label_ancient_apparition_4"	"Break the ice."
"dota_chatwheel_message_ancient_apparition_5"	"Icefog!"
"[english]dota_chatwheel_message_ancient_apparition_5"	"Icefog!"
"dota_chatwheel_label_ancient_apparition_5"	"Icefog!"
"[english]dota_chatwheel_label_ancient_apparition_5"	"Icefog!"
"dota_chatwheel_label_doom_bringer_laugh"	"[Skratta]"
"[english]dota_chatwheel_label_doom_bringer_laugh"	"Laugh"
"dota_chatwheel_message_doom_bringer_thank"	"Åh ja."
"[english]dota_chatwheel_message_doom_bringer_thank"	"Oh, yes."
"dota_chatwheel_label_doom_bringer_thank"	"Åh ja."
"[english]dota_chatwheel_label_doom_bringer_thank"	"Oh, yes."
"dota_chatwheel_message_doom_bringer_5"	"Helvetet brakar lös."
"[english]dota_chatwheel_message_doom_bringer_5"	"All hell's broken loose."
"dota_chatwheel_label_doom_bringer_5"	"Helvetet brakar lös."
"[english]dota_chatwheel_label_doom_bringer_5"	"All hell's broken loose."
"dota_chatwheel_message_ursa_laugh"	"Hah! Hah! Hah-hah-hah!"
"[english]dota_chatwheel_message_ursa_laugh"	"Hah! Hah! Hah-hah-hah!"
"dota_chatwheel_label_ursa_laugh"	"[Skratta]"
"[english]dota_chatwheel_label_ursa_laugh"	"Laugh"
"dota_chatwheel_message_ursa_1"	"Ett dåligt försvar."
"[english]dota_chatwheel_message_ursa_1"	"A poor defense."
"dota_chatwheel_label_ursa_1"	"Ett dåligt försvar."
"[english]dota_chatwheel_label_ursa_1"	"A poor defense."
"dota_chatwheel_label_ursa_5"	"Mm, inte illa."
"[english]dota_chatwheel_label_ursa_5"	"Mm, not bad."
"dota_chatwheel_message_spirit_breaker_laugh"	"Whoheheheahahah."
"[english]dota_chatwheel_message_spirit_breaker_laugh"	"Whoheheheahahah."
"dota_chatwheel_label_spirit_breaker_laugh"	"[Skratta]"
"[english]dota_chatwheel_label_spirit_breaker_laugh"	"Laugh"
"dota_chatwheel_label_spirit_breaker_thank"	"Allt faller på plats."
"[english]dota_chatwheel_label_spirit_breaker_thank"	"All coming together."
"dota_chatwheel_message_gyrocopter_laugh"	"Ah ha! Wah haha ha ha! Ah ha hhuh."
"[english]dota_chatwheel_message_gyrocopter_laugh"	"Ah ha! Wah haha ha ha! Ah ha hhuh."
"dota_chatwheel_label_gyrocopter_laugh"	"[Skratta]"
"[english]dota_chatwheel_label_gyrocopter_laugh"	"Laugh"
"dota_chatwheel_message_gyrocopter_deny"	"Dumheter."
"[english]dota_chatwheel_message_gyrocopter_deny"	"Aaah phooey."
"dota_chatwheel_label_gyrocopter_deny"	"Dumheter!"
"[english]dota_chatwheel_label_gyrocopter_deny"	"Aaah phooey!"
"dota_chatwheel_message_alchemist_laugh"	"Ha ha ha ha ha!"
"[english]dota_chatwheel_message_alchemist_laugh"	"Ha ha ha ha ha!"
"dota_chatwheel_label_alchemist_laugh"	"[Skratta]"
"[english]dota_chatwheel_label_alchemist_laugh"	"Laugh"
"dota_chatwheel_message_alchemist_4"	"Vilken röra!"
"[english]dota_chatwheel_message_alchemist_4"	"What a mess!"
"dota_chatwheel_label_alchemist_4"	"Vilken röra!"
"[english]dota_chatwheel_label_alchemist_4"	"What a mess!"
"dota_chatwheel_message_invoker_laugh"	"Ha ha ha ha ha ha ha ha ha ha!"
"[english]dota_chatwheel_message_invoker_laugh"	"Ha ha ha ha ha ha ha ha ha ha!"
"dota_chatwheel_label_invoker_laugh"	"[Skratta]"
"[english]dota_chatwheel_label_invoker_laugh"	"Laugh"
"dota_chatwheel_message_invoker_1"	"Hörde jag ett pip?"
"[english]dota_chatwheel_message_invoker_1"	"Did I hear a squeak?"
"dota_chatwheel_label_invoker_1"	"Hörde jag ett pip?"
"[english]dota_chatwheel_label_invoker_1"	"Did I hear a squeak?"
"dota_chatwheel_message_invoker_3"	"Blandade jag min magi?"
"[english]dota_chatwheel_message_invoker_3"	"Did I mix my magics?"
"dota_chatwheel_label_invoker_3"	"Blandade jag min magi?"
"[english]dota_chatwheel_label_invoker_3"	"Did I mix my magics?"
"dota_chatwheel_message_silencer_laugh"	"Ah ha ha."
"[english]dota_chatwheel_message_silencer_laugh"	"Ah ha ha."
"dota_chatwheel_label_silencer_laugh"	"[Skratta]"
"[english]dota_chatwheel_label_silencer_laugh"	"Laugh"
"dota_chatwheel_message_silencer_1"	"Lugna ned er."
"[english]dota_chatwheel_message_silencer_1"	"Calm yourselves."
"dota_chatwheel_label_silencer_1"	"Lugna ned er."
"[english]dota_chatwheel_label_silencer_1"	"Calm yourselves"
"dota_chatwheel_message_silencer_4"	"Allt för inget."
"[english]dota_chatwheel_message_silencer_4"	"All for naught."
"dota_chatwheel_label_silencer_4"	"Allt för inget."
"[english]dota_chatwheel_label_silencer_4"	"All for naught."
"dota_chatwheel_message_obsidian_destroyer_laugh"	"Ha ha ha ha ha ha ha ha ha!"
"[english]dota_chatwheel_message_obsidian_destroyer_laugh"	"Ha ha ha ha ha ha ha ha ha!"
"dota_chatwheel_label_obsidian_destroyer_laugh"	"[Skratta]"
"[english]dota_chatwheel_label_obsidian_destroyer_laugh"	"Laugh"
"dota_chatwheel_message_lycan_laugh"	"Ah ha ha ha ha ha ha ha."
"[english]dota_chatwheel_message_lycan_laugh"	"Ah ha ha ha ha ha ha ha."
"dota_chatwheel_label_lycan_laugh"	"[Skratta]"
"[english]dota_chatwheel_label_lycan_laugh"	"Laugh"
"dota_chatwheel_message_brewmaster_laugh"	"Hehaahehah."
"[english]dota_chatwheel_message_brewmaster_laugh"	"Hehaahehah."
"dota_chatwheel_label_brewmaster_laugh"	"[Skratta]"
"[english]dota_chatwheel_label_brewmaster_laugh"	"Laugh"
"dota_chatwheel_message_brewmaster_thank"	"Jag älskar er, grabbar."
"[english]dota_chatwheel_message_brewmaster_thank"	"Ah, I love you guys."
"dota_chatwheel_message_brewmaster_deny"	"Bättre lycka nästa gång."
"[english]dota_chatwheel_message_brewmaster_deny"	"Better luck next time."
"dota_chatwheel_label_brewmaster_deny"	"Bättre lycka nästa gång."
"[english]dota_chatwheel_label_brewmaster_deny"	"Better luck next time."
"dota_chatwheel_message_shadow_demon_laugh"	"Ha ha ha ha ha ha ha ha ha ha."
"[english]dota_chatwheel_message_shadow_demon_laugh"	"Ha ha ha ha ha ha ha ha ha ha."
"dota_chatwheel_label_shadow_demon_laugh"	"[Skratta]"
"[english]dota_chatwheel_label_shadow_demon_laugh"	"Laugh"
"dota_chatwheel_message_shadow_demon_thank"	"Och de trodde att det inte kunde bli mörkare."
"[english]dota_chatwheel_message_shadow_demon_thank"	"And they thought it could get no darker."
"dota_chatwheel_message_shadow_demon_4"	"Buga."
"[english]dota_chatwheel_message_shadow_demon_4"	"Bow down."
"dota_chatwheel_label_shadow_demon_4"	"Buga."
"[english]dota_chatwheel_label_shadow_demon_4"	"Bow down."
"dota_chatwheel_message_shadow_demon_5"	"Gråt lite mer."
"[english]dota_chatwheel_message_shadow_demon_5"	"Cry some more."
"dota_chatwheel_label_shadow_demon_5"	"Gråt lite mer."
"[english]dota_chatwheel_label_shadow_demon_5"	"Cry some more."
"dota_chatwheel_message_lone_druid_laugh"	"Ah ha ha ha ha hah!"
"[english]dota_chatwheel_message_lone_druid_laugh"	"Ah ha ha ha ha hah!"
"dota_chatwheel_label_lone_druid_laugh"	"[Skratta]"
"[english]dota_chatwheel_label_lone_druid_laugh"	"Laugh"
"dota_chatwheel_message_lone_druid_deny"	"Ah, mitt gamla jag!"
"[english]dota_chatwheel_message_lone_druid_deny"	"Ah, my old self!"
"dota_chatwheel_label_lone_druid_deny"	"Ah, mitt gamla jag!"
"[english]dota_chatwheel_label_lone_druid_deny"	"Ah, my old self!"
"dota_chatwheel_message_lone_druid_1"	"Synergi!"
"[english]dota_chatwheel_message_lone_druid_1"	"Synergy!"
"dota_chatwheel_label_lone_druid_1"	"Synergi!"
"[english]dota_chatwheel_label_lone_druid_1"	"Synergy!"
"dota_chatwheel_message_lone_druid_3"	"Ett värdigt utbyte."
"[english]dota_chatwheel_message_lone_druid_3"	"A worthy exchange."
"dota_chatwheel_label_lone_druid_3"	"Ett värdigt utbyte."
"[english]dota_chatwheel_label_lone_druid_3"	"A worthy exchange."
"dota_chatwheel_message_lone_druid_5"	"Auuuuuhhh!"
"[english]dota_chatwheel_message_lone_druid_5"	"Auuuuuhhh!"
"dota_chatwheel_label_lone_druid_5"	"Auuuuuhhh!"
"[english]dota_chatwheel_label_lone_druid_5"	"Auuuuuhhh!"
"dota_chatwheel_message_chaos_knight_laugh"	"Oo ho ho ha ha ha ha ha ha ha ha ha ha ha!"
"[english]dota_chatwheel_message_chaos_knight_laugh"	"Oo ho ho ha ha ha ha ha ha ha ha ha ha ha!"
"dota_chatwheel_label_chaos_knight_laugh"	"[Skratta]"
"[english]dota_chatwheel_label_chaos_knight_laugh"	"Laugh"
"dota_chatwheel_message_chaos_knight_thank"	"Ja. Ja!"
"[english]dota_chatwheel_message_chaos_knight_thank"	"Yes. Yes!"
"dota_chatwheel_label_chaos_knight_thank"	"Ja. Ja!"
"[english]dota_chatwheel_label_chaos_knight_thank"	"Yes. Yes!"
"dota_chatwheel_label_meepo_laugh"	"[Skratta]"
"[english]dota_chatwheel_label_meepo_laugh"	"Laugh"
"dota_chatwheel_message_meepo_deny"	"Hur e' läget?"
"[english]dota_chatwheel_message_meepo_deny"	"How ya doin?"
"dota_chatwheel_label_meepo_deny"	"Hur e' läget?"
"[english]dota_chatwheel_label_meepo_deny"	"How ya doin?"
"dota_chatwheel_message_meepo_1"	"Men va' fasen!"
"[english]dota_chatwheel_message_meepo_1"	"Ah for cryin' out loud!"
"dota_chatwheel_message_treant_laugh"	"Ah ho ho ho hoooo ho ho ho hm hm hm."
"[english]dota_chatwheel_message_treant_laugh"	"Ah ho ho ho hoooo ho ho ho hm hm hm."
"dota_chatwheel_label_treant_laugh"	"[Skratta]"
"[english]dota_chatwheel_label_treant_laugh"	"Laugh"
"dota_chatwheel_message_treant_1"	"Är du vilse?"
"[english]dota_chatwheel_message_treant_1"	"Are you lost?"
"dota_chatwheel_label_treant_1"	"Är du vilse?"
"[english]dota_chatwheel_label_treant_1"	"Are you lost?"
"dota_chatwheel_message_treant_2"	"Försiktigt."
"[english]dota_chatwheel_message_treant_2"	"Careful."
"dota_chatwheel_label_treant_2"	"Försiktigt."
"[english]dota_chatwheel_label_treant_2"	"Careful."
"dota_chatwheel_message_treant_4"	"Ah, färsk gödsel."
"[english]dota_chatwheel_message_treant_4"	"Ah, fresh fertilizer."
"dota_chatwheel_label_treant_4"	"Ah, färsk gödsel."
"[english]dota_chatwheel_label_treant_4"	"Ah, fresh fertilizer."
"dota_chatwheel_label_ogre_magi_laugh"	"[Skratta]"
"[english]dota_chatwheel_label_ogre_magi_laugh"	"Laugh"
"dota_chatwheel_label_ogre_magi_2"	"Bra jobbat!"
"[english]dota_chatwheel_label_ogre_magi_2"	"Good work!"
"dota_chatwheel_label_undying_laugh"	"[Skratta]"
"[english]dota_chatwheel_label_undying_laugh"	"Laugh"
"dota_chatwheel_label_undying_2"	"Nu fattar jag."
"[english]dota_chatwheel_label_undying_2"	"I need… gummy vitamins."
"dota_chatwheel_label_undying_3"	"Bara detta."
"[english]dota_chatwheel_label_undying_3"	"Only this."
"dota_chatwheel_message_undying_5"	"Ingen hjärna."
"[english]dota_chatwheel_message_undying_5"	"No brains."
"dota_chatwheel_label_undying_5"	"Ingen hjärna."
"[english]dota_chatwheel_label_undying_5"	"No brains."
"dota_chatwheel_message_rubick_laugh"	"Ah ha ha! Eh he he he he he he he he he!"
"[english]dota_chatwheel_message_rubick_laugh"	"Ah ha ha! Eh he he he he he he he he he!"
"dota_chatwheel_label_rubick_laugh"	"[Skratta]"
"[english]dota_chatwheel_label_rubick_laugh"	"Laugh"
"dota_chatwheel_message_rubick_4"	"Whoops!"
"[english]dota_chatwheel_message_rubick_4"	"Whoops!"
"dota_chatwheel_label_rubick_4"	"Whoops!"
"[english]dota_chatwheel_label_rubick_4"	"Whoops!"
"dota_chatwheel_label_rubick_5"	"Enastående!"
"[english]dota_chatwheel_label_rubick_5"	"Exquisite!"
"dota_chatwheel_message_disruptor_laugh"	"Heheha."
"[english]dota_chatwheel_message_disruptor_laugh"	"Heheha."
"dota_chatwheel_label_disruptor_laugh"	"[Skratta]"
"[english]dota_chatwheel_label_disruptor_laugh"	"Laugh"
"dota_chatwheel_label_disruptor_2"	"Avbruten"
"[english]dota_chatwheel_label_disruptor_2"	"Disrupted"
"dota_chatwheel_message_disruptor_4"	"Avbröt jag dig?"
"[english]dota_chatwheel_message_disruptor_4"	"I call down the thunder."
"dota_chatwheel_label_disruptor_5"	"Se där ja."
"[english]dota_chatwheel_label_disruptor_5"	"Look at that"
"dota_chatwheel_message_nyx_assassin_laugh"	"Heehehheh Nyx, Nyx."
"[english]dota_chatwheel_message_nyx_assassin_laugh"	"Heehehheh Nyx, Nyx."
"dota_chatwheel_label_nyx_assassin_laugh"	"[Skratta]"
"[english]dota_chatwheel_label_nyx_assassin_laugh"	"Laugh"
"dota_chatwheel_message_nyx_assassin_1"	"Talanglös."
"[english]dota_chatwheel_message_nyx_assassin_1"	"Talentless."
"dota_chatwheel_label_nyx_assassin_1"	"Talanglös."
"[english]dota_chatwheel_label_nyx_assassin_1"	"Talentless"
"dota_chatwheel_message_nyx_assassin_2"	"Nyx chichcichcihcihchi."
"[english]dota_chatwheel_message_nyx_assassin_2"	"Nyx chichcichcihcihchi."
"dota_chatwheel_label_nyx_assassin_2"	"Nyx chichcichcihcihchi."
"[english]dota_chatwheel_label_nyx_assassin_2"	"Nyx chichcichcihcihchi."
"dota_chatwheel_message_nyx_assassin_4"	"Lönnmördad."
"[english]dota_chatwheel_message_nyx_assassin_4"	"Assassinated."
"dota_chatwheel_label_nyx_assassin_4"	"Lönnmördad."
"[english]dota_chatwheel_label_nyx_assassin_4"	"Assassinated."
"dota_chatwheel_message_nyx_assassin_5"	"Nyx, Nyx, Nyx, Nyx."
"[english]dota_chatwheel_message_nyx_assassin_5"	"Nyx, Nyx, Nyx, Nyx."
"dota_chatwheel_label_nyx_assassin_5"	"Nyx, Nyx, Nyx, Nyx."
"[english]dota_chatwheel_label_nyx_assassin_5"	"Nyx, Nyx, Nyx, Nyx."
"dota_chatwheel_message_naga_siren_laugh"	"Ahehehaheh."
"[english]dota_chatwheel_message_naga_siren_laugh"	"Ahehehaheh."
"dota_chatwheel_label_naga_siren_laugh"	"[Skratta]"
"[english]dota_chatwheel_label_naga_siren_laugh"	"Laugh"
"dota_chatwheel_message_naga_siren_deny"	"En dålig ton."
"[english]dota_chatwheel_message_naga_siren_deny"	"A sour note."
"dota_chatwheel_label_naga_siren_deny"	"En dålig ton."
"[english]dota_chatwheel_label_naga_siren_deny"	"A sour note."
"dota_chatwheel_label_naga_siren_5"	"Mina ben!"
"[english]dota_chatwheel_label_naga_siren_5"	"My legs!"
"dota_chatwheel_label_keeper_of_the_light_laugh"	"[Skratta]"
"[english]dota_chatwheel_label_keeper_of_the_light_laugh"	"Laugh"
"dota_chatwheel_message_keeper_of_the_light_deny"	"Ingen mana."
"[english]dota_chatwheel_message_keeper_of_the_light_deny"	"No mana."
"dota_chatwheel_label_keeper_of_the_light_deny"	"Ingen mana!"
"[english]dota_chatwheel_label_keeper_of_the_light_deny"	"No mana!"
"dota_chatwheel_message_keeper_of_the_light_5"	"Ah hah, ah ha ha, öh va?"
"[english]dota_chatwheel_message_keeper_of_the_light_5"	"Do not fear the light - fear me!"
"dota_chatwheel_label_keeper_of_the_light_5"	"Ah hah, ah ha ha, öh va?"
"[english]dota_chatwheel_label_keeper_of_the_light_5"	"Do not fear the light..."
"dota_chatwheel_message_wisp_4"	"[Arga pip]"
"[english]dota_chatwheel_message_wisp_4"	"Angry Beeps"
"dota_chatwheel_label_wisp_4"	"[Arga pip]"
"[english]dota_chatwheel_label_wisp_4"	"Angry Beeps"
"dota_chatwheel_message_visage_laugh"	"Ah ha ha ha ha ha ha ha ha!"
"[english]dota_chatwheel_message_visage_laugh"	"Ah ha ha ha ha ha ha ha ha!"
"dota_chatwheel_label_visage_laugh"	"[Skratta]"
"[english]dota_chatwheel_label_visage_laugh"	"Laugh"
"dota_chatwheel_message_visage_deny"	"Du igen?"
"[english]dota_chatwheel_message_visage_deny"	"You again?"
"dota_chatwheel_label_visage_deny"	"Du igen?"
"[english]dota_chatwheel_label_visage_deny"	"You again?"
"dota_chatwheel_message_visage_1"	"Och så dör du."
"[english]dota_chatwheel_message_visage_1"	"And so you die."
"dota_chatwheel_label_visage_1"	"Och så dör du."
"[english]dota_chatwheel_label_visage_1"	"And so you die."
"dota_chatwheel_message_visage_5"	"Ahh detta är mycket bättre."
"[english]dota_chatwheel_message_visage_5"	"Ahh this is much better."
"dota_chatwheel_label_visage_5"	"Mycket bättre"
"[english]dota_chatwheel_label_visage_5"	"Much better"
"dota_chatwheel_label_slark_laugh"	"[Skratta]"
"[english]dota_chatwheel_label_slark_laugh"	"Laugh"
"dota_chatwheel_label_slark_4"	"Värt besväret."
"[english]dota_chatwheel_label_slark_4"	"All worth while."
"dota_chatwheel_message_medusa_laugh"	"Hmm hmm hmm ha ha ha ha ha!"
"[english]dota_chatwheel_message_medusa_laugh"	"Hmm hmm hmm ha ha ha ha ha!"
"dota_chatwheel_label_medusa_laugh"	"[Skratta]"
"[english]dota_chatwheel_label_medusa_laugh"	"Laugh"
"dota_chatwheel_message_medusa_thank"	"Briljant."
"[english]dota_chatwheel_message_medusa_thank"	"Brilliant."
"dota_chatwheel_label_medusa_thank"	"Briljant."
"[english]dota_chatwheel_label_medusa_thank"	"Brilliant."
"dota_chatwheel_message_troll_warlord_laugh"	"Yaaahahahaahhah."
"[english]dota_chatwheel_message_troll_warlord_laugh"	"Yaaahahahaahhah."
"dota_chatwheel_label_troll_warlord_laugh"	"[Skratta]"
"[english]dota_chatwheel_label_troll_warlord_laugh"	"Laugh"
"dota_chatwheel_message_troll_warlord_thank"	"Gå loss!"
"[english]dota_chatwheel_message_troll_warlord_thank"	"Go crazy!"
"dota_chatwheel_label_troll_warlord_thank"	"Gå loss!"
"[english]dota_chatwheel_label_troll_warlord_thank"	"Go crazy!"
"dota_chatwheel_message_troll_warlord_deny"	"Beklagligt."
"[english]dota_chatwheel_message_troll_warlord_deny"	"Unfortunate."
"dota_chatwheel_label_troll_warlord_deny"	"Beklagligt."
"[english]dota_chatwheel_label_troll_warlord_deny"	"Unfortunate."
"dota_chatwheel_message_troll_warlord_1"	"Kom tillbaks och dö igen."
"[english]dota_chatwheel_message_troll_warlord_1"	"Come back and die again."
"dota_chatwheel_label_troll_warlord_1"	"Kom tillbaks..."
"[english]dota_chatwheel_label_troll_warlord_1"	"Come back..."
"dota_chatwheel_message_centaur_laugh"	"Heheeeh hahah ehha."
"[english]dota_chatwheel_message_centaur_laugh"	"Heheeeh hahah ehha."
"dota_chatwheel_label_centaur_laugh"	"[Skratta]"
"[english]dota_chatwheel_label_centaur_laugh"	"Laugh"
"dota_chatwheel_message_centaur_deny"	"Stampad."
"[english]dota_chatwheel_message_centaur_deny"	"Stomped."
"dota_chatwheel_label_centaur_deny"	"Stampad."
"[english]dota_chatwheel_label_centaur_deny"	"Stomped."
"dota_chatwheel_message_centaur_1"	"Mmmmm."
"[english]dota_chatwheel_message_centaur_1"	"Mmmmm."
"dota_chatwheel_label_centaur_1"	"Mmmmmm."
"[english]dota_chatwheel_label_centaur_1"	"Mmmmmm."
"dota_chatwheel_message_centaur_3"	"Tillbaks till helvetet med dig."
"[english]dota_chatwheel_message_centaur_3"	"Back to hell with you."
"dota_chatwheel_label_centaur_3"	"Tillbaks till helvetet med dig."
"[english]dota_chatwheel_label_centaur_3"	"Back to hell with you."
"dota_chatwheel_message_magnataur_laugh"	"Ah ha ha."
"[english]dota_chatwheel_message_magnataur_laugh"	"Ah ha ha."
"dota_chatwheel_label_magnataur_laugh"	"[Skratta]"
"[english]dota_chatwheel_label_magnataur_laugh"	"Laugh"
"dota_chatwheel_message_magnataur_2"	"Skämtar du med mig?"
"[english]dota_chatwheel_message_magnataur_2"	"Are you kidding me?"
"dota_chatwheel_label_magnataur_2"	"Skämtar du med mig?"
"[english]dota_chatwheel_label_magnataur_2"	"Are you kidding me?"
"dota_chatwheel_message_magnataur_3"	"Allt på en arbetsdag."
"[english]dota_chatwheel_message_magnataur_3"	"All in a day's work."
"dota_chatwheel_label_magnataur_3"	"Allt på en arbetsdag."
"[english]dota_chatwheel_label_magnataur_3"	"All in a day's work."
"dota_chatwheel_message_shredder_laugh"	"He he he he he!"
"[english]dota_chatwheel_message_shredder_laugh"	"He he he he he!"
"dota_chatwheel_label_shredder_laugh"	"[Skratta]"
"[english]dota_chatwheel_label_shredder_laugh"	"Laugh"
"dota_chatwheel_label_shredder_deny"	"Är du galen?"
"[english]dota_chatwheel_label_shredder_deny"	"You mad?"
"dota_chatwheel_message_shredder_1"	"Oh yeah ha ha."
"[english]dota_chatwheel_message_shredder_1"	"Oh yeah ha ha."
"dota_chatwheel_label_shredder_1"	"Oh yeah ha ha."
"[english]dota_chatwheel_label_shredder_1"	"Oh yeah ha ha."
"dota_chatwheel_message_bristleback_laugh"	"Hehey hahaha."
"[english]dota_chatwheel_message_bristleback_laugh"	"Hehey hahaha."
"dota_chatwheel_label_bristleback_laugh"	"[Skratta]"
"[english]dota_chatwheel_label_bristleback_laugh"	"Laugh"
"dota_chatwheel_message_bristleback_deny"	"Nu mår jag bättre."
"[english]dota_chatwheel_message_bristleback_deny"	"Ah, now I feel better."
"dota_chatwheel_message_bristleback_2"	"Du skojar."
"[english]dota_chatwheel_message_bristleback_2"	"No way."
"dota_chatwheel_label_bristleback_2"	"Du skojar."
"[english]dota_chatwheel_label_bristleback_2"	"No way."
"dota_chatwheel_label_tusk_laugh"	"[Skratta]"
"[english]dota_chatwheel_label_tusk_laugh"	"Laugh"
"dota_chatwheel_message_tusk_1"	"Är du okej?"
"[english]dota_chatwheel_message_tusk_1"	"Are you okay?"
"dota_chatwheel_label_tusk_1"	"Är du okej?"
"[english]dota_chatwheel_label_tusk_1"	"Are you ok?"
"dota_chatwheel_message_tusk_2"	"Dohmvzm!"
"[english]dota_chatwheel_message_tusk_2"	"Dohmvzm!"
"dota_chatwheel_label_tusk_2"	"Dohmvzm!"
"[english]dota_chatwheel_label_tusk_2"	"Dohmvzm!"
"dota_chatwheel_label_tusk_5"	"Stort misslyckande."
"[english]dota_chatwheel_label_tusk_5"	"Big ball of failure."
"dota_chatwheel_message_skywrath_mage_laugh"	"Ha ha!"
"[english]dota_chatwheel_message_skywrath_mage_laugh"	"Ha ha!"
"dota_chatwheel_label_skywrath_mage_laugh"	"[Skratta]"
"[english]dota_chatwheel_label_skywrath_mage_laugh"	"Laugh"
"dota_chatwheel_message_skywrath_mage_deny"	"Ner med dig!"
"[english]dota_chatwheel_message_skywrath_mage_deny"	"Down you go!"
"dota_chatwheel_label_skywrath_mage_deny"	"
Ner med dig!"
"[english]dota_chatwheel_label_skywrath_mage_deny"	"Down you go!"
"dota_chatwheel_message_skywrath_mage_1"	"Tusan!"
"[english]dota_chatwheel_message_skywrath_mage_1"	"Ai, me!"
"dota_chatwheel_label_skywrath_mage_1"	"Tusan!"
"[english]dota_chatwheel_label_skywrath_mage_1"	"Ai, me!"
"dota_chatwheel_message_abaddon_laugh"	"Ha ha ha ha ha ha ha ha ha."
"[english]dota_chatwheel_message_abaddon_laugh"	"Ha ha ha ha ha ha ha ha ha."
"dota_chatwheel_label_abaddon_laugh"	"[Skratta]"
"[english]dota_chatwheel_label_abaddon_laugh"	"Laugh"
"dota_chatwheel_message_abaddon_deny"	"Aldrig."
"[english]dota_chatwheel_message_abaddon_deny"	"Never."
"dota_chatwheel_label_abaddon_deny"	"Aldrig."
"[english]dota_chatwheel_label_abaddon_deny"	"Never."
"dota_chatwheel_message_abaddon_1"	"Buga för din herre."
"[english]dota_chatwheel_message_abaddon_1"	"Bow to your lord."
"dota_chatwheel_label_abaddon_1"	"Buga för din herre."
"[english]dota_chatwheel_label_abaddon_1"	"Bow to your lord."
"dota_chatwheel_message_abaddon_4"	"Med vilken rätt går du här?"
"[english]dota_chatwheel_message_abaddon_4"	"By what right do you tread here?"
"dota_chatwheel_label_abaddon_4"	"Med vilken rätt..."
"[english]dota_chatwheel_label_abaddon_4"	"By what right..."
"dota_chatwheel_message_elder_titan_laugh"	"Eh ha ha ha ha ha."
"[english]dota_chatwheel_message_elder_titan_laugh"	"Eh ha ha ha ha ha."
"dota_chatwheel_label_elder_titan_laugh"	"[Skratta]"
"[english]dota_chatwheel_label_elder_titan_laugh"	"Laugh"
"dota_chatwheel_message_elder_titan_4"	"Ett ynkligt försök."
"[english]dota_chatwheel_message_elder_titan_4"	"A pitiable attempt."
"dota_chatwheel_label_elder_titan_4"	"Ett ynkligt försök."
"[english]dota_chatwheel_label_elder_titan_4"	"A pitiable attempt."
"dota_chatwheel_message_legion_commander_laugh"	"Ah ha ha ha ha ha ha!"
"[english]dota_chatwheel_message_legion_commander_laugh"	"Ah ha ha ha ha ha ha!"
"dota_chatwheel_label_legion_commander_laugh"	"[Skratta]"
"[english]dota_chatwheel_label_legion_commander_laugh"	"Laugh"
"dota_chatwheel_message_legion_commander_deny"	"Ansträng dig mer."
"[english]dota_chatwheel_message_legion_commander_deny"	"Try harder."
"dota_chatwheel_label_legion_commander_deny"	"Ansträng dig mer."
"[english]dota_chatwheel_label_legion_commander_deny"	"Try Harder."
"dota_chatwheel_label_techies_laugh"	"[Skratt]"
"[english]dota_chatwheel_label_techies_laugh"	"Laugh"
"dota_chatwheel_label_techies_thank"	"Roligt!"
"[english]dota_chatwheel_label_techies_thank"	"Fun!"
"dota_chatwheel_message_techies_1"	"Skit också!"
"[english]dota_chatwheel_message_techies_1"	"Oh crap!"
"dota_chatwheel_label_techies_1"	"Skit också!"
"[english]dota_chatwheel_label_techies_1"	"Oh crap!"
"dota_chatwheel_message_techies_3"	"Fick dig!"
"[english]dota_chatwheel_message_techies_3"	"Gotcha!"
"dota_chatwheel_label_techies_3"	"Fick dig!"
"[english]dota_chatwheel_label_techies_3"	"Gotcha!"
"dota_chatwheel_label_techies_4"	"Varsågod och sitt."
"[english]dota_chatwheel_label_techies_4"	"Have a seat."
"dota_chatwheel_message_ember_spirit_laugh"	"Eh he he he he he!"
"[english]dota_chatwheel_message_ember_spirit_laugh"	"Eh he he he he he!"
"dota_chatwheel_label_ember_spirit_laugh"	"[Skratta]"
"[english]dota_chatwheel_label_ember_spirit_laugh"	"Laugh"
"dota_chatwheel_message_earth_spirit_laugh"	"Oh ho ho ha ha ha ha ha ha!"
"[english]dota_chatwheel_message_earth_spirit_laugh"	"Oh ho ho ha ha ha ha ha ha!"
"dota_chatwheel_label_earth_spirit_laugh"	"[Skratta]"
"[english]dota_chatwheel_label_earth_spirit_laugh"	"Laugh"
"dota_chatwheel_message_earth_spirit_thank"	"Du är bäst."
"[english]dota_chatwheel_message_earth_spirit_thank"	"You rock."
"dota_chatwheel_label_earth_spirit_thank"	"Du är bäst."
"[english]dota_chatwheel_label_earth_spirit_thank"	"You rock."
"dota_chatwheel_message_earth_spirit_1"	"Va?"
"[english]dota_chatwheel_message_earth_spirit_1"	"What?"
"dota_chatwheel_label_earth_spirit_1"	"Va?"
"[english]dota_chatwheel_label_earth_spirit_1"	"What?"
"dota_chatwheel_message_abyssal_underlord_laugh"	"Ah ha ha ha ha ha ha ha ha!"
"[english]dota_chatwheel_message_abyssal_underlord_laugh"	"Ah ha ha ha ha ha ha ha ha!"
"dota_chatwheel_label_abyssal_underlord_laugh"	"[Skratta]"
"[english]dota_chatwheel_label_abyssal_underlord_laugh"	"Laugh"
"dota_chatwheel_message_abyssal_underlord_deny"	"Förbannelse!"
"[english]dota_chatwheel_message_abyssal_underlord_deny"	"Curses!"
"dota_chatwheel_label_abyssal_underlord_deny"	"Förbannelse!"
"[english]dota_chatwheel_label_abyssal_underlord_deny"	"Curses!"
"dota_chatwheel_message_abyssal_underlord_1"	"Åh ja."
"[english]dota_chatwheel_message_abyssal_underlord_1"	"Oh yes."
"dota_chatwheel_label_abyssal_underlord_1"	"Åh ja."
"[english]dota_chatwheel_label_abyssal_underlord_1"	"Oh yes."
"dota_chatwheel_message_abyssal_underlord_3"	"Buga för din nya herre."
"[english]dota_chatwheel_message_abyssal_underlord_3"	"Bow to your new lord."
"dota_chatwheel_label_abyssal_underlord_3"	"Buga för din nya herre."
"[english]dota_chatwheel_label_abyssal_underlord_3"	"Bow to your new lord."
"dota_chatwheel_label_abyssal_underlord_5"	"Håll i er!"
"[english]dota_chatwheel_label_abyssal_underlord_5"	"Hold on!"
"dota_chatwheel_message_terrorblade_laugh"	"Hehahahahahh."
"[english]dota_chatwheel_message_terrorblade_laugh"	"Hehahahahahh."
"dota_chatwheel_label_terrorblade_laugh"	"[Skratta]"
"[english]dota_chatwheel_label_terrorblade_laugh"	"Laugh"
"dota_chatwheel_message_terrorblade_4"	"En vis klinga tar en dåres liv."
"[english]dota_chatwheel_message_terrorblade_4"	"A wise blade takes a fool's life."
"dota_chatwheel_label_terrorblade_4"	"Vis klinga."
"[english]dota_chatwheel_label_terrorblade_4"	"Wise blade."
"dota_chatwheel_label_terrorblade_5"	"Kom an!"
"[english]dota_chatwheel_label_terrorblade_5"	"Fight me!"
"dota_chatwheel_message_phoenix_4"	"[Argt skri]"
"[english]dota_chatwheel_message_phoenix_4"	"Angry Squawk"
"dota_chatwheel_label_phoenix_4"	"[Argt skri]"
"[english]dota_chatwheel_label_phoenix_4"	"Angry Squawk"
"dota_chatwheel_message_phoenix_5"	"[Nöjsamt skri]"
"[english]dota_chatwheel_message_phoenix_5"	"Contented Squawk"
"dota_chatwheel_label_phoenix_5"	"[Nöjsamt skri]"
"[english]dota_chatwheel_label_phoenix_5"	"Contented Squawk"
"dota_chatwheel_message_oracle_laugh"	"He ha ha he ha ha!"
"[english]dota_chatwheel_message_oracle_laugh"	"He ha ha he ha ha!"
"dota_chatwheel_label_oracle_laugh"	"[Skratta]"
"[english]dota_chatwheel_label_oracle_laugh"	"Laugh"
"dota_chatwheel_message_oracle_deny"	"Jag vill dö."
"[english]dota_chatwheel_message_oracle_deny"	"I want to die."
"dota_chatwheel_label_oracle_deny"	"Jag vill dö."
"[english]dota_chatwheel_label_oracle_deny"	"I want to die."
"dota_chatwheel_message_oracle_1"	"Jag såg det där."
"[english]dota_chatwheel_message_oracle_1"	"I saw that."
"dota_chatwheel_label_oracle_1"	"Jag såg det där."
"[english]dota_chatwheel_label_oracle_1"	"I saw that."
"dota_chatwheel_message_arc_warden_laugh"	"Hm hm hm hm hm hm hm hm hm hm hm hm hm hm hm."
"[english]dota_chatwheel_message_arc_warden_laugh"	"Hm hm hm hm hm hm hm hm hm hm hm hm hm hm hm."
"dota_chatwheel_label_arc_warden_laugh"	"[Skratta]"
"[english]dota_chatwheel_label_arc_warden_laugh"	"Laugh"
"dota_chatwheel_message_arc_warden_deny"	"Var inte självisk."
"[english]dota_chatwheel_message_arc_warden_deny"	"Do not be selfish."
"dota_chatwheel_label_arc_warden_deny"	"Var inte självisk."
"[english]dota_chatwheel_label_arc_warden_deny"	"Do not be selfish."
"dota_chatwheel_message_arc_warden_1"	"Tagen på bar gärning."
"[english]dota_chatwheel_message_arc_warden_1"	"Busted."
"dota_chatwheel_label_arc_warden_1"	"Tagen på bar gärning."
"[english]dota_chatwheel_label_arc_warden_1"	"Busted."
"dota_chatwheel_message_arc_warden_3"	"Blott en avledning."
"[english]dota_chatwheel_message_arc_warden_3"	"A mere diversion."
"dota_chatwheel_label_arc_warden_3"	"Blott en avledning."
"[english]dota_chatwheel_label_arc_warden_3"	"A mere diversion."
"dota_chatwheel_message_winter_wyvern_laugh"	"Ah ha ha ha ha ha ha ha ha ha ha!"
"[english]dota_chatwheel_message_winter_wyvern_laugh"	"Ah ha ha ha ha ha ha ha ha ha ha!"
"dota_chatwheel_label_winter_wyvern_laugh"	"[Skratta]"
"[english]dota_chatwheel_label_winter_wyvern_laugh"	"Laugh"
"dota_chatwheel_message_winter_wyvern_thank"	"Underbart!"
"[english]dota_chatwheel_message_winter_wyvern_thank"	"Wonderful!"
"dota_chatwheel_label_winter_wyvern_thank"	"Underbart."
"[english]dota_chatwheel_label_winter_wyvern_thank"	"Wonderful."
"dota_chatwheel_message_winter_wyvern_deny"	"Chilla."
"[english]dota_chatwheel_message_winter_wyvern_deny"	"Chill, baby."
"dota_chatwheel_label_winter_wyvern_deny"	"Chilla."
"[english]dota_chatwheel_label_winter_wyvern_deny"	"Chill, baby."
"dota_chatwheel_message_winter_wyvern_5"	"Jag har aldrig mått så här bra! Ah ha ha ha ha!"
"[english]dota_chatwheel_message_winter_wyvern_5"	"Ah, I've never felt this good! Ah ha ha ha ha!"
"dota_chatwheel_message_monkey_king_laugh"	"Ah ha ha ha ha ha. Woohoohoohoo. Ohhh heee."
"[english]dota_chatwheel_message_monkey_king_laugh"	"Ah ha ha ha ha ha. Woohoohoohoo. Ohhh heee."
"dota_chatwheel_label_monkey_king_laugh"	"[Skratta]"
"[english]dota_chatwheel_label_monkey_king_laugh"	"Laugh"
"dota_chatwheel_message_monkey_king_3"	"Okej."
"[english]dota_chatwheel_message_monkey_king_3"	"Alright."
"dota_chatwheel_label_monkey_king_3"	"Okej."
"[english]dota_chatwheel_label_monkey_king_3"	"Alright."
"dota_chatwheel_message_dark_willow_laugh"	"Hahaha ahaha ahaha ahhahahahahaa!"
"[english]dota_chatwheel_message_dark_willow_laugh"	"Hahaha ahaha ahaha ahhahahahahaa!"
"dota_chatwheel_label_dark_willow_laugh"	"[Skratta]"
"[english]dota_chatwheel_label_dark_willow_laugh"	"Laugh"
"dota_chatwheel_label_dark_willow_3"	"Bry er inte om mig."
"[english]dota_chatwheel_label_dark_willow_3"	"Don't mind me."
"dota_chatwheel_message_pangolier_laugh"	"Aaaah ha hahahaha hahahaaa huu."
"[english]dota_chatwheel_message_pangolier_laugh"	"Aaaah ha hahahaha hahahaaa huu."
"dota_chatwheel_label_pangolier_laugh"	"[Skratta]"
"[english]dota_chatwheel_label_pangolier_laugh"	"Laugh"
"dota_chatwheel_label_pangolier_1"	"Ansträng dig lite mer"
"[english]dota_chatwheel_label_pangolier_1"	"Try Harder"
"dota_chatwheel_message_pangolier_3"	"Tut tut!"
"[english]dota_chatwheel_message_pangolier_3"	"Beep Beep!"
"dota_chatwheel_label_pangolier_3"	"Tut tut!"
"[english]dota_chatwheel_label_pangolier_3"	"Beep Beep!"
"dota_chatwheel_label_pangolier_5"	"Helt och hållet ditt fel?"
"[english]dota_chatwheel_label_pangolier_5"	"All your fault?"
}
