"hero_chat_wheel"
{
"dota_chatwheel_message_antimage_laugh"	"Ha ha ha ha ha ha ha ha ha ha ha ha!"
"[english]dota_chatwheel_message_antimage_laugh"	"Ha ha ha ha ha ha ha ha ha ha ha ha!"
"dota_chatwheel_label_antimage_laugh"	"[Śmiech]"
"[english]dota_chatwheel_label_antimage_laugh"	"[Laugh]"
"dota_chatwheel_message_antimage_deny"	"Czy ty się w ogóle starasz?"
"[english]dota_chatwheel_message_antimage_deny"	"Are you even trying?"
"dota_chatwheel_label_antimage_deny"	"Czy ty się w ogóle starasz?"
"[english]dota_chatwheel_label_antimage_deny"	"Are you even trying?"
"dota_chatwheel_message_antimage_2"	"Rozczarowanie."
"[english]dota_chatwheel_message_antimage_2"	"A disappointment."
"dota_chatwheel_label_antimage_2"	"Rozczarowanie."
"[english]dota_chatwheel_label_antimage_2"	"A disappointment."
"dota_chatwheel_message_antimage_3"	"Wyczaruj się z tego."
"[english]dota_chatwheel_message_antimage_3"	"Magic thyself out of that."
"dota_chatwheel_label_antimage_3"	"Wyczaruj się z tego."
"[english]dota_chatwheel_label_antimage_3"	"Magic thyself out of that."
"dota_chatwheel_message_antimage_4"	"Przeklinam cię!"
"[english]dota_chatwheel_message_antimage_4"	"Thou art damned!"
"dota_chatwheel_label_antimage_4"	"Przeklinam cię."
"[english]dota_chatwheel_label_antimage_4"	"Thou art damned."
"dota_chatwheel_message_antimage_5"	"Wyślij wszystkie legiony twojego Martwego Boga, odeślę je w zaświaty."
"[english]dota_chatwheel_message_antimage_5"	"Send thy Dead God's legions, I will put them all to death."
"dota_chatwheel_label_antimage_5"	"Wyślij wszystkie legiony..."
"[english]dota_chatwheel_label_antimage_5"	"Send thy Dead God's legions..."
"dota_chatwheel_message_axe_laugh"	"Ha ha ha ha ha ha!"
"[english]dota_chatwheel_message_axe_laugh"	"Ha ha ha ha ha ha!"
"dota_chatwheel_label_axe_laugh"	"[Śmiech]"
"[english]dota_chatwheel_label_axe_laugh"	"[Laugh]"
"dota_chatwheel_message_axe_thank"	"Axe to się podobać bardzo."
"[english]dota_chatwheel_message_axe_thank"	"Axe likes this very much."
"dota_chatwheel_message_bane_deny"	"Powodzenia następnym razem."
"[english]dota_chatwheel_message_bane_deny"	"Better luck next time."
"dota_chatwheel_label_bane_deny"	"Powodzenia następnym razem."
"[english]dota_chatwheel_label_bane_deny"	"Better luck next time."
"dota_chatwheel_message_bloodseeker_thank"	"Tyle krwi."
"[english]dota_chatwheel_message_bloodseeker_thank"	"So much blood."
"dota_chatwheel_label_bloodseeker_thank"	"Tyle krwi."
"[english]dota_chatwheel_label_bloodseeker_thank"	"So much blood."
"dota_chatwheel_message_drow_ranger_thank"	"Kolejny triumf!"
"[english]dota_chatwheel_message_drow_ranger_thank"	"Another triumph!"
"dota_chatwheel_label_drow_ranger_thank"	"Kolejny triumf!"
"[english]dota_chatwheel_label_drow_ranger_thank"	"Another triumph!"
"dota_chatwheel_message_drow_ranger_2"	"Amator."
"[english]dota_chatwheel_message_drow_ranger_2"	"Amateur."
"dota_chatwheel_label_drow_ranger_2"	"Amator."
"[english]dota_chatwheel_label_drow_ranger_2"	"Amateur."
"dota_chatwheel_message_earthshaker_deny"	"Szokujące..."
"[english]dota_chatwheel_message_earthshaker_deny"	"Shocking..."
"dota_chatwheel_label_earthshaker_deny"	"Szokujące..."
"[english]dota_chatwheel_label_earthshaker_deny"	"Shocking..."
"dota_chatwheel_message_puck_thank"	"Interesujące."
"[english]dota_chatwheel_message_puck_thank"	"Interesting."
"dota_chatwheel_label_puck_thank"	"Interesujące."
"[english]dota_chatwheel_label_puck_thank"	"Interesting."
"dota_chatwheel_message_puck_1"	"Pozdrowienia!"
"[english]dota_chatwheel_message_puck_1"	"Greetings!"
"dota_chatwheel_label_puck_1"	"Pozdrowienia!"
"[english]dota_chatwheel_label_puck_1"	"Greetings!"
"dota_chatwheel_message_razor_3"	"Szokujące."
"[english]dota_chatwheel_message_razor_3"	"Shocking."
"dota_chatwheel_label_razor_3"	"Szokujące."
"[english]dota_chatwheel_label_razor_3"	"Shocking."
"dota_chatwheel_message_storm_spirit_5"	"Niesamowicie!"
"[english]dota_chatwheel_message_storm_spirit_5"	"Glorious!"
"dota_chatwheel_label_storm_spirit_5"	"Niesamowicie!"
"[english]dota_chatwheel_label_storm_spirit_5"	"Glorious!"
"dota_chatwheel_label_windrunner_1"	"Mogło być gorzej..."
"[english]dota_chatwheel_label_windrunner_1"	"Could be worse..."
"dota_chatwheel_message_lina_deny"	"Parzy, czyż nie?"
"[english]dota_chatwheel_message_lina_deny"	"Burns, doesn't it?"
"dota_chatwheel_label_lina_deny"	"Parzy, czyż nie?"
"[english]dota_chatwheel_label_lina_deny"	"Burns, doesn't it?"
"dota_chatwheel_message_lina_5"	"Chodź do mamy!"
"[english]dota_chatwheel_message_lina_5"	"Come to mama!"
"dota_chatwheel_label_lina_5"	"Chodź do mamy!"
"[english]dota_chatwheel_label_lina_5"	"Come to mama!"
"dota_chatwheel_message_enigma_laugh"	"He-he-huh-heh-heh."
"[english]dota_chatwheel_message_enigma_laugh"	"He-he-huh-heh-heh."
"dota_chatwheel_message_enigma_2"	"Milczenie jest złotem."
"[english]dota_chatwheel_message_enigma_2"	"Silence is golden."
"dota_chatwheel_label_enigma_2"	"Milczenie jest złotem."
"[english]dota_chatwheel_label_enigma_2"	"Silence is golden."
"dota_chatwheel_message_queenofpain_2"	"Bolało?"
"[english]dota_chatwheel_message_queenofpain_2"	"Does this hurt?"
"dota_chatwheel_label_queenofpain_2"	"Bolało?"
"[english]dota_chatwheel_label_queenofpain_2"	"Does this hurt?"
"dota_chatwheel_message_skeleton_king_2"	"BARDZO ŁADNIE."
"[english]dota_chatwheel_message_skeleton_king_2"	"VERY NICE."
"dota_chatwheel_label_skeleton_king_2"	"BARDZO ŁADNIE."
"[english]dota_chatwheel_label_skeleton_king_2"	"VERY NICE."
"dota_chatwheel_message_death_prophet_3"	"Wróć do mnie! Wróć do mnie!"
"[english]dota_chatwheel_message_death_prophet_3"	"Come back to me! Come back to me!"
"dota_chatwheel_label_death_prophet_3"	"Wróć do mnie!"
"[english]dota_chatwheel_label_death_prophet_3"	"Come back to me!"
"dota_chatwheel_message_phantom_assassin_deny"	"Wszystko zgodnie z planem."
"[english]dota_chatwheel_message_phantom_assassin_deny"	"All according to plan."
"dota_chatwheel_label_phantom_assassin_deny"	"Wszystko zgodnie z planem."
"[english]dota_chatwheel_label_phantom_assassin_deny"	"All according to plan."
"dota_chatwheel_message_pugna_2"	"Ktoś za mną tęsknił?"
"[english]dota_chatwheel_message_pugna_2"	"Anyone miss me?"
"dota_chatwheel_label_pugna_2"	"Ktoś za mną tęsknił?"
"[english]dota_chatwheel_label_pugna_2"	"Anyone miss me?"
"dota_chatwheel_message_templar_assassin_2"	"To pułapka!"
"[english]dota_chatwheel_message_templar_assassin_2"	"It's a trap!"
"dota_chatwheel_label_templar_assassin_2"	"To pułapka!"
"[english]dota_chatwheel_label_templar_assassin_2"	"It's a trap!"
"dota_chatwheel_message_viper_deny"	"Blisko, ale nie do końca."
"[english]dota_chatwheel_message_viper_deny"	"Close but not quite."
"dota_chatwheel_label_viper_deny"	"Blisko, ale nie do końca."
"[english]dota_chatwheel_label_viper_deny"	"Close but not quite."
"dota_chatwheel_message_viper_1"	"Śmierć...z góry."
"[english]dota_chatwheel_message_viper_1"	"Death...from above."
"dota_chatwheel_label_viper_1"	"Śmierć...z góry."
"[english]dota_chatwheel_label_viper_1"	"Death...from above."
"dota_chatwheel_message_viper_4"	"Parzy...czyż nie?"
"[english]dota_chatwheel_message_viper_4"	"Burns...doesn't it."
"dota_chatwheel_label_viper_4"	"Parzy...czyż nie?"
"[english]dota_chatwheel_label_viper_4"	"Burns...doesn't it."
"dota_chatwheel_message_luna_deny"	"Interesujące!"
"[english]dota_chatwheel_message_luna_deny"	"Interesting!"
"dota_chatwheel_label_luna_deny"	"Interesujące!"
"[english]dota_chatwheel_label_luna_deny"	"Interesting!"
"dota_chatwheel_message_furion_3"	"Bardzo ładnie."
"[english]dota_chatwheel_message_furion_3"	"Very nice."
"dota_chatwheel_label_furion_3"	"Bardzo ładnie."
"[english]dota_chatwheel_label_furion_3"	"Very nice."
"dota_chatwheel_message_dark_seer_thank"	"Bardzo dobrze."
"[english]dota_chatwheel_message_dark_seer_thank"	"Very good."
"dota_chatwheel_label_dark_seer_thank"	"Bardzo dobrze."
"[english]dota_chatwheel_label_dark_seer_thank"	"Very good."
"dota_chatwheel_message_omniknight_thank"	"Pięknie."
"[english]dota_chatwheel_message_omniknight_thank"	"Beautiful."
"dota_chatwheel_label_omniknight_thank"	"Pięknie."
"[english]dota_chatwheel_label_omniknight_thank"	"Beautiful."
"dota_chatwheel_message_enchantress_deny"	"Nie wściekaj się."
"[english]dota_chatwheel_message_enchantress_deny"	"Don't be mad."
"dota_chatwheel_label_enchantress_deny"	"Nie wściekaj się."
"[english]dota_chatwheel_label_enchantress_deny"	"Don't be mad."
"dota_chatwheel_message_huskar_1"	"Kolejne zmarnowane życie."
"[english]dota_chatwheel_message_huskar_1"	"Another life squandered."
"dota_chatwheel_label_huskar_1"	"Kolejne zmarnowane życie."
"[english]dota_chatwheel_label_huskar_1"	"Another life squandered."
"dota_chatwheel_message_huskar_2"	"Dobry interes!"
"[english]dota_chatwheel_message_huskar_2"	"A fair trade!"
"dota_chatwheel_label_huskar_2"	"Dobry interes!"
"[english]dota_chatwheel_label_huskar_2"	"A fair trade!"
"dota_chatwheel_message_jakiro_deny"	"To zmienia wszystko."
"[english]dota_chatwheel_message_jakiro_deny"	"This changes everything."
"dota_chatwheel_label_jakiro_deny"	"To zmienia wszystko."
"[english]dota_chatwheel_label_jakiro_deny"	"This changes everything."
"dota_chatwheel_message_jakiro_1"	"Spalony."
"[english]dota_chatwheel_message_jakiro_1"	"Burned."
"dota_chatwheel_label_jakiro_1"	"SPALONY!"
"[english]dota_chatwheel_label_jakiro_1"	"BURNED!"
"dota_chatwheel_message_spectre_1"	"Przydatna umiejętność."
"[english]dota_chatwheel_message_spectre_1"	"A useful skill."
"dota_chatwheel_label_spectre_1"	"Przydatna umiejętność."
"[english]dota_chatwheel_label_spectre_1"	"A useful skill."
"dota_chatwheel_message_ancient_apparition_thank"	"Interesujące."
"[english]dota_chatwheel_message_ancient_apparition_thank"	"Interesting."
"dota_chatwheel_label_ancient_apparition_thank"	"Interesujące."
"[english]dota_chatwheel_label_ancient_apparition_thank"	"Interesting."
"dota_chatwheel_message_doom_bringer_thank"	"O, tak."
"[english]dota_chatwheel_message_doom_bringer_thank"	"Oh, yes."
"dota_chatwheel_label_doom_bringer_thank"	"O, tak."
"[english]dota_chatwheel_label_doom_bringer_thank"	"Oh, yes."
"dota_chatwheel_message_ursa_1"	"Słaba obrona."
"[english]dota_chatwheel_message_ursa_1"	"A poor defense."
"dota_chatwheel_label_ursa_1"	"Słaba obrona."
"[english]dota_chatwheel_label_ursa_1"	"A poor defense."
"dota_chatwheel_message_gyrocopter_1"	"Masz szczęście!"
"[english]dota_chatwheel_message_gyrocopter_1"	"Lucky!"
"dota_chatwheel_label_gyrocopter_1"	"Masz szczęście!"
"[english]dota_chatwheel_label_gyrocopter_1"	"Lucky!"
"dota_chatwheel_message_gyrocopter_3"	"Wara z mojego podwórka!"
"[english]dota_chatwheel_message_gyrocopter_3"	"Get off my lawn!"
"dota_chatwheel_label_gyrocopter_3"	"Wara z mojego podwórka!"
"[english]dota_chatwheel_label_gyrocopter_3"	"Get off my lawn!"
"dota_chatwheel_label_alchemist_3"	"Nie wierzę w to, co widzę."
"[english]dota_chatwheel_label_alchemist_3"	"Can't believe I'm seeing this."
"dota_chatwheel_message_silencer_3"	"Milcz, głupcze!"
"[english]dota_chatwheel_message_silencer_3"	"Silence, fool!"
"dota_chatwheel_label_silencer_3"	"Milcz, głupcze."
"[english]dota_chatwheel_label_silencer_3"	"Silence, fool."
"dota_chatwheel_message_brewmaster_thank"	"Ach, uwielbiam was."
"[english]dota_chatwheel_message_brewmaster_thank"	"Ah, I love you guys."
"dota_chatwheel_label_brewmaster_thank"	"Kocham was chłopaki."
"[english]dota_chatwheel_label_brewmaster_thank"	"Love you guys."
"dota_chatwheel_message_shadow_demon_4"	"Ukłoń się."
"[english]dota_chatwheel_message_shadow_demon_4"	"Bow down."
"dota_chatwheel_label_shadow_demon_4"	"Ukłoń się."
"[english]dota_chatwheel_label_shadow_demon_4"	"Bow down."
"dota_chatwheel_message_lone_druid_3"	"Dobra wymiana."
"[english]dota_chatwheel_message_lone_druid_3"	"A worthy exchange."
"dota_chatwheel_label_lone_druid_3"	"Dobra wymiana."
"[english]dota_chatwheel_label_lone_druid_3"	"A worthy exchange."
"dota_chatwheel_message_lone_druid_5"	"Auuuuuhhh!"
"[english]dota_chatwheel_message_lone_druid_5"	"Auuuuuhhh!"
"dota_chatwheel_label_lone_druid_5"	"Auuuuuhhh!"
"[english]dota_chatwheel_label_lone_druid_5"	"Auuuuuhhh!"
"dota_chatwheel_message_treant_1"	"Zgubiłeś się?"
"[english]dota_chatwheel_message_treant_1"	"Are you lost?"
"dota_chatwheel_label_treant_1"	"Zgubiłeś się?"
"[english]dota_chatwheel_label_treant_1"	"Are you lost?"
"dota_chatwheel_message_treant_2"	"Ostrożnie."
"[english]dota_chatwheel_message_treant_2"	"Careful."
"dota_chatwheel_label_treant_2"	"Ostrożnie."
"[english]dota_chatwheel_label_treant_2"	"Careful."
"dota_chatwheel_label_ogre_magi_2"	"Dobra robota!"
"[english]dota_chatwheel_label_ogre_magi_2"	"Good work!"
"dota_chatwheel_message_undying_1"	"Nienawidzę życia."
"[english]dota_chatwheel_message_undying_1"	"I hate life."
"dota_chatwheel_label_undying_1"	"Nienawidzę życia"
"[english]dota_chatwheel_label_undying_1"	"I hate life"
"dota_chatwheel_message_rubick_thank"	"Wspaniały pomysł!"
"[english]dota_chatwheel_message_rubick_thank"	"Excellent idea!"
"dota_chatwheel_label_rubick_thank"	"Wspaniały pomysł!"
"[english]dota_chatwheel_label_rubick_thank"	"Excellent idea!"
"dota_chatwheel_message_visage_1"	"I tak oto giniesz."
"[english]dota_chatwheel_message_visage_1"	"And so you die."
"dota_chatwheel_label_visage_1"	"I tak oto giniesz."
"[english]dota_chatwheel_label_visage_1"	"And so you die."
"dota_chatwheel_message_medusa_thank"	"Wspaniale."
"[english]dota_chatwheel_message_medusa_thank"	"Brilliant."
"dota_chatwheel_label_medusa_thank"	"Wspaniale."
"[english]dota_chatwheel_label_medusa_thank"	"Brilliant."
"dota_chatwheel_label_troll_warlord_1"	"Wracaj..."
"[english]dota_chatwheel_label_troll_warlord_1"	"Come back..."
"dota_chatwheel_message_tusk_1"	"Wszystko w porządku?"
"[english]dota_chatwheel_message_tusk_1"	"Are you okay?"
"dota_chatwheel_label_tusk_1"	"Wszystko w porządku?"
"[english]dota_chatwheel_label_tusk_1"	"Are you ok?"
"dota_chatwheel_label_abaddon_4"	"Jakim prawem..."
"[english]dota_chatwheel_label_abaddon_4"	"By what right..."
"dota_chatwheel_message_elder_titan_1"	"Wara z mojego podwórka!"
"[english]dota_chatwheel_message_elder_titan_1"	"Get off my lawn!"
"dota_chatwheel_label_elder_titan_1"	"Wara z mojego podwórka."
"[english]dota_chatwheel_label_elder_titan_1"	"Get off my lawn."
"dota_chatwheel_label_techies_thank"	"Zabawa!"
"[english]dota_chatwheel_label_techies_thank"	"Fun!"
"dota_chatwheel_message_ember_spirit_thank"	"Błysk inspiracji!"
"[english]dota_chatwheel_message_ember_spirit_thank"	"A flash of inspiration!"
"dota_chatwheel_label_ember_spirit_thank"	"Błysk inspiracji!"
"[english]dota_chatwheel_label_ember_spirit_thank"	"A flash of inspiration!"
"dota_chatwheel_label_monkey_king_laugh"	"Śmiech"
"[english]dota_chatwheel_label_monkey_king_laugh"	"Laugh"
"dota_chatwheel_label_dark_willow_3"	"Nie przejmuj się mną."
"[english]dota_chatwheel_label_dark_willow_3"	"Don't mind me."
"dota_chatwheel_label_dark_willow_5"	"Bez sensu."
"[english]dota_chatwheel_label_dark_willow_5"	"Makes no sense."
}
