"lang"
{
"Language"	"norwegian"
"Tokens"
{
"DOTA_WearableType_Daggers"	"Dolker"
"DOTA_WearableType_Glaives"	"Glavin"
"DOTA_WearableType_Weapon"	"Våpen"
"DOTA_WearableType_Armor"	"rustning"
"DOTA_WearableType_Hair"	"Hår"
"DOTA_WearableType_Belt"	"belte"
"DOTA_WearableType_Mask"	"Maske"
"DOTA_WearableType_Cape"	"Kappe"
"DOTA_WearableType_Bracer"	"armbeskytter"
"DOTA_WearableType_Boots"	"Støvler"
"DOTA_WearableType_Hands"	"Hender"
"DOTA_WearableType_Head"	"hode"
"DOTA_WearableType_Mace"	"Stav"
"DOTA_WearableType_Gauntlet"	"Stridshanske"
"DOTA_WearableType_Shoulder"	"skulder"
"DOTA_WearableType_Bow"	"Bue"
"DOTA_WearableType_ShoulderPads"	"Skulderputer"
"DOTA_WearableType_Quiver"	"Kogger"
"DOTA_WearableType_Shield"	"skjold"
"DOTA_WearableType_Horns"	"Horn"
"DOTA_WearableType_Beard"	"Skjegg"
"DOTA_WearableType_Necklace"	"Halskjede"
"DOTA_WearableType_Fish_Treat"	"Fiskegodbit"
"DOTA_WearableType_Meathook"	"Kjøttkrok"
"DOTA_WearableType_Offhand_weapon"	"Sekundærvåpen"
"DOTA_WearableType_Back"	"rygg"
"DOTA_WearableType_Gloves"	"hansker"
"DOTA_WearableType_Legs"	"bein"
"DOTA_WearableType_offhand"	"sekundær"
"DOTA_WearableType_arms"	"Armer"
"DOTA_WearableType_Unnamed_New_Item"	"Pakke"
"DOTA_WearableType_New_Item"	"Ny gjenstand"
"DOTA_WearableType_body"	"Kropp"
"DOTA_WearableType_Tail"	"hale"
"DOTA_WearableType_Pauldrons"	"Skulderplater"
"DOTA_WearableType_Chain_Weapon"	"Kjedevåpen"
"DOTA_WearableType_Helm"	"hjelm"
"DOTA_WearableType_Pegleg"	"Provisorisk protese"
"DOTA_WearableType_Sword"	"Sverd"
"DOTA_WearableType_Hat"	"Hatt"
"DOTA_WearableType_Ability_Modifier"	"Verktøy"
"DOTA_WearableType_Toga"	"Toga"
"DOTA_WearableType_Hand"	"Hånd"
"DOTA_WearableType_Taunt"	"Hån"
"DOTA_WearableType_Skin"	"Hud"
"DOTA_WearableType_Alternate_Ultimate"	"Alternativ ultimate"
"DOTA_WearableType_Alternate_Attack"	"Alternativt angrep"
"DOTA_WearableType_Pauldron"	"Skulderpute"
"DOTA_WearableType_Spaulder"	"Skulderplate"
"DOTA_WearableType_Squishy_Hat"	"Bløt hatt"
"DOTA_WearableType_Bracers"	"Armbeskyttere"
"DOTA_WearableType_Robe"	"Kjortel"
"DOTA_WearableType_Headdress"	"Hodeplagg"
"DOTA_WearableType_Mailed_Skirt"	"Ringbrynje"
"DOTA_WearableType_Hat_and_Hair"	"Hatt og hår"
"DOTA_WearableType_Shoes"	"Sko"
"DOTA_WearableType_Spikes"	"Pigger"
"DOTA_WearableType_Bone_Helm"	"Beinhjelm"
"DOTA_WearableType_Mine"	"Mine"
"DOTA_WearableType_Fins"	"Finner"
"DOTA_WearableType_Axe"	"Øks"
"DOTA_WearableType_Shoulder_Guard"	"Skulderbeskyttere"
"DOTA_WearableType_Cloak_and_Tunic"	"Kappe og kjortel"
"DOTA_WearableType_Hammer"	"Hammer"
"DOTA_WearableType_Dead_Shark"	"Død hai"
"DOTA_WearableType_Finished_Lunch"	"Ferdig lunsj"
"DOTA_WearableType_Bone_Club"	"Beinklubbe"
"DOTA_WearableType_Makeshift_Weapon"	"Improvisert våpen"
"DOTA_WearableType_Shoulderguard"	"Skulderbeskyttelse"
"DOTA_WearableType_Fancy_Pantaloons"	"Stilige pantalonger"
"DOTA_WearableType_Cloth_Bracer"	"Armbeskyttere av stoff"
"DOTA_WearableType_Stuffed_Toy"	"Kosedyr"
"DOTA_WearableType_Staff"	"Stav"
"DOTA_WearableType_Gruesome_Trophies"	"Grusomme trofeer"
"DOTA_WearableType_Hood"	"Hette"
"DOTA_WearableType_Shuriken"	"Shuriken"
"DOTA_WearableType_Mancatcher"	"Menneskefanger"
"DOTA_WearableType_Apron"	"Forkle"
"DOTA_WearableType_Armlet"	"Armbånd"
"DOTA_WearableType_Scepter"	"Septer"
"DOTA_WearableType_Abomination"	"Abominasjon"
"DOTA_WearableType_Greaves"	"Grakser"
"DOTA_WearableType_Saw"	"Sag"
"DOTA_WearableType_Hook"	"Krok"
"DOTA_WearableType_Abdomen"	"Abdomen"
"DOTA_WearableType_Sect_Pauldron"	"Sektskulderpute"
"DOTA_WearableType_Sect_Helm"	"Sekthjelm"
"DOTA_WearableType_Sect_Sword"	"Sektsverd"
"DOTA_WearableType_Flag"	"Flagg"
"DOTA_WearableType_Blade_RightHand"	"Sverd, høyrehånd"
"DOTA_WearableType_Blade_LeftHand"	"Sverd, venstrehånd"
"DOTA_WearableType_Sect_Cape"	"Sektkappe"
"DOTA_WearableType_Sect_Skirt"	"Sektskjørt"
"DOTA_WearableType_Sect_Gauntlet"	"Sektstridshanske"
"DOTA_WearableType_Scarf"	"Skjerf"
"DOTA_WearableType_Leather_Pants"	"Lærbukser"
"DOTA_WearableType_Blade_RightHanded"	"Sverd, høyrehånd"
"DOTA_WearableType_Talisman"	"Talisman"
"DOTA_WearableType_Garland"	"Krans"
"DOTA_WearableType_Exort_Cape"	"Exort-kappe"
"DOTA_WearableType_Exort_Bracer"	"Exort-armbeskytter"
"DOTA_WearableType_Exort_Crest"	"Exort-emblem"
"DOTA_Item"	"Brukbar"
"DOTA_Custom_Courier"	"Budbringer"
"DOTA_Custom_HexModel"	"Tilpasset hex-dyr"
"DOTA_WearableType_Announcer"	"Oppleser"
"DOTA_WearableType_Custom_Courier"	"Budbringer"
"DOTA_WearableType_MegaKills"	" 
"
"DOTA_WearableType_Treasure_Chest"	"Skattekiste"
"DOTA_TreasureChest_Type"	"Skatt"
"DOTA_WearableType_Tool"	"Redskap"
"DOTA_WearableType_Battle_Bonus"	"Kamp-bonus"
"DOTA_Item_Gift"	"Gave"
"DOTA_WearableType_Gift"	"Gave"
"DOTA_WearableType_Strange_Essence"	"Merkelig essens"
"DOTA_WearableType_LeagueViewPass"	" 
"
"DOTA_WearableType_Bundle"	"Pakke"
"DOTA_Wearable_Riki_DefaultWeapon"	"Rikis dolker"
"DOTA_Item_AntiMages_Glaives"	"Anti-Mages glavin"
"DOTA_Item_Desc_AntiMages_Glaives"	" 
"
"DOTA_Item_Axes_Axe"	"Axes øks"
"DOTA_Wearable_Axe_DefaultArmor"	"Axes skulderputer"
"DOTA_Wearable_Axe_DefaultHair"	"Axes hestehale"
"DOTA_Item_Axes_Belt"	"Axes belte"
"DOTA_Wearable_Jugg_DefaultMask"	"Juggernauts maske"
"DOTA_Wearable_Jugg_DefaultWeapon"	"Juggernauts våpen"
"DOTA_Wearable_Jugg_DefaultCape"	"Juggernauts kappe"
"DOTA_Wearable_Jugg_DefaultBracers"	"Juggernaut's Bracers"
"DOTA_Item_Kunkkas_Boots"	"Kunkkas støvler"
"DOTA_Item_Kunkkas_Hands"	"Kunkkas hender"
"DOTA_Item_Kunkkas_Sword"	"Kunkkas sverd"
"DOTA_Item_Omniknights_Bracers"	"Omniknights armbeskyttere"
"DOTA_Item_Desc_Bracers"	"Omniknights gamle armbeskyttere"
"DOTA_Item_Kunkkas_Head"	"Kunkkas hode"
"DOTA_FacelessVoid_Default_Weapon"	"Faceless Voids våpen"
"DOTA_Wearable_Sven_DefaultHead"	"Svens maske"
"DOTA_Wearable_Sven_DefaultSword"	"Svens sverd"
"DOTA_Wearable_Sven_DefaultBelt"	"Svens belte"
"DOTA_Wearable_Sven_DefaultGauntlet"	"Svens stridshanske"
"DOTA_Wearable_Sven_DefaultShoulder"	"Svens skulder"
"DOTA_Wearable_Windrunner_DefaultHead"	"Windrangers hode"
"DOTA_Wearable_Windrunner_DefaultBow"	"Windrangers bue"
"DOTA_Wearable_Windrunner_ShoulderPads"	"Windrangers skulderputer"
"DOTA_Wearable_Windrunner_Cape"	"Windrangers kappe"
"DOTA_Wearable_Windrunner_DefaultQuiver"	"Windrangers kogger"
"DOTA_Item_Queen_of_Pains_Weapon"	"Queen of Pains våpen"
"DOTA_Wearable_Silencer_DefaultWeapon"	"Silencers våpen"
"DOTA_Wearable_Silencer_DefaultShield"	"Silencers skjold"
"DOTA_Wearable_Furion_DefaultWeapon"	"Prophets stav"
"DOTA_Wearable_Furion_DefaultHorns"	"Prophets horn"
"DOTA_Wearable_Furion_DefaultBeard"	"Prophets skjegg"
"DOTA_Wearable_Furion_DefaultCape"	"Prophets kappe"
"DOTA_Wearable_Furion_DefaultNecklace"	"Prophets halskjede"
"DOTA_Item_Tidehunters_Bracer"	"Tidehunters armbeskytter"
"DOTA_Item_Tidehunters_Belt"	"Tidehunters belte"
"DOTA_Item_Tidehunters_Anchor"	"Tidehunters anker"
"DOTA_Item_Tidehunters_Lunch"	"Tidehunters lunsj"
"DOTA_Wearable_CrystalMaiden_Default_Cape"	"Crystal Maidens kappe"
"DOTA_Wearable_CrystalMaiden_Default_Shoulder_Pads"	"Crystal Maidens skulderputer"
"DOTA_Wearable_CrystalMaiden_Default_Weapon"	"Crystal Maidens våpen"
"DOTA_Wearable_CrystalMaiden_Default_Boots_and_Cuffs"	"Crystal Maidens støvler & mansjett"
"DOTA_Item_Omniknights_Shoulders"	"Omniknights skuldre"
"DOTA_Item_Omniknights_Cape"	"Omniknights kappe"
"DOTA_Item_Omniknights_Weapon"	"Omniknights våpen"
"DOTA_Item_Desc_Omniknights_Hammer"	"Omniknights gamle hammer"
"DOTA_Item_Omniknights_Head"	"Omniknights hode"
"DOTA_Item_Omniknights_Hair"	"Omniknights hår"
"DOTA_Item_Pudges_Rusty_Meathook"	"Pudges rustne kjøttkrok"
"DOTA_Item_Desc_Rusty_Meathook"	"En rusten og grusom kjøttkrok."
"DOTA_Item_Invokers_Cape"	"Invoker's Cape"
"DOTA_Item_Prophets_Bracers"	"Prophet's Bracers"
"DOTA_Item_Desc_Copy_of_Prophets_Horns"	" 

"
"DOTA_Item_Bounty_Hunters_Weapon"	"Bounty Hunters våpen"
"DOTA_Item_Desc_Unnamed_New_Item"	"Denne nye gjenstanden har ingen beskrivelse."
"DOTA_Item_Bounty_Hunters_Offhand_Weapon"	"Bounty Hunters sekundærvåpen"
"DOTA_Item_Desc_Copy_of_RWeapon"	"Denne nye gjenstanden har ingen beskrivelse."
"DOTA_Item_Bounty_Hunters_Back"	"Bounty Hunters rygg"
"DOTA_Item_Desc_Copy_of_LWeapon"	"Denne nye gjenstanden har ingen beskrivelse."
"DOTA_Item_Armor"	"Bounty Hunter's Armor"
"DOTA_Item_Desc_Copy_of_Backpack"	"Denne nye gjenstanden har ingen beskrivelse."
"DOTA_Item_Bounty_Hunters_Shoulder"	"Bounty Hunters skulder"
"DOTA_Item_Desc_Copy_of_Armor"	"Denne nye gjenstanden har ingen beskrivelse."
"DOTA_Item_Bounty_Hunters_Bandana"	"Bounty Hunters tørkle"
"DOTA_Item_Desc_Copy_of_BWeapon"	"Denne nye gjenstanden har ingen beskrivelse."
"DOTA_Item_Clinkz_Skull"	"Clinkz' hodeskalle"
"DOTA_Item_Desc_Clinkz_Skull"	"Clinkz standardskalle"
"DOTA_Item_Clinkz_Bow"	"Clinkz' bue"
"DOTA_Item_Desc_Clinkz_Bow"	"Clinkz standardbue"
"DOTA_Item_Clinkz_Shoulder_Pads"	"Clinkz' skulderputer"
"DOTA_Item_Desc_Clinkz_Shoulder_Pads"	"Clinkz standardskulderputer"
"DOTA_Item_Clinkz_Quiver"	"Clinkz' kogger"
"DOTA_Item_Desc_Clinkz_Quiver"	"Clinkz standardpilkogger"
"DOTA_Item_Clinkz_Horns"	"Clinkz' horn"
"DOTA_Item_Desc_Clinkz_Horns"	"Clinkz standardhorn"
"DOTA_Item_Clinkz_Gloves"	"Clinkz' hansker"
"DOTA_Item_Desc_Copy_of_Clinkz_Skull"	"Clinkz standardskalle"
"DOTA_Wearable_Jugg_DefaultLegs"	"Juggernauts bein"
"DOTA_Item_Dragon_Knights_Helmet"	"Dragon Knights hjelm"
"DOTA_Item_Desc_Copy_of_Juggernauts_Legs"	" 
"
"DOTA_Item_Dragon_Knights_Shoulder_Armor"	"Dragon Knights skulderrustning"
"DOTA_Item_Dragon_Knights_Bracers"	"Dragon Knights armbeskyttere"
"DOTA_Item_Desc_Copy_of_Dragon_Knights_Shoulder_Armor"	" 

"
"DOTA_Item_Dragon_Knights_Weapon"	"Dragon Knights våpen"
"DOTA_Item_Dragon_Knights_Offhand"	"Dragon Knights sekundære"
"DOTA_Item_Dragon_Knights_Skirt"	"Dragon Knights skjørt"
"DOTA_Item_Desc_Copy_of_Dragon_Knights_Offhand"	" 

"
"DOTA_Item_Blood_Seekers_Weapon"	"Bloodseekers våpen"
"DOTA_Item_Desc_Copy_of_Dragon_Knights_Skirt"	" 

"
"DOTA_Item_Blood_Seekers_Headdress"	"Bloodseekers hodeplagg"
"DOTA_Item_Blood_Seekers_Offhand_Weapon"	"Bloodseekers sekundærvåpen"
"DOTA_Item_Desc_Copy_of_Blood_Seekers_Headdress"	" 

"
"DOTA_Item_Blood_Seekers_Necklace"	"Bloodseekers halskjede"
"DOTA_Item_Desc_Copy_of_Blood_Seekers_Offhand_Weapon"	" 

"
"DOTA_Item_Blood_Seekers_Cape"	"Bloodseekers kappe"
"DOTA_Item_Desc_Copy_of_Blood_Seekers_Necklace"	" 

"
"DOTA_Item_Blood_Seekers_Bracers"	"Bloodseekers armbeskyttere"
"DOTA_Item_Desc_Copy_of_Blood_Seekers_Cape"	" 
"
"DOTA_Item_Drows_Bracers"	"Drows armbeskyttere"
"DOTA_Item_Desc_Copy_of_Blood_Seekers_Bracers"	" 
"
"DOTA_Item_Drows_Cape"	"Drows kappe"
"DOTA_Item_Desc_Copy_of_Drows_Bracers"	" 
"
"DOTA_Item_Drows_Bow"	"Drows bue"
"DOTA_Item_Desc_Copy_of_Drows_Cape"	" 
"
"DOTA_Item_Drows_Leg_Armor"	"Drows beinrustning"
"DOTA_Item_Drows_Quiver"	"Drows kogger"
"DOTA_Item_Desc_Copy_of_Drows_Leg_Armor"	" 
"
"DOTA_Item_Drows_Shoulder_Armor"	"Drows skulderrustning"
"DOTA_Item_Desc_Copy_of_Drows_Quiver"	" 

"
"DOTA_Item_Kunkkas_Spyglass"	"Kunkkas kikkert"
"DOTA_Item_Desc_Copy_of_Kunkkas_Head"	" 
"
"DOTA_Item_Queen_of_Pains_Wings"	"Queen of Pains vinger"
"DOTA_Item_Desc_Copy_of_Queen_of_Pains_Weapon"	" 
"
"DOTA_Item_Queen_of_Pains_Armor"	"Queen of Pain's Armor"
"DOTA_Item_Desc_Copy_of_Queen_of_Pains_Wings"	" 
"
"DOTA_Item_Queen_of_Pains_Hair"	"Queen of Pains hår"
"DOTA_Item_Desc_Copy_of_Queen_of_Pains_Armor"	" 

"
"DOTA_Item_Ursas_Helmet"	"Ursa's Helmet"
"DOTA_Item_Desc_Copy_of_Queen_of_Pains_Hair"	" 
"
"DOTA_Item_Ursas_Fur"	"Ursa's Fur"
"DOTA_Item_Desc_Copy_of_Ursas_Helmet"	" 
"
"DOTA_Item_Ursas_Bracers"	"Ursa's Bracers"
"DOTA_Item_Desc_Copy_of_Ursas_Fur"	" 
"
"DOTA_Item_Ursas_Skirt"	"Ursa's Skirt"
"DOTA_Item_Desc_Copy_of_Ursas_Bracers"	" 

"
"DOTA_Item_Invokers_Shoulder"	"Invoker's Shoulder"
"DOTA_Item_Facelesss_Head"	"Faceless' hode"
"DOTA_Item_Facelesss_Shoulder"	"Faceless' skuldre"
"DOTA_Item_Facelesss_Bracer"	"Faceless' armbeskytter"
"DOTA_Item_Facelesss_Belt"	"Faceless' belte"
"DOTA_Item_Witch_Doctors_Head"	"Witch Doctor's Head"
"DOTA_Item_Witch_Doctors_Bag"	"Witch Doctor's Bag"
"DOTA_Item_Witch_Doctors_Belt"	"Witch Doctor's Belt"
"DOTA_Item_Witch_Doctors_Staff"	"Witch Doctor's Staff"
"DOTA_Item_Invokers_Head"	"Invoker's Head"
"DOTA_Item_Invokers_Hair"	"Invoker's Hair"
"DOTA_Item_Invokers_Bracer"	"Invoker's Bracer"
"DOTA_Item_Broodmothers_Hair"	"Broodmothers hår"
"DOTA_Item_Broodmothers_Legs"	"Broodmothers bein"
"DOTA_Item_Broodmothers_Abdomen"	"Broodmothers mage"
"DOTA_Item_Meepos_Weapon"	"Meepos våpen"
"DOTA_Item_Ogremagis_Weapon"	"Ogremagi's Weapon"
"DOTA_Item_Desc_Copy_of_weapon"	"Denne nye gjenstanden har ingen beskrivelse."
"DOTA_Item_Spirit_Breakers_Head"	"Spirit Breakers hode"
"DOTA_Item_Lone_Druids_Hair"	"Lone Druids hår"
"DOTA_Item_Desc_head"	"standardhår"
"DOTA_Item_Lone_Druids_Shoulder_Armor"	"Lone Druids skulderrustning"
"DOTA_Item_Desc_Lone_Druids_Shoulder_Armor"	"standardskulderbeskytter"
"DOTA_Item_Lone_Druids_Bracers"	"Lone Druids armbeskyttere"
"DOTA_Item_Desc_Lone_Druids_Bracers"	"standardarmgjenstand"
"DOTA_Item_Lone_Druids_Poncho"	"Lone Druids poncho"
"DOTA_Item_Desc_Lone_Druids_Poncho"	"standardkroppsgjenstand"
"DOTA_Item_Spirit_Breakers_Horns"	"Spirit Breakers horn"
"DOTA_Item_Desc_Copy_of_Spirit_Breakers_Head"	"Denne nye gjenstanden har ingen beskrivelse."
"DOTA_Item_Spirit_Breakers_Shoulder_Armor"	"Spirit Breakers skulderrustning"
"DOTA_Item_Desc_Copy_of_Spirit_Breakers_Horns"	"Denne nye gjenstanden har ingen beskrivelse."
"DOTA_Item_Spirit_Breakers_Mace"	"Spirit Breaker's Mace"
"DOTA_Item_Desc_Copy_of_Spirit_Breakers_Shoulder_Armor"	"Denne nye gjenstanden har ingen beskrivelse."
"DOTA_Item_Spirit_Breakers_Tail"	"Spirit Breakers hale"
"DOTA_Item_Desc_Copy_of_Spirit_Breakers_Mace"	"Denne nye gjenstanden har ingen beskrivelse."
"DOTA_Item_Spirit_Breakers_Bracers"	"Spirit Breakers armbeskyttere"
"DOTA_Item_Desc_Copy_of_Spirit_Breakers_Tail"	"Denne nye gjenstanden har ingen beskrivelse."
"DOTA_Item_Spirit_Breakers_Lower_Armor"	"Spirit Breakers nedre rustning"
"DOTA_Item_Desc_Copy_of_Spirit_Breakers_Bracers"	"Denne nye gjenstanden har ingen beskrivelse."
"DOTA_Item_Alchemists_Goblin_Body"	"Alchemists nissekropp"
"DOTA_Item_Alchemists_Weapon"	"Alchemists våpen"
"DOTA_Item_Alchemists_Saddle"	"Alchemists sal"
"DOTA_Item_Alchemists_Gauntlet"	"Alchemists stridshanske"
"DOTA_Item_Alchemists_Goblin_Hat"	"Alchemists nissehatt"
"DOTA_Item_Alchemists_Left_Bottle"	"Alchemists venstre flaske"
"DOTA_Item_Alchemists_Goblin_Head"	"Alchemists nissehode"
"DOTA_Item_Alchemists_Ogre_Head"	"Alchemists trollhode"
"DOTA_Item_Alchemists_Shoulder_Bottle"	"Alchemists skulderflaske"
"DOTA_Item_Phantom_Lancers_Legs"	"Phantom Lancers bein"
"DOTA_Item_Desc_Phantom_Lancers_Legs"	"Disse støvlene ble skapt for å gå med."
"DOTA_Item_Phantom_Lancers_Head"	"Phantom Lancers hode"
"DOTA_Item_Desc_Phantom_Lancers_Head"	"For å se og snakke. Det er et skjegg på det også.<br><br>standardgjenstand"
"DOTA_Item_Phantom_Lancers_Belt"	"Phantom Lancers belte"
"DOTA_Item_Desc_Phantom_Lancers_Belt"	"Han er den regjerende tungvektsmesteren.<br><br>standardgjenstand"
"DOTA_Item_Phantom_Lancers_Gauntlet"	"Phantom Lancers stridshanske"
"DOTA_Item_Desc_Phantom_Lancers_Gauntlet"	"Bare de tapreste krigerne har på seg kun én hanske i kamp.<br><br>standardgjenstand"
"DOTA_Item_Phantom_Lancers_Shoulderpad"	"Phantom Lancers skulderpute"
"DOTA_Item_Desc_Phantom_Lancers_Shoulderpad"	"Denne armbeskytteren gir beskyttelse mot alvorlige skader fra katteslagsmål.<br><br>standardgjenstand"
"DOTA_Item_Phantom_Lancers_Necklace"	"Phantom Lancers halskjede"
"DOTA_Item_Desc_Phantom_Lancers_Necklace"	"Selv krigere liker å føle seg stilige."
"DOTA_Item_Phantom_Lancers_Weapon"	"Phantom Lancers våpen"
"DOTA_Item_Desc_Phantom_Lancers_Weapon"	"Til å dolke med.<br><br>standardgjenstand"
"DOTA_Item_Ogremagis_Cape"	"Ogremagi's Cape"
"DOTA_Item_Desc_Copy_of_Ogremagis_Weapon"	"Denne nye gjenstanden har ingen beskrivelse."
"DOTA_Item_Ogremagis_Bracers"	"Ogremagi's Bracers"
"DOTA_Item_Desc_Copy_of_Ogremagis_Cape"	"Denne nye gjenstanden har ingen beskrivelse."
"DOTA_Item_Ogremagis_Hats"	"Ogremagi's Hats"
"DOTA_Item_Desc_Copy_of_Ogremagis_Bracers"	"Denne nye gjenstanden har ingen beskrivelse."
"DOTA_Item_Ogremagis_Belt"	"Ogremagi's Belt"
"DOTA_Item_Desc_Copy_of_Ogremagis_Hats"	"Denne nye gjenstanden har ingen beskrivelse."
"DOTA_Item_Wich_Doctors_Horn_Mask"	"Witch Doctor's Horn Mask"
"DOTA_Item_Pangolin_Shoulder_Armor"	"Pangolin Shoulder Armor"
"DOTA_Item_Desc_Pangolin_Shoulder_Armor"	"Mesterlig utformede skulderplater fra Pangolin-klanen. De gir styrken til stålrustninger til en brøkdel av vekten."
"DOTA_Item_Witch_Doctors_Ribcage_Backpack"	"Witch Doctor's Ribcage Backpack"
"DOTA_Item_The_Blood_Chaser"	"The Blood Chaser"
"DOTA_Item_Desc_The_Blood_Chaser"	"Et tredelt sammenlenket skaft med dobbeltbladet øksehode på toppen. Nesten like farlig for den som bærer den som for fienden."
"DOTA_Item_Timestopper"	"Timestopper"
"DOTA_Wearable_FacelessVoid_Timestopper_Desc"	"Dersom dine uutsigelige transdimensjonale makt over kronologi skulle feile i å stoppe fienden, forsøk å slå dem i hodet med denne solide klubben."
"DOTA_Wearable_Dazzle_TrolltoothNecklace"	"Trolltooth Necklace"
"DOTA_Wearable_Dazzle_TrolltoothNecklace_Desc"	"En nøye sammensatt samling av trolltenner. Hver tann inneholder den fangede sjelen til dens tidligere eier."
"DOTA_Item_Dragonclaw_Hook"	"Dragonclaw Hook"
"DOTA_Item_Desc_Dragonclaw_Hook"	"Kloen fra en svartdrages venstre tå. Den eneste delen av beistet som overlevde et møte med Pudges glupske apetitt."
"DOTA_Item_Demon_Blood_Helm"	"Demon Blood Helm"
"DOTA_Item_Desc_Demon_Blood_Helm"	"En hjelm som bærer det kyklopiske ansiktet til Tjernmennenes demoniske krigsgud. Det sies at den Røde Tåke utslettet guden og tok dens symboler som sine egne."
"DOTA_Wearable_Axe_Demon_Blood_Armor"	"Demon Blood Armor"
"DOTA_Item_Desc_Demon_Blood_Armor"	"Tung platerustning smidd i blodet til Tarnsmen-stammens døde guder."
"DOTA_Item_Demon_Blood_Guard"	"Demon Blood Guard"
"DOTA_Item_Desc_Demon_Blood_Guard"	"Når den Røde Tåke slukte de Tusen Tjern, ble innsjøene farget røde av blodet til de drepte. Mange demoner forkledd som lovmakere og prester i den fordømte sivilisasjonen ble også utslettet, og blodet deres blandet seg med blodet til de dødelige de en gang hersket over."
"DOTA_Wearable_Kunkka_Pegleg"	"Pegleg of the Cursed Pirate"
"DOTA_Item_Desc_Pegleg_of_the_Cursed_Pirate"	"Et tapt ben er ingen hindring for Kunkkas hevntørst."
"DOTA_Item_ThreeFold_Mien_of_the_Boar_God"	"Three-Fold Mien of the Boar God"
"DOTA_Item_Desc_ThreeFold_Mien_of_the_Boar_God"	"Villsvinets aspekt bringer helse, virilitet og iver. Det primitive tegnet til fire-syv-tolv."
"DOTA_Item_SevenSealed_the_Fur_Bracer"	"Seven-Sealed the Fur Bracer"
"DOTA_Item_Desc_SevenSealed_the_Fur_Bracer"	"Dette er kun en armbeskytter i pels. Den har ingen interessante aspekter og tilbyr ingen magisk beskyttelse. Allikevel bærer den et stort navn og illustrerer således hulheten i grunnløs stolthet."
"DOTA_Item_TwelveTusks_the_Cape_of_Boars"	"Twelve-Tusks the Cape of Boars"
"DOTA_Item_Desc_TwelveTusks_the_Cape_of_Boars"	"Her har vi ære ganger tolv. Som man ville prydet en verdig krigerkonge, hver tann et triumfsymbol."
"DOTA_Item_FourFangs_the_Swordbreaker"	"Four-Fangs the Swordbreaker"
"DOTA_Item_Desc_FourFangs_the_Swordbreaker"	"Hoggtennene på dette hissige sverdet vil bite seg dypt inn i din fiendes utsatte våpen!"
"DOTA_Wearable_Kunkka_Bandana"	"Pride of the Crew"
"DOTA_Item_Desc_Pride_of_the_Crew"	"Selv kapteinen må fra tid til annen hjelpe mannskapet med skipets daglige gjøremål."
"DOTA_Wearable_Kunkka_Bicorne_Hat"	"Royal Admiral's Bicorne"
"DOTA_Item_Desc_Royal_Admirals_Bicorne"	"En skipsmesters fine båthatt."
"DOTA_Wearable_Kunkka_Tricorne_Hat"	"Tricorne of the Drowned"
"DOTA_Item_Desc_Tricorne_of_the_Drowned"	"En vellaget trekanthatt kantet med gull."
"DOTA_Wearable_Kunkka_Wavecrester"	"Wavecrester"
"DOTA_Item_Pact_of_GorThramak"	"Pact of Gor-Thramak"
"DOTA_Wearable_Axe_Berserkers_Pauldron"	"Berserker's Pauldron"
"DOTA_Wearable_Axe_Berserkers_Helm"	"Berserker's Helm"
"DOTA_Wearable_Axe_Berserkers_Belt"	"Berserker's Belt"
"DOTA_Item_Desc_Berserkers_Belt"	"«La blodbadet begynne.»"
"DOTA_Item_Coat_of_the_Elder_Grove"	"Coat of the Elder Grove"
"DOTA_Item_Horns_of_the_Forest_Lord"	"Horns of the Forest Lord"
"DOTA_Item_Toga_of_the_PeaceBringer"	"Toga of the Peace-Bringer"
"DOTA_Item_Desc_Toga_of_the_PeaceBringer"	"Ganske avslappende."
"DOTA_Item_Luxuriant_ChinFoliage"	"Luxuriant Chin-Foliage"
"DOTA_Item_Horns_of_Noblesse"	"Horns of Noblesse"
"DOTA_Item_Desc_Horns_of_Noblesse"	"Et sett med horn verdige for en konge."
"DOTA_Item_Cape_of_Verdant_Dreaming"	"Cape of Verdant Dreaming"
"DOTA_Item_Runestaff_of_Verodicia"	"Runestaff of Verodicia"
"DOTA_Item_Runed_Ailettes"	"Runed Ailettes"
"DOTA_Item_Lucky_Tooth_Necklace"	"Lucky Tooth Necklace"
"DOTA_Item_Desc_Lucky_Tooth_Necklace"	"Et halskjede av tennene til et sjeldent sjøuhyre."
"DOTA_Item_Captains_Hook"	"Captain's Hook"
"DOTA_Item_Tayrnhelm_of_the_Swordmaster"	"Tayrnhelm of the Swordmaster"
"DOTA_Item_Girth_of_the_Swordmaster"	"Girth of the Swordmaster"
"DOTA_Item_Fluted_Guard_of_the_Swordmaster"	"Fluted Guard of the Swordmaster"
"DOTA_Item_Grip_of_the_Swordmaster"	"Grip of the Swordmaster"
"DOTA_Item_Meranth_Executioners_Blade"	"Meranth Executioner's Blade"
"DOTA_Item_Desc_Meranth_Executioners_Blade"	"Et enegget blad som er perfekt for å raskt fjerne hoder. Eller ben. Eller armer."
"DOTA_Item_Taunt_Snipers_Celebration"	"Hån: Sniper's Celebration"
"DOTA_AnimTaunt_SniperTaunt_Desc"	"Feir et utsøkt drap eller en herlig manøver ved å vise din begeistring til fienden. Han bryr seg sikkert ikke."
"DOTA_Item_Taunt_Beautiful_Snowangel"	"Hån: Beautiful Snowangel"
"DOTA_AnimTaunt_CM_Snowangel_Desc"	"Crystal Maiden lager en snøengel!"
"DOTA_Item_Taunt_Playful_Snowball"	"Hån: Playful Snowball"
"DOTA_AnimTaunt_CM_Snowball_Desc"	"Crystal Maiden kaster en snøball!"
"DOTA_Item_Taunt_Come_and_Get_It"	"Hån: Come and Get It!"
"DOTA_Item_Desc_Taunt_Come_and_Get_It"	"Axe anmoder flere tosker å slakte!"
"DOTA_Item_Taunt_Spider_Shuffle"	"Hån: Spider Shuffle"
"DOTA_Item_Taunt_Good_Day_Sir"	"Hån: Good Day Sir!"
"DOTA_Item_Desc_Taunt_Good_Day_Sir"	" "
"DOTA_Item_Taunt_DoubleHeaded_Roar"	"Hån: Double-Headed Roar"
"DOTA_Item_Taunt_Icemelter"	"Hån: Icemelter"
"DOTA_Item_Taunt_Fish_Treat"	"Hån: Fish Treat"
"DOTA_AnimTaunt_Tidehunter_Toss_Fish_Desc"	" "
"DOTA_Item_Wrath_of_the_Orca"	"Wrath of the Orca"
"DOTA_Item_Desc_Wrath_of_the_Orca"	"Ingen beskrivelse ennå."
"DOTA_Item_Taunt_Get_Burned"	"Hån: Get Burned"
"DOTA_Item_Wuldastron_the_TwinBlade_of_Giants"	"Wuldastron the Twin-Blade of Giants"
"DOTA_Item_Desc_Wuldastron_the_TwinBlade_of_Giants"	"Få mennesker kan bruke et så mektig sverd."
"DOTA_Item_Ultimate_Belly_Flop"	"Ultimat: Belly Flop"
"DOTA_Item_Attack_Fish_Slap"	"Angrep: Fish Slap"
"DOTA_Item_Taunt_The_Jig"	"Hån: The Jig"
"DOTA_Item_Taunt_You"	"Hån: You!"
"DOTA_Item_Taunt_Dive_Dive"	"Hån: Dive! Dive!"
"DOTA_Item_Taunt_Canonical_Blast"	"Hån: Canonical Blast"
"DOTA_Item_Taunt_Shredding_the_Lute_Invisible"	"Hån: Shredding the Lute Invisible"
"DOTA_Item_Taunt_For_Death_and_Honor"	"Hån: For Death and Honor"
"DOTA_Item_Taunt_Face_the_Juggernaut"	"Hån: Face the Juggernaut"
"DOTA_Item_Taunt_Tooting_the_Horn"	"Hån: Tooting the Horn"
"DOTA_Item_Staff_of_the_TuskBereft"	"Staff of the Tusk-Bereft"
"DOTA_Item_Tusked_Bracers"	"Tusked Bracers"
"DOTA_Item_Grand_Crown_of_the_Gigas"	"Grand Crown of the Gigas"
"DOTA_Item_Desc_Grand_Crown_of_the_Gigas"	"Er det noen dyr så majestetisk som kraftfulle Gigas? Til og med Alcer og Cameloider bøyer seg for dem."
"DOTA_Item_Sinorian_Sphere_Staff"	"Sinorian Sphere Staff"
"DOTA_Item_Taunt_Bo_Staff_Beckon"	"Hån: Bo Staff Beckon"
"DOTA_Item_Taunt_Vaudville_Victory_Dance"	"Hån: Vaudville Victory Dance"
"DOTA_Item_Taunt_Murder_Lute"	"Hån: Murder Lute"
"DOTA_Item_Twin_Bull_Adornment"	"Twin Bull Adornment"
"DOTA_Item_Pauldron_of_AlFusha"	"Pauldron of Al-Fusha"
"DOTA_Item_Castors_Spaulder"	"Castor's Spaulder"
"DOTA_Item_Defender_of_the_Ivory_Isles"	"Defender of the Ivory Isles"
"DOTA_Item_Visage_of_the_Ivory_Isles"	"Visage of the Ivory Isles"
"DOTA_Item_Curled_RootStaff"	"Curled Root-Staff"
"DOTA_Item_Flared_Wooden_Crest"	"Flared Wooden Crest"
"DOTA_Item_Fireborn_Odachi"	"Fireborn Odachi"
"DOTA_Item_Taunt_Kata_of_Foot_and_Earth"	"Hån: Kata of Foot and Earth"
"DOTA_Item_Doubly_Braided_Beard"	"Doubly Braided Beard"
"DOTA_Item_Druidic_Ritual_Crest"	"Druidic Ritual Crest"
"DOTA_Item_Stoic_Mask_of_the_High_Plains"	"Stoic Mask of the High Plains"
"DOTA_Item_Wolf_Cape_of_the_High_Plains"	"Wolf Cape of the High Plains"
"DOTA_Item_Aspect_Wraps_of_the_High_Plains"	"Aspect Wraps of the High Plains"
"DOTA_Item_LongFang_the_Grey_Blade"	"Long-Fang the Grey Blade"
"DOTA_Item_Beard_of_Cycles"	"Beard of Cycles"
"DOTA_Item_Desc_Beard_of_Cycles"	"Representerer dette skjegget den brutale livssyklusen i naturen? Eller er det knyttet tilbake bare for å hindre at det kommer i veien for ens kaos? Kanskje den inneholder både et symbol og en hensikt."
"DOTA_Item_Diadem_of_the_Goddess_Enthroned"	"Diadem of the Goddess Enthroned"
"DOTA_Item_Drape_of_Foliate_Magery"	"Drape of Foliate Magery"
"DOTA_Item_Guard_of_the_Deep_Tribes"	"Guard of the Deep Tribes"
"DOTA_Item_PineSage_Sigil_Stones"	"Pine-Sage Sigil Stones"
"DOTA_Item_Modestly_Braided_Beard"	"Modestly Braided Beard"
"DOTA_Item_Taunt_Kata_of_Blade_and_Sky"	"Hån: Kata of Blade and Sky"
"DOTA_Item_Cuffs_of_Oak_and_Yew"	"Cuffs of Oak and Yew"
"DOTA_Item_Kraken_Shell"	"Kraken Shell"
"DOTA_Item_Octopus_Hat"	"Octopus Hat"
"DOTA_Item_Grand_Claive_of_the_Unshamed"	"Grand Claive of the Unshamed"
"DOTA_Item_Wyrm_Shield_of_Uldorak"	"Wyrm Shield of Uldorak"
"DOTA_Item_Belt_o_Wicked_Badness"	"Belt o' Wicked Badness"
"DOTA_Item_Kimono_of_the_Ebony_Tower"	"Kimono of the Ebony Tower"
"DOTA_Item_Bracers_of_the_Ebony_Tower"	"Bracers of the Ebony Tower"
"DOTA_Item_Relic_Blade_of_the_KuurIshiminari"	"Relic Blade of the Kuur-Ishiminari"
"DOTA_Item_Kantusa_the_Script_Sword"	"Kantusa the Script Sword"
"DOTA_Item_Omnishred_the_Defiant"	"Omnishred the Defiant"
"DOTA_Item_Healing_Ward_of_the_KuurIshiminari"	"Healing Ward of the Kuur-Ishiminari"
"DOTA_Item_Call_of_the_Dendrochron"	"Call of the Dendrochron"
"DOTA_Item_100Proof_Jug"	"100-Proof Jug"
"DOTA_Item_Fine_Bone_Bracers"	"Fine Bone Bracers"
"DOTA_Item_PreyTrackers_Aspect_Mask"	"Prey-Tracker's Aspect Mask"
"DOTA_Item_Staff_of_the_Eagle"	"Staff of the Eagle"
"DOTA_Item_Blade_of_the_Dark_Ancients"	"Blade of the Dark Ancients"
"DOTA_Item_Habit_of_the_Seeker"	"Habit of the Seeker"
"DOTA_Item_HlotlFeather_Gloves"	"Hlotl-Feather Gloves"
"DOTA_Item_HlotlTusk_Headdress_of_the_Seeker"	"Hlotl-Tusk Headdress of the Seeker"
"DOTA_Item_HlotlFeather_Necklace"	"Hlotl-Feather Necklace"
"DOTA_Item_Wyrm_Helm_of_Uldorak"	"Wyrm Helm of Uldorak"
"DOTA_Item_Wyrm_Bracer_of_Uldorak"	"Wyrm Bracer of Uldorak"
"DOTA_Item_Wyrm_Skirt_of_Uldorak"	"Wyrm Skirt of Uldorak"
"DOTA_Item_Wyrm_Pauldron_of_Uldorak"	"Wyrm Pauldron of Uldorak"
"DOTA_Item_Gloves_of_the_Admirable_Admiral"	"Gloves of the Admirable Admiral"
"DOTA_Item_Ceremonial_Rapier"	"Ceremonial Rapier"
"DOTA_Item_Sword_of_the_SeventySeven_Seas"	"Sword of the Seventy-Seven Seas"
"DOTA_Item_Grand_Curls_of_the_Admirable_Admiral"	"Grand Curls of the Admirable Admiral"
"DOTA_Item_Seafarers_Shoes"	"Seafarer's Shoes"
"DOTA_Item_BackAche"	"Back-Ache"
"DOTA_Item_Excavators_Treasure"	"Excavator's Treasure"
"DOTA_Item_Excavators_Decorated_Treasure"	"Excavator's Decorated Treasure"
"DOTA_Item_Naval_Mine"	"Naval Mine"
"DOTA_Item_Swamp_Fins"	"Swamp Fins"
"DOTA_Item_Desc_Swamp_Fins"	"Ingen vet om denne oppvisningen betyr at Tidehunter er sint eller i brunst. Uansett har ingen overlevd for å spørre."
"DOTA_Item_Pillar_of_Strength"	"Pillar of Strength"
"DOTA_Item_Stone_Loins"	"Stone Loins"
"DOTA_Item_Stone_Guard"	"Stone Guard"
"DOTA_Item_Stone_Helmet"	"Stone Helmet"
"DOTA_Item_Helm_of_the_Radiant_Crusader"	"Helm of the Radiant Crusader"
"DOTA_Item_Armor_of_the_Radiant_Crusader"	"Armor of the Radiant Crusader"
"DOTA_Item_Bracers_of_the_Radiant_Crusader"	"Bracers of the Radiant Crusader"
"DOTA_Item_Sigil_of_the_Radiant_Crusader"	"Sigil of the Radiant Crusader"
"DOTA_Item_Hammer_of_the_Radiant_Crusader"	"Hammer of the Radiant Crusader"
"DOTA_Item_Champion_of_Emauracus"	"Champion of Emauracus"
"DOTA_Item_Raw_Hide"	"Raw Hide"
"DOTA_Item_Cerebral_Support"	"Cerebral Support"
"DOTA_Item_Femur_Thrasher"	"Femur Thrasher"
"DOTA_Item_BeastJaw_Bludgeoner"	"Beast-Jaw Bludgeoner"
"DOTA_Item_Mask_of_the_Freelancer"	"Mask of the Freelancer"
"DOTA_Item_Shoulderguard_of_the_Freelancer"	"Shoulderguard of the Freelancer"
"DOTA_Item_Pantaloons_of_the_Freelancer"	"Pantaloons of the Freelancer"
"DOTA_Item_Sword_of_the_Freelancer"	"Sword of the Freelancer"
"DOTA_Item_Dragonmaw"	"Dragonmaw"
"DOTA_Item_Pirate_Slayers_Bracer"	"Pirate Slayer's Bracer"
"DOTA_Item_Pirate_Slayers_Tricorn"	"Pirate Slayer's Tricorn"
"DOTA_Item_Squiddles"	"Squiddles"
"DOTA_Item_Spectrolite_Staff"	"Spectrolite Staff"
"DOTA_Item_Sword_of_the_Admirable_Admiral"	"Sword of the Admirable Admiral"
"DOTA_Item_Executioners_Axe"	"Executioner's Axe"
"DOTA_Item_Executioners_Cape"	"Executioner's Cape"
"DOTA_Item_Executioners_Trophies"	"Executioner's Trophies"
"DOTA_Item_Executioners_Hood"	"Executioner's Hood"
"DOTA_Item_SeaGods_Ceremonial_Headdress"	"Sea-God's Ceremonial Headdress"
"DOTA_Item_Desc_SeaGods_Ceremonial_Headdress"	"Denne nye gjenstanden har ingen beskrivelse."
"DOTA_Item_Cold_Case_Bow"	"Cold Case Bow"
"DOTA_Item_Shuriken_of_the_Hidden_Hunter"	"Shuriken of the Hidden Hunter"
"DOTA_Item_Harvester_of_the_Hidden_Hunter"	"Harvester of the Hidden Hunter"
"DOTA_Item_Cleaver_of_the_Hidden_Hunter"	"Cleaver of the Hidden Hunter"
"DOTA_Item_Forgemasters_Apron"	"Forgemaster's Apron"
"DOTA_Item_Forgemasters_Armlet"	"Forgemaster's Armlet"
"DOTA_Item_Forgemasters_Hammer"	"Forgemaster's Hammer"
"DOTA_Item_Forgemasters_Mask"	"Forgemaster's Mask"
"DOTA_Item_Ice_Burst_Bow"	"Ice Burst Bow"
"DOTA_Item_The_Cleaver_of_Might"	"The Cleaver of Might"
"DOTA_Item_Natures_Bow"	"Natures Bow"
"DOTA_Item_Chronite_Armor"	"Chronite Armor"
"DOTA_Item_Chronite_Bracers"	"Chronite Bracers"
"DOTA_Item_Chronite_Scepter"	"Chronite Scepter"
"DOTA_Item_Voidkeepers_Visage"	"Voidkeeper's Visage"
"DOTA_Item_Ice_Burst_Bracers"	"Ice Burst Bracers"
"DOTA_Item_Ice_Burst_Greaves"	"Ice Burst Greaves"
"DOTA_Item_Creepers_Cruel_Painsaw"	"Creeper's Cruel Painsaw"
"DOTA_Item_Creepers_Cruel_Hook"	"Creeper's Cruel Hook"
"DOTA_Item_Creepers_Cruel_Shuriken"	"Creeper's Cruel Shuriken"
"DOTA_Item_Desc_Creepers_Cruel_Shuriken"	"\"Au!\""
"DOTA_Item_Blademothers_Crawlers"	"Blademother's Crawlers"
"DOTA_Item_Blademothers_Goggles"	"Blademother's Goggles"
"DOTA_Item_Blademothers_Abdomen"	"Blademother's Abdomen"
"DOTA_Item_Spiral_Staff"	"Spiral Staff"
"DOTA_Item_Pincher_Bow"	"Pincher Bow"
"DOTA_Item_Dressed_Pauldron_of_the_Mono_Militis"	"Dressed Pauldron of the Mono Militis"
"DOTA_Item_Cyclopean_Helm_of_the_Mono_Militis"	"Cyclopean Helm of the Mono Militis"
"DOTA_Item_Sword_of_the_Mono_Militis"	"Sword of the Mono Militis"
"DOTA_Item_Sword_of_the_Flameguard"	"Sword of the Flameguard"
"DOTA_Item_Pirate_Slayers_Cutlass"	"Pirate Slayer's Cutlass"
"DOTA_Item_Pirate_Slayers_Black_Flag"	"Pirate Slayer's Black Flag"
"DOTA_Item_ShovelMouthed_Mask"	"Shovel-Mouthed Mask"
"DOTA_Item_War_Blade_Right"	"War Blade"
"DOTA_Item_War_Blade_Left"	"War Blade (Venstre)"
"DOTA_Item_Headcrusher"	"Headcrusher"
"DOTA_Item_Helm_of_the_Flameguard"	"Helm of the Flameguard"
"DOTA_Item_Dressed_Pauldron_of_the_Flameguard"	"Dressed Pauldron of the Flameguard"
"DOTA_Item_Cape_of_the_Flameguard"	"Cape of the Flameguard"
"DOTA_Item_Skirt_of_the_Flameguard"	"Skirt of the Flameguard"
"DOTA_Item_Commanders_Helm_of_the_Flameguard"	"Commander's Helm of the Flameguard"
"DOTA_Item_Commanders_Gauntlet_of_the_Flameguard"	"Commander's Gauntlet of the Flameguard"
"DOTA_Item_Lucky_Alpine_Stalkers_Hat"	"Lucky Alpine Stalker's Hat"
"DOTA_Item_Alpine_Stalkers_Scarf"	"Alpine Stalker's Scarf"
"DOTA_Item_Alpine_Stalkers_Pants"	"Alpine Stalker's Pants"
"DOTA_Item_Alpine_Stalkers_Gloves"	"Alpine Stalker's Gloves"
"DOTA_Item_Back_Hook_Right"	"Back Hook"
"DOTA_Item_Back_Hook_Left"	"Back Hook (Venstre)"
"DOTA_Item_Witch_Doctors_Vile_Hat"	"Witch Doctor's Vile Hat"
"DOTA_Item_Desc_Witch_Doctors_Vile_Hat"	"Denne nye gjenstanden har ingen beskrivelse."
"DOTA_Item_Witch_Doctors_Dreaded_Dreads"	"Witch Doctor's Dreaded Dreads"
"DOTA_Item_Juju_o_Wicked_Badness"	"Juju o' Wicked Badness"
"DOTA_Item_Staff_o_Wicked_Badness"	"Staff o' Wicked Badness"
"DOTA_Item_Mask_o_Wicked_Badness"	"Mask o' Wicked Badness"
"DOTA_Item_Witch_Doctors_Shrunken_Head_Staff"	"Witch Doctor's Shrunken Head Staff"
"DOTA_Item_Witch_Doctors_Wooden_Mask"	"Witch Doctor's Wooden Mask"
"DOTA_Item_Wich_Doctors_Tribal_Mask"	"Witch Doctor's Tribal Mask"
"DOTA_Item_Flower_Staff_of_the_PeaceBringer"	"Flower Staff of the Peace-Bringer"
"DOTA_Item_Lei_of_the_PeaceBringer"	"Lei of the Peace-Bringer"
"DOTA_Item_Horns_of_the_PeaceBringer"	"Horns of the Peace-Bringer"
"DOTA_Item_Beard_of_the_PeaceBringer"	"Beard of the Peace-Bringer"
"DOTA_Item_Desc_Beard_of_the_PeaceBringer"	"Lett og dunbløt."
"DOTA_Item_Pangolin_Carapace"	"Pangolin Carapace"
"DOTA_Item_Pangolin_Scarf"	"Pangolin Scarf"
"DOTA_Item_Frost_Spikes"	"Frost Spikes"
"DOTA_Item_Cape_of_the_Burning_Cabal"	"Cape of the Burning Cabal"
"DOTA_Item_Bracer_of_the_Burning_Cabal"	"Bracer of the Burning Cabal"
"DOTA_Item_Crest_of_the_Burning_Cabal"	"Crest of the Burning Cabal"
"DOTA_Item_Stylish_Wizards_Topnot"	"Stylish Wizard's Topnot"
"DOTA_Custom_Courier_ShittyWizard_Desc"	" "
"DOTA_Custom_Courier_MiniPudge_Desc"	"
"
"DOTA_Item_Desc_Copy_of_Minipudge_Courier"	" "
"DOTA_Item_Treasure_Chest"	" "
"DOTA_TreasureChest_Rare"	" "
"DOTA_TreasureChest_Desc"	" "
"DOTA_Item_Name_Tag"	"Navnelapp"
"DOTA_Item_Desc_Tag"	"Merkelapp"
"DOTA_Item_75_Battle_Point_Booster_3_Days"	"75% Battle Point Booster (3 dager)"
"DOTA_Bundle_DOTA2_Access"	"Dota 2-invitasjon"
"DOTA_WearableType_Helmet"	"hjelm"
"DOTA_WearableType_All_Hero_Taunt"	"Alle heltehån"
"DOTA_WearableType_Strange_Modifier"	"Merkelig modifikasjon"
"DOTA_Item_Phantom_Assassins_Helmet"	"Phantom Assassins hjelm"
"DOTA_Item_Phantom_Assassins_Shoulder_Pads"	"Phantom Assassins skulderputer"
"DOTA_Item_Desc_Copy_of_Phantom_Assassins_Helmet"	"Denne nye gjenstanden har ingen beskrivelse."
"DOTA_Item_Phantom_Assassins_Cape"	"Phantom Assassins kappe"
"DOTA_Item_Desc_Copy_of_Phantom_Assassins_Shoulder_Pads"	"Denne nye gjenstanden har ingen beskrivelse."
"DOTA_Item_Phantom_Assassins_Weapon"	"Phantom Assassins våpen"
"DOTA_Item_Desc_Copy_of_Phantom_Assassins_Cape"	"Denne nye gjenstanden har ingen beskrivelse."
"DOTA_Item_Phantom_Assassins_Daggers"	"Phantom Assassins dolker"
"DOTA_Item_Horn_Mask"	"Hornmaske"
"DOTA_Item_Rattlebite"	"Rattlebite"
"DOTA_Item_Taunt_Its_in_the_Bag"	"Hån: It's in the Bag"
"DOTA_Item_Desc_Copy_of_Disruptors_Weapon"	"Denne nye gjenstanden har ingen beskrivelse."
"DOTA_Item_Desc_Copy_of_Disruptors_Bracers"	"Denne nye gjenstanden har ingen beskrivelse."
"DOTA_Item_Desc_Copy_of_Disruptors_Hair"	"Denne nye gjenstanden har ingen beskrivelse."
"DOTA_Item_Desc_Copy_of_Disruptors_Back"	"Denne nye gjenstanden har ingen beskrivelse."
"DOTA_Item_Desc_Copy_of_Disruptors_Shoulder_Armor"	"Denne nye gjenstanden har ingen beskrivelse."
"DOTA_Item_Phantom_Assasins_Doubleblade"	"Phantom Assasins dobbelsverd"
"DOTA_Item_Unusual_Paint"	"Uvanlig maling"
"DOTA_Item_Unusual_Paint_Blue"	"Uvanlig maling: Blå"
"DOTA_Item_Unusual_Paint_Purple"	"Uvanlig maling: Lilla"
"DOTA_Item_Unusual_Paint_Green"	"Uvanlig maling: Grønn"
"DOTA_Item_Unusual_Paint_Light_Green"	"Uvanlig maling: Lysegrønn"
"DOTA_Item_Unusual_Paint_Gold"	"Uvanlig maling: Gull"
"DOTA_Item_Unusual_Paint_Orange"	"Uvanlig maling: Oransje"
"DOTA_Item_Unusual_Paint_Red"	"Uvanlig maling: Rød"
"DOTA_Bundle_Desc_Assemblage_of_Announcers_Pack"	"Inkluderer de følgende, ofte brautende og alltid underholdende oppleserne:"
"DOTA_WearableType_Drum"	"Tromme"
"DOTA_WearableType_Wheel"	"Hjul"
"DOTA_Item_Elder_Tusk_of_the_Brave"	"Elder Tusk of the Brave"
"DOTA_Item_NoGuard_the_Courageous_Edge"	"No-Guard the Courageous Edge"
"DOTA_Item_Radiant_crystal_bracer"	"Radiant Crystal Bracer"
"DOTA_Item_Radiant_crystal_crown"	"Radiant Crystal Crown"
"DOTA_Item_Radiant_crystal_shoulder_armor"	"Radiant Crystal Shoulder Armor"
"DOTA_Item_Radiant_crystal_back_armor"	"Radiant Crystal Back Armor"
"DOTA_WearableType_Knife"	"Kniv"
"DOTA_Item_Brewmasters_Staff"	"Brewmasters stav"
"DOTA_Item_Brewmasters_Barrel"	"Brewmasters tønne"
"DOTA_Item_Desc_Copy_of_Brewmasters_Staff"	"Denne nye gjenstanden har ingen beskrivelse."
"DOTA_Item_Brewmasters_Bracers"	"Brewmasters armbeskyttere"
"DOTA_Item_Desc_Copy_of_Brewmasters_Barrel"	"Denne nye gjenstanden har ingen beskrivelse."
"DOTA_Item_Brewmasters_Backpack"	"Brewmasters ryggsekk"
"DOTA_Item_Brewmasters_Shoulders"	"Brewmasters skuldre"
"DOTA_Item_Desc_Copy_of_Brewmasters_Backpack"	"Denne nye gjenstanden har ingen beskrivelse."
"DOTA_Item_Rikis_Horns"	"Rikis horn"
"DOTA_Item_Desc_Copy_of_Rikis_Daggers"	"
"
"DOTA_Item_Rikis_Shoulder_Armor"	"Rikis skulderrustning"
"DOTA_Item_Desc_Copy_of_Rikis_Horns"	"
"
"DOTA_Item_Rikis_Tail"	"Rikis hale"
"DOTA_Item_Desc_Copy_of_Rikis_Shoulder_Armor"	"
"
"DOTA_Item_Rikis_Gloves"	"Rikis hansker"
"DOTA_Item_Desc_Copy_of_Rikis_Tail"	"
"
"DOTA_Item_Radiant_Crystal_Pauldrons"	"Radiant Crystal Pauldrons"
"DOTA_Item_Radiant_Crystal_Crests"	"Radiant Crystal Crests"
"DOTA_Item_Desc_Copy_of_BladedStaff_of_the_Reaper"	"Denne nye gjenstanden har ingen beskrivelse."
"DOTA_Item_Desc_Copy_of_Makeshift_Sword_of_the_Reaper"	"Denne nye gjenstanden har ingen beskrivelse."
"DOTA_Item_Bloodmist_Belt"	"Bloodmist Belt"
"DOTA_Item_Bloodmist_Helm"	"Bloodmist Helm"
"DOTA_Item_Bloodmist_Crescent_Axe"	"Bloodmist Crescent Axe"
"DOTA_Item_Bloodmist_Pauldrons"	"Bloodmist Pauldrons"
"DOTA_Item_Bloodmist_Armor_Set"	"Sett: Bloodmist Armor"
"DOTA_Item_Lanayas_shoulders"	"Lanayas skuldre"
"DOTA_Item_Chaos_Knights_horse_head"	"Chaos Knights hestehode"
"DOTA_Item_Chaos_Knight_horse_amor"	"Chaos Knights hesterustning"
"DOTA_Item_Chaos_Knight_shoulderpads"	"Chaos Knights skulderputer"
"DOTA_Item_Chaos_Knight_helmet"	"Chaos Knights hjelm"
"DOTA_Item_Chaos_Knight_weapon"	"Chaos Knights våpen"
"DOTA_Item_Chaos_Knight_shield"	"Chaos Knights skjold"
"DOTA_Item_Naga_Sirens_Hair"	"Naga Sirens hår"
"DOTA_Item_Naga_Sirens_Swords"	"Naga Sirens sverd"
"DOTA_Item_Naga_Sirens_Tail"	"Naga Sirens hale"
"DOTA_Item_Naga_Sirens_Armor"	"Naga Sirens rustning"
"DOTA_Item_Gyrocopters_Bottles"	"Gyrocopters flasker"
"DOTA_Item_Gyrocopters_Gloves"	"Gyrocopters hansker"
"DOTA_Item_Gyrocopters_Goggles"	"Gyrocopters briller"
"DOTA_Item_Gyrocopters_Guns"	"Gyrocopters våpen"
"DOTA_Item_Gyrocopters_Propeller"	"Gyrocopters propell"
"DOTA_Item_Gyrocopters_Homing_Missile"	"Gyrocopters heimende missil"
"DOTA_Item_Sand_Kings_Head"	"Sand Kings hode"
"DOTA_Item_Nyxs_Weapon"	"Nyx' våpen"
"DOTA_Item_Nyxs_Armor"	"Nyx' rustning"
"DOTA_Item_Desc_Copy_of_Nyxs_Weapon"	"Denne nye gjenstanden har ingen beskrivelse."
"DOTA_Item_Nyxs_Helmet"	"Nyx' hjelm"
"DOTA_Item_Desc_Copy_of_Nyxs_Armor"	"Denne nye gjenstanden har ingen beskrivelse."
"DOTA_Item_Sand_Kings_Armor"	"Sand Kings rustning"
"DOTA_Item_Sand_Kings_Arms"	"Sand Kings armer"
"DOTA_Item_Sand_Kings_Legs"	"Sand Kings bein"
"DOTA_Item_Sand_Kings_Tail"	"Sand Kings hale"
"DOTA_Item_Assault_Armor_Shoulders"	"Assault Armor Shoulders"
"DOTA_Item_Master_Assassins_Shoulders"	"Master Assassin's Shoulders"
"DOTA_Item_Nightmare_Blade"	"Nightmare Blade"
"DOTA_Item_BloodLetter_Right"	"BloodLetter (høyre)"
"DOTA_Item_BloodLetter_Left"	"BloodLetter (venstre)"
"DOTA_Item_Blood_Ravager"	"Blood Ravager"
"DOTA_Item_Desc_Obsidian_Destroyers_head"	"Denne nye gjenstanden har ingen beskrivelse."
"DOTA_Item_Phantom_Assassins_Head"	"Phantom Assassins hode"
"DOTA_Item_Desc_Copy_of_Rubicks_Staff"	"Denne nye gjenstanden har ingen beskrivelse."
"DOTA_Item_Desc_Copy_of_Rubicks_Cape"	"Denne nye gjenstanden har ingen beskrivelse."
"DOTA_Item_Lycans_Blades"	"Lycans knivblader"
"DOTA_Item_Lycans_Head"	"Lycans hode"
"DOTA_Item_Lycans_Armor"	"Lycans rustning"
"DOTA_Item_Lycans_Fur"	"Lycans pels"
"DOTA_Item_Lycans_Belt"	"Lycans belte"
"DOTA_Item_Necrolytes_Sickle"	"Necrophos' sigd"
"DOTA_Item_Necrolytes_Beard"	"Necrophos' skjegg"
"DOTA_Item_Desc_Copy_of_Necrolytes_Sickle"	"Denne nye gjenstanden har ingen beskrivelse."
"DOTA_Item_Necrolytes_Headdress"	"Necrophos' hodeplagg"
"DOTA_Item_Desc_Copy_of_Necrolytes_Beard"	"Denne nye gjenstanden har ingen beskrivelse."
"DOTA_Item_Necrolytes_Vestments"	"Necrophos' klesdrakt"
"DOTA_Item_Desc_Copy_of_Necrolytes_Headdress"	"Denne nye gjenstanden har ingen beskrivelse."
"DOTA_Item_AntiMages_Head"	"Anti-Mages hode"
"DOTA_Item_AntiMages_Shoulder"	"Anti-Mages skulder"
"DOTA_Item_AntiMages_Arms"	"Anti-Mages armer"
"DOTA_Item_AntiMages_Belt"	"Anti-Mages belte"
"DOTA_Item_Lone_Druids_Weapon"	"Lone Druids våpen"
"DOTA_Item_Desc_Copy_of_Chens_Staff"	"Denne nye gjenstanden har ingen beskrivelse."
"DOTA_Item_Desc_Copy_of_Chens_Mount"	"Denne nye gjenstanden har ingen beskrivelse."
"DOTA_Item_Desc_Copy_of_Chens_Helmet"	"Denne nye gjenstanden har ingen beskrivelse."
"DOTA_Item_Desc_Copy_of_Chens_Bracers"	"Denne nye gjenstanden har ingen beskrivelse."
"DOTA_Item_Desc_Copy_of_Chens_Shoulder_Armor"	"Denne nye gjenstanden har ingen beskrivelse."
"DOTA_Item_Desc_Copy_of_Treants_Head"	"Denne nye gjenstanden har ingen beskrivelse."
"DOTA_Item_Desc_Copy_of_Treants_Foliage"	"Denne nye gjenstanden har ingen beskrivelse."
"DOTA_Item_Desc_Copy_of_Treants_Hands"	"Denne nye gjenstanden har ingen beskrivelse."
"DOTA_Item_Desc_Copy_of_Treants_Feet"	"Denne nye gjenstanden har ingen beskrivelse."
"DOTA_Item_Savage_Beast_Shoulders"	"Savage Beast Shoulders"
"DOTA_Item_Savage_Beast_Weapon_Left"	"Savage Beast Weapon (Venstre)"
"DOTA_Item_Dooms_Weapon"	"Dooms våpen"
"DOTA_Item_Dooms_Helm"	"Dooms hjelm"
"DOTA_Item_Desc_Copy_of_Dooms_Weapon"	"Denne nye gjenstanden har ingen beskrivelse."
"DOTA_Item_Dooms_Shoulder_Armor"	"Dooms skulderrustning"
"DOTA_Item_Desc_Copy_of_Dooms_Helm"	"Denne nye gjenstanden har ingen beskrivelse."
"DOTA_Item_Dooms_Bracers"	"Dooms armbeskyttere"
"DOTA_Item_Desc_Copy_of_Dooms_Shoulder_Armor"	"Denne nye gjenstanden har ingen beskrivelse."
"DOTA_Item_Dooms_Belt"	"Dooms belte"
"DOTA_Item_Desc_Copy_of_Dooms_Bracers"	"Denne nye gjenstanden har ingen beskrivelse."
"DOTA_Item_Dooms_Wings"	"Dooms vinger"
"DOTA_Item_Desc_Copy_of_Dooms_Belt"	"Denne nye gjenstanden har ingen beskrivelse."
"DOTA_Item_Dooms_Tail"	"Dooms hale"
"DOTA_Item_Desc_Copy_of_Dooms_Wings"	"Denne nye gjenstanden har ingen beskrivelse."
"DOTA_Item_Shadow_Shamans_Weapon"	"Shadow Shamans våpen"
"DOTA_Item_Shadow_Shamans_Offhand_Weapon"	"Shadow Shamans sekundærvåpen"
"DOTA_Item_Desc_Copy_of_Shadow_Shamans_Weapon"	"Denne nye gjenstanden har ingen beskrivelse."
"DOTA_Item_Shadow_Shamans_Headdress"	"Shadow Shamans hodeplagg"
"DOTA_Item_Desc_Copy_of_Shadow_Shamans_Offhand_Weapon"	"Denne nye gjenstanden har ingen beskrivelse."
"DOTA_Item_Shadow_Shamans_Armor"	"Shadow Shamans rustning"
"DOTA_Item_Desc_Copy_of_Shadow_Shamans_Headdress"	"Denne nye gjenstanden har ingen beskrivelse."
"DOTA_Item_Shadow_Shamans_Stuff"	"Shadow Shamans saker"
"DOTA_Item_Desc_Copy_of_Shadow_Shamans_Armor"	"Denne nye gjenstanden har ingen beskrivelse."
"DOTA_Item_Shadow_Shamans_Head"	"Shadow Shamans hode"
"DOTA_Item_Desc_Copy_of_Shadow_Shamans_Stuff"	"Denne nye gjenstanden har ingen beskrivelse."
"DOTA_Item_League_AbsoluteArenaKOH_Admin"	"
"
"DOTA_WearableType_Book"	"Bok"
"DOTA_Item_Blood_Seekers_Blade"	"Bloodseekers knivblad"
"DOTA_Item_Blood_Seekers_Blade__OffHand"	"Bloodseekers knivblad – sekundær"
"DOTA_Item_Desc_KotL_Mount"	"
"
"DOTA_Item_Desc_KotL_Weapon"	"
"
"DOTA_Item_Desc_KotL_Skirt"	"
"
"DOTA_Item_Desc_KotL_Horse_Accesories"	"
"
"DOTA_Item_Blood_Seekers_Skirt"	"Bloodseekers skjørt"
"DOTA_Item_back_rings"	"
"
"DOTA_Item_Desc_back_rings"	"
"
"DOTA_Item_cleaver"	"
"
"DOTA_Item_Desc_Copy_of_back_rings"	"
"
"DOTA_Item_left_arm"	"
"
"DOTA_Item_Desc_left_arm"	"
"
"DOTA_Item_bracer"	"
"
"DOTA_Item_Desc_Copy_of_left_arm"	"
"
"DOTA_Item_hair"	"
"
"DOTA_Item_Desc_Copy_of_bracer"	"
"
"DOTA_Item_War_Blade__OffHand"	"War Blade – Off-Hand"
"DOTA_Item_Back_Hook__OffHand"	"Back Hook – Off-Hand"
"DOTA_Item_Shoulders_of_the_Comets_Tail"	"Shoulders of the Comet's Tail"
"DOTA_Item_Bloodletter"	"Bloodletter"
"DOTA_Item_Bloodletter__OffHand"	"Bloodletter – Off-Hand"
"DOTA_Item_Bonehunter_Slicer__OffHand"	"Bonehunter Slicer – Off-Hand"
"DOTA_Item_Bloodlords_Horns"	"Bloodlord's Horns"
"DOTA_Item_Legions_Wrath"	"Legion's Wrath"
"DOTA_Item_Cloak_of_the_Dawn"	"Cloak of the Dawn"
"DOTA_Item_Shoulders_of_the_Twelfth_Day"	"Shoulders of the Twelfth Day"
"DOTA_Item_Desc_Pennant_Upgrade"	"
"
"DOTA_Item_Drows_Headwear"	"Drows hodeplagg"
"DOTA_Item_Pudges_Backrings"	"Pudges ryggringer"
"DOTA_Item_Pudges_Cleaver"	"Pudges kjøttøks"
"DOTA_Item_Pudges_Left_Arm"	"Pudges venstre arm"
"DOTA_Item_Pudges_Bracer"	"Pudges  armbeskytter"
"DOTA_Item_Pudges_Toupee"	"Pudges tupé"
"DOTA_Item_Desc_Copy_of_Drows_Shoulder_Armor"	"
"
"DOTA_Item_Huskars_Spear"	"Huskars spyd"
"DOTA_Item_Huskars_Dagger"	"Huskars dolk"
"DOTA_Item_Huskars_Helmet"	"Huskars hjelm"
"DOTA_Item_Huskars_Shoulder"	"Huskars skulder"
"DOTA_Item_Huskars_Bracer"	"Huskars armbeskytter"
"DOTA_WearableType_Egg"	"Egg"
"DOTA_WearableType_LeagueViewPass_Admin"	"
"
"DOTA_Item_Rikis_Dagger"	"Rikis dolk"
"DOTA_Item_Juggernauts_Weapon"	"Juggernauts våpen"
"DOTA_Item_Juggernauts_Cape"	"Juggernauts kappe"
"DOTA_Item_Juggernauts_Bracers"	"Juggernauts armbeskyttere"
"DOTA_Item_Naga_Sirens_Sword"	"Naga Sirens sverd"
"DOTA_Item_Sand_Kings_Shoulders"	"Sand Kings skuldre"
"DOTA_Item_AntiMages_Armor"	"Anti-Mages rustning"
"DOTA_Item_Desc_Copy_of_Crystal_Maidens_Cape"	"
"
"DOTA_Item_Naga_Sirens_Offhand_Sword"	"Naga Sirens sekundærsverd"
"DOTA_Item_Desc_Copy_of_Naga_Sirens_Sword"	"Denne nye gjenstanden har ingen beskrivelse."
"DOTA_Item_Beastmasters_Weapons"	"Beastmasters våpen"
"DOTA_Item_Beastmasterss_Head"	"Beastmasters hode"
"DOTA_Item_Beastmasters_Shoulder"	"Beastmasters skulder"
"DOTA_Item_Beastmasters_Arms"	"Beastmasters armer"
"DOTA_Item_Beastmasters_Belt"	"Beastmasters belte"
"DOTA_Item_Rikis_Offhand_Dagger"	"Rikis sekundærdolk"
"DOTA_Item_Desc_Copy_of_Rikis_Dagger"	"
"
"DOTA_Item_Spectres_hat"	"Spectres hatt"
"DOTA_Item_Spectres_dress"	"Spectres kjole"
"DOTA_Item_Spectres_wings"	"Spectres vinger"
"DOTA_Item_Magnuss_Hair"	"Magnus' hår"
"DOTA_Item_Magnuss_Horn"	"Magnus' horn"
"DOTA_Item_Magnuss_Bracers"	"Magnus' armbeskyttere"
"DOTA_Item_Magnuss_Belt"	"Magnus' belte"
"DOTA_Item_Magnuss_Weapon"	"Magnus' våpen"
"DOTA_Item_Natures_Shortbow"	"Nature's Shortbow"
"DOTA_Item_Shoulders_of_the_Slain_Dragon"	"Shoulders of the Slain Dragon"
"DOTA_Item_North_Expedition"	"North Expedition"
"DOTA_Item_Kunkkas_Coral_Sword"	"Kunkka's Coral Sword"
"DOTA_Item_Furyblade__OffHand"	"Furyblade – Off-Hand"
"DOTA_Item_Omniscients_Maul"	"Omniscient's Maul"
"DOTA_Item_Shoulders_of_the_New_Season"	"Shoulders of the New Season"
"DOTA_Item_Kunkkas_Shadowblade"	"Kunkka's Shadowblade"
"DOTA_Item_Shadow_Guardian_Belt_set"	"Shadow Guardian Belt (sett)"
"DOTA_Item_Spinal_Slicer__OffHand"	"Spinal Slicer – Off-Hand"
"DOTA_Item_Mask_of_Madness"	"Mask of Madness"
"DOTA_Item_Shadow_Guardian_Blade_set"	"Shadow Guardian Blade (sett)"
"DOTA_Item_Zarukina_Protector_Hair"	"Zaru'kina Protector Hair"
"DOTA_Item_Bloodwood_Arc"	"Bloodwood Arc"
"DOTA_Item_Shadow_Guardian_Shoulder_set"	"Shadow Guardian Shoulder (sett)"
"DOTA_Item_Shadow_Guardian_Mask_set"	"Shadow Guardian Mask (sett)"
"DOTA_Item_Bloodwood_Reserve"	"Bloodwood Reserve"
"DOTA_Item_Crimson_Wyvern_Shoulders"	"Crimson Wyvern Shoulders"
"DOTA_Item_Kunkkas_Spiced_Rum"	"Kunkka's Spiced Rum"
"DOTA_Item_Desc_the_evildoer"	"Denne nye gjenstanden har ingen beskrivelse."
"DOTA_Item_Ember_Scepter"	"Ember Scepter"
"DOTA_Item_Loners_Vanity"	"Loner's Vanity"
"DOTA_Item_Lone_Druids_Hood"	"Lone Druids hette"
"DOTA_Item_Desc_Copy_of_Hair_of_the_Dark_Magic"	"
"
"DOTA_Item_Desc_Copy_of_Cape_of_the_Dark_Magic"	"
"
"DOTA_Item_Shoulders_of_the_Dark_Magic"	"Shoulders of the Dark Magic"
"DOTA_Item_Desc_Copy_of_Bracers_of_the_Dark_Magic"	"
"
"DOTA_Item_League_PremierLeague"	"Premier League"
"DOTA_Item_League_PremierLeague_Desc"	"Drevet av forente krefter mellom TwitchTV og SteelSeries, Season 3 er den nyeste utgaven av Premier League. Se 10 av de beste lagene fra både Europa og Nord-Amerika kjempe for $6000 med 5 intense kamper hver uke i 9 uker. Kommentert av TriumphOfMan."
"DOTA_Item_League_PremierLeague_Admin"	"
"
"DOTA_Bundle_Desc_Axe_Heavy_Steel_Armor_Set"	"
"
"DOTA_Item_Kunkkas_But_Im_Not_A_Pirate_Pack"	"Kunkka's 'But I'm Not A Pirate!' Pack"
"DOTA_Item_Bloodletters"	"Bloodletters Pack"
"DOTA_Item_Doombringers_Weapon"	"Doombringers våpen"
"DOTA_Item_Doombringers_Helm"	"Doombringers hjelm"
"DOTA_Item_Doombringers_Shoulder_Armor"	"Doombringers skulderrustning"
"DOTA_Item_Doombringers_Bracers"	"Doombringers armbeskyttere"
"DOTA_Item_Doombringers_Belt"	"Doombringers belte"
"DOTA_Item_Doombringers_Wings"	"Doombringers vinger"
"DOTA_Item_Doombringers_Tail"	"Doombringers hale"
"DOTA_Item_AntiMages_Offhand_Glaive"	"Anti-Mages sekundærglavin"
"DOTA_Item_Desc_Copy_of_AntiMages_Glaive"	"
"
"DOTA_Item_Nightstalkers_Wings"	"Night Stalkers vinger"
"DOTA_Item_Nightstalkers_Armor"	"Night Stalkers rustning"
"DOTA_Item_Desc_Copy_of_Nightstalkers_Wings"	"Denne nye gjenstanden har ingen beskrivelse."
"DOTA_Item_Nightstalkers_Tail"	"Night Stalkers hale"
"DOTA_Item_Desc_Copy_of_Nightstalkers_Armor"	"Denne nye gjenstanden har ingen beskrivelse."
"DOTA_Item_Razors_Weapon"	"Razors våpen"
"DOTA_Item_Razors_Head"	"Razors hode"
"DOTA_Item_Razors_Armor"	"Razors rustning"
"DOTA_Item_Razors_Bracers"	"Razors armbeskyttere"
"DOTA_Item_Razors_Robe"	"Razors kappe"
"DOTA_Item_AntiMage_Slasher_Offhand_Weapon"	"Anti-Mage Slasher Offhand Weapon"
"DOTA_Item_AntiMage_Slasher_Armor"	"Anti-Mage Slasher Armor"
"DOTA_Item_AntiMage_Slasher_Shoulder"	"Anti-Mage Slasher Shoulder"
"DOTA_Item_AntiMage_Slasher_Bracer"	"Anti-Mage Slasher Bracer"
"DOTA_Item_AntiMage_Slasher_Skirt"	"Anti-Mage Slasher Skirt"
"DOTA_Item_AntiMage_Slasher_Weapon"	"Anti-Mage Slasher Weapon"
"DOTA_Item_AntiMage_Slasher_Helm"	"Anti-Mage Slasher Helm"
"DOTA_Item_Unusual_Essence"	"Uvanlig essens"
"DOTA_Item_Shadow_Essence"	"Shadow Essence"
"DOTA_Item_Kunkkas_Hair"	"Kunkkas hår"
"DOTA_Item_Slarks_Weapon"	"Slarks våpen"
"DOTA_Item_Desc_Copy_of_Dark_Seers_Hat"	"Denne nye gjenstanden har ingen beskrivelse."
"DOTA_Item_Desc_Copy_of_Dark_Seers_Loin_Cloth"	"Denne nye gjenstanden har ingen beskrivelse."
"DOTA_Item_Slarks_Bracers"	"Slarks armbeskyttere"
"DOTA_Item_Desc_Copy_of_Slarks_Weapon"	"Denne nye gjenstanden har ingen beskrivelse."
"DOTA_Item_Slarks_Shoulder_Armor"	"Slarks skulderrustning"
"DOTA_Item_Desc_Copy_of_Slarks_Bracers"	"Denne nye gjenstanden har ingen beskrivelse."
"DOTA_Item_Slarks_Cape"	"Slarks kappe"
"DOTA_Item_Desc_Copy_of_Slarks_Shoulder_Armor"	"Denne nye gjenstanden har ingen beskrivelse."
"DOTA_Item_Slarks_Hood"	"Slarks hette"
"DOTA_Item_Kunkkas_Shoulder_Guard"	"Kunkkas skulderbeskytter"
"DOTA_Item_Desc_Copy_of_Kunkkas_Spyglass"	"
"
"DOTA_Item_Centaurs_Axe"	"Centaurs øks"
"DOTA_Item_Centaurs_Horns_and_Hair"	"Centaurs horn og hår"
"DOTA_Item_Desc_Copy_of_Centaurs_Axe"	"Denne nye gjenstanden har ingen beskrivelse."
"DOTA_Item_Centaurs_Upper_Armor"	"Centaurs øvre rustning"
"DOTA_Item_Desc_Copy_of_Centaurs_Pride"	"Denne nye gjenstanden har ingen beskrivelse."
"DOTA_Item_Centaurs_Belt_Buckle"	"Centaurs beltespenne"
"DOTA_Item_Desc_Copy_of_Centaurs_Upper_Armor"	"Denne nye gjenstanden har ingen beskrivelse."
"DOTA_Item_Centaurs_Trophies"	"Centaurs trofeer"
"DOTA_Item_Desc_Copy_of_Centaurs_Belt_Buckle"	"Denne nye gjenstanden har ingen beskrivelse."
"DOTA_Item_Centaurs_Bracers"	"Centaurs armbeskyttere"
"DOTA_Item_Desc_Copy_of_Centaurs_Trophies"	"Denne nye gjenstanden har ingen beskrivelse."
"DOTA_Item_Centaurs_Tail"	"Centaurs hale"
"DOTA_Item_Desc_Copy_of_Centaurs_Bracers"	"Denne nye gjenstanden har ingen beskrivelse."
"DOTA_Item_Glaive_of_the_Mage_Slayer__OffHand"	"Glaive of the Mage Slayer – Off-Hand"
"DOTA_Item_Desc_Greevil_Nose_1"	"
"
"DOTA_Item_Desc_Copy_of_Lions_Default_Weapon"	"Denne nye gjenstanden har ingen beskrivelse."
"DOTA_Item_Desc_Copy_of_Lions_Default_cape"	"Denne nye gjenstanden har ingen beskrivelse."
"DOTA_Item_Lions_Default_Shoulders"	"Lions standardskuldre"
"DOTA_Item_Desc_Copy_of_Lions_Default_Hat"	"Denne nye gjenstanden har ingen beskrivelse."
"DOTA_Item_Desc_Copy_of_Lions_Default_Shoulders"	"Denne nye gjenstanden har ingen beskrivelse."
"DOTA_Item_Ghost_Orb_of_the_Planeswalker"	"Ghost Orb of the Planeswalker"
"DOTA_Item_Desc_Copy_of_Pucks_Wings"	"Denne nye gjenstanden har ingen beskrivelse."
"DOTA_Item_Desc_Copy_of_Pucks_Tail"	"Denne nye gjenstanden har ingen beskrivelse."
"DOTA_Item_Desc_base_off_hand_ranged_weapon"	"Denne nye gjenstanden har ingen beskrivelse."
"DOTA_Item_troll_warlord_base_weapon_melee"	"
"
"DOTA_Item_troll_warlord_off_hand_base_weapon_melee"	"
"
"DOTA_Item_Nightmare_Beacon"	"Nightmare Beacon"
"DOTA_Item_Naked_Air"	"Naked Air"
"DOTA_Item_Naked_Ambience"	"Naked Ambience"
"DOTA_Item_Naked_Aura"	"Naked Aura"
"DOTA_Item_Razer_Mini_Madness__Admin"	"Razer Mini Madness – Admin"
"DOTA_Item_RaidCall_Dota_2_League__Admin"	"RaidCall Dota 2 League – Admin"
"DOTA_Item_Premier_League__Admin"	"Premier League - Admin"
"DOTA_Item_Ramnaught_of_Underwool"	"Ramnaught of Underwool"
"DOTA_Item_League_DreamHackWinter2012_Admin"	"DreamHack Dota 2 Corsair Vengeance Cup ADMIN"
"DOTA_Item_Medusas_Bow"	"Medusas bue"
"DOTA_Item_Medusas_Veil"	"Medusas slør"
"DOTA_Item_Desc_Copy_of_Medusas_Bow"	"Denne nye gjenstanden har ingen beskrivelse."
"DOTA_Item_Medusas_Chest_Armor"	"Medusas brystrustning"
"DOTA_Item_Desc_Copy_of_Medusas_Veil"	"Denne nye gjenstanden har ingen beskrivelse."
"DOTA_Item_Medusas_Bracers"	"Medusas armbeskyttere"
"DOTA_Item_Desc_Copy_of_Medusas_Chest_Armor"	"Denne nye gjenstanden har ingen beskrivelse."
"DOTA_Item_Medusas_Tail"	"Medusas hale"
"DOTA_Item_Desc_Copy_of_Medusas_Bracers"	"Denne nye gjenstanden har ingen beskrivelse."
"DOTA_Item_Desc_Copy_of_Shredder_Drivers_Hat"	"Denne nye gjenstanden har ingen beskrivelse."
"DOTA_Item_Desc_Copy_of_Shredders_Claw"	"Denne nye gjenstanden har ingen beskrivelse."
"DOTA_Item_Desc_Copy_of_Shredders_Chainsaw"	"Denne nye gjenstanden har ingen beskrivelse."
"DOTA_Item_Desc_Copy_of_Shredders_Shoulder_Armor"	"Denne nye gjenstanden har ingen beskrivelse."
"DOTA_Item_Undyings_Bracer"	"Undyings armbeskytter"
"DOTA_Item_Undyings_Helmet"	"Undyings hjelm"
"DOTA_Item_Desc_Copy_of_Undyings_Bracer"	"Denne nye gjenstanden har ingen beskrivelse."
"DOTA_Item_Undyings_Armor"	"Undyings rustning"
"DOTA_Item_Desc_Copy_of_Undyings_Helmet"	"Denne nye gjenstanden har ingen beskrivelse."
"DOTA_Item_Undyings_Shoulder_Armor"	"Undyings skulderrustning"
"DOTA_Item_Desc_Copy_of_Undyings_Armor"	"Denne nye gjenstanden har ingen beskrivelse."
"DOTA_Item_NaVis_Weaselcrow"	"Na'Vi's Weaselcrow"
"DOTA_Item_Dragon_Knight_Ward"	"Dragon Knight Ward"
"DOTA_WearableType_Wand"	"Tryllestav"
"DOTA_WearableType_Axes"	"Økser"
"DOTA_WearableType_Hud_Skin"	"Grensesnitt"
"DOTA_WearableType_Announcer_Bundle"	"Oppleserpakke"
"DOTA_Item_Spectres_weapon"	"Spectres våpen"
"DOTA_Item_Shadow_Demons_Cape"	"Shadow Demons kappe"
"DOTA_Item_Shadow_Demons_Armor"	"Shadow Demons rustning"
"DOTA_Item_Desc_Copy_of_Shadow_Demons_Cape"	"Denne nye gjenstanden har ingen beskrivelse."
"DOTA_Item_Shadow_Demons_Belt"	"Shadow Demons belte"
"DOTA_Item_Desc_Copy_of_Shadow_Demons_Armor"	"Denne nye gjenstanden har ingen beskrivelse."
"DOTA_Item_Shadow_Demons_Tail"	"Shadow Demons hale"
"DOTA_Item_Desc_Copy_of_Shadow_Demons_Belt"	"Denne nye gjenstanden har ingen beskrivelse."
"DOTA_Item_Rampant_the_Scaled_Hunter"	"Rampant the Scaled Hunter"
"DOTA_Item_Shoulders_of_the_Grand_Inquisitor"	"Shoulders of the Grand Inquisitor"
"DOTA_Item_Cloak_of_the_Stormcrow"	"Cloak of the Stormcrow"
"DOTA_Item_Blade_of_the_Slithereen_Exile__OffHand"	"Blade of the Slithereen Exile – Off-Hand"
"DOTA_Item_Ember_Edge"	"Ember Edge"
"DOTA_Item_Bloodstained_Britches"	"Bloodstained Britches"
"DOTA_Item_Pile_of_Coal"	"Kullhaug"
"DOTA_Item_RaidCall_Dota_2_League_Season_2"	"RaidCall Dota 2 League Season 2"
"DOTA_Item_RaidCall_Dota_2_League_Season_2_ADMIN"	"RaidCall Dota 2 League Season 2 – ADMIN"
"DOTA_Item_Miranas_Bow"	"Miranas bue"
"DOTA_Item_Miranas_Mount"	"Miranas ridedyr"
"DOTA_Item_Desc_Copy_of_Miranas_Bow"	"Denne nye gjenstanden har ingen beskrivelse."
"DOTA_Item_Miranas_Headdress"	"Miranas hodeplagg"
"DOTA_Item_Desc_Copy_of_Miranas_Mount"	"Denne nye gjenstanden har ingen beskrivelse."
"DOTA_Item_Miranas_Cape"	"Miranas kappe"
"DOTA_Item_Desc_Copy_of_Miranas_Headdress"	"Denne nye gjenstanden har ingen beskrivelse."
"DOTA_Item_Miranas_Shoulders"	"Miranas skuldre"
"DOTA_Item_Desc_Copy_of_Miranas_Cape"	"Denne nye gjenstanden har ingen beskrivelse."
"DOTA_Item_Miranas_Bracers"	"Miranas armbeskyttere"
"DOTA_Item_Desc_Copy_of_Miranas_Shoulders"	"Denne nye gjenstanden har ingen beskrivelse."
"DOTA_Item_Miranas_Quiver"	"Miranas kogger"
"DOTA_Item_Desc_Copy_of_Miranas_Bracers"	"Denne nye gjenstanden har ingen beskrivelse."
"DOTA_Item_troll_warlord_base_shoulders"	"troll_warlord_base_shoulders"
"DOTA_Item_Arc_of_the_Solar_Divine"	"Arc of the Solar Divine"
"DOTA_Item_Chaos_Knights_horse"	"Chaos Knights hest"
"DOTA_WearableType_shoulders"	"Skuldre"
"DOTA_Item_Troll_Warlords_Default_Shoulders"	"Troll Warlords standardskuldre"
"DOTA_Item_Desc_Troll_Warlords_Default_Shoulders"	"Troll Warlords standardskuldre"
"DOTA_Item_Cloak_of_the_Haruspex"	"Cloak of the Haruspex"
"DOTA_Item_Reliquary_of_Rotting_Doom"	"Reliquary of Rotting Doom"
"DOTA_Item_Spirit_of_Calm"	"Spirit of Calm"
"DOTA_WearableType_Golem"	"Warlock-golem"
"DOTA_WearableType_Armguard"	"Armbeskytter"
"DOTA_Item_Slardar_Weapon"	"Slardars våpen"
"DOTA_Item_Slardar_Fin"	"Slardars finne"
"DOTA_Item_Slardar_Head"	"Slardars hode"
"DOTA_Item_Slardar_Arms"	"Slardars armer"
"DOTA_Item_Snipers_Weapon"	"Snipers våpen"
"DOTA_Item_Snipers_Cape"	"Snipers kappe"
"DOTA_Item_Desc_Copy_of_Snipers_Weapon"	"Denne nye gjenstanden har ingen beskrivelse."
"DOTA_Item_Snipers_Head_Gear"	"Snipers hodeplagg"
"DOTA_Item_Desc_Copy_of_Snipers_Cape"	"Denne nye gjenstanden har ingen beskrivelse."
"DOTA_Item_Snipers_Shoulder_Armor"	"Snipers skulderrustning"
"DOTA_Item_Desc_Copy_of_Snipers_Head_Gear"	"Denne nye gjenstanden har ingen beskrivelse."
"DOTA_Item_Snipers_Bracers"	"Snipers armbeskyttere"
"DOTA_Item_Desc_Copy_of_Snipers_Shoulder_Armor"	"Denne nye gjenstanden har ingen beskrivelse."
"DOTA_Item_Desc_Copy_of_Enchantress_Necklace"	"Denne nye gjenstanden har ingen beskrivelse."
"DOTA_Item_Desc_Copy_of_Enchantress_Hair"	"Denne nye gjenstanden har ingen beskrivelse."
"DOTA_Item_Desc_Copy_of_Enchantress_Dress"	"Denne nye gjenstanden har ingen beskrivelse."
"DOTA_Item_Desc_Copy_of_Enchantress_Bracers"	"Denne nye gjenstanden har ingen beskrivelse."
"DOTA_Item_Desc_venomancers_mandibles"	"Denne nye gjenstanden har ingen beskrivelse."
"DOTA_Item_Desc_Copy_of_venomancers_mandibles"	"Denne nye gjenstanden har ingen beskrivelse."
"DOTA_Item_Desc_Venomancers_Limbs"	"Denne nye gjenstanden har ingen beskrivelse."
"DOTA_Item_Desc_Copy_of_Venomancers_Limbs"	"Denne nye gjenstanden har ingen beskrivelse."
"DOTA_Item_Desc_Copy_of_Venomancers_Tail"	"Denne nye gjenstanden har ingen beskrivelse."
"DOTA_Item_Meepos_Hood"	"Meepos hette"
"DOTA_Item_Desc_Copy_of_Meepos_Weapon"	"Denne nye gjenstanden har ingen beskrivelse."
"DOTA_Item_Meepos_Backpack"	"Meepos ryggsekk"
"DOTA_Item_Desc_Copy_of_Meepos_Hood"	"Denne nye gjenstanden har ingen beskrivelse."
"DOTA_Item_Meepos_Shoulderpads"	"Meepos skulderplater"
"DOTA_Item_Desc_Copy_of_Meepos_Backpack"	"Denne nye gjenstanden har ingen beskrivelse."
"DOTA_Item_Meepos_Bracers"	"Meepos armbeskyttere"
"DOTA_Item_Desc_Copy_of_Meepos_Shoulderpads"	"Denne nye gjenstanden har ingen beskrivelse."
"DOTA_Item_Meepos_Tail"	"Meepos hale"
"DOTA_Item_Desc_Copy_of_Meepos_Bracers"	"Denne nye gjenstanden har ingen beskrivelse."
"DOTA_Item_Silencers_Shoulders"	"Silencers skuldre"
"DOTA_Item_Shoulders_of_Claszureme"	"Shoulders of Claszureme"
"DOTA_Item_Shoulders_of_Timeless_Ritual"	"Shoulders of Timeless Ritual"
"DOTA_Item_Necklace_of_the_Wildwings_Blessing"	"Necklace of the Wildwing's Blessing"
"DOTA_Item_Etched_Crescent_of_Yoskreth__OffHand"	"Etched Crescent of Yoskreth – Off-Hand"
"DOTA_Item_Desc_Warlock_Ward"	"
"
"DOTA_WearableType_Eye"	"Øye"
"DOTA_Item_Tusks_Hat"	"Tusks hatt"
"DOTA_Item_Tusks_Horns"	"Tusks horn"
"DOTA_Item_Tusks_Weapon"	"Tusks våpen"
"DOTA_Item_Tusks_Fish_Basket"	"Tusks fiskekurv"
"DOTA_Item_Rubicks_Head"	"Rubicks hode"
"DOTA_Item_Nightsilver_Bracers"	"Nightsilver Bracers"
"DOTA_Item_Nightsilver_Quiver"	"Nightsilver Quiver"
"DOTA_Item_Nightsilver_Raiments"	"Nightsilver Raiments"
"DOTA_Item_Nightsilver_Regalia"	"Nightsilver Regalia"
"DOTA_Item_Nightsilver_Locks"	"Nightsilver Locks"
"DOTA_Item_Nightsilver_Bow"	"Nightsilver Bow"
"DOTA_Item_The_Premier_League_Season_4"	"Premier League Season 4"
"DOTA_Item_RaidCall_EMS_One_Spring_2013"	"RaidCall EMS One Spring 2013"
"DOTA_Item_RaidCall_EMS_One_Spring_2013_ADMIN"	"RaidCall EMS One Spring 2013 ADMIN"
"DOTA_Item_OLD__The_Premier_League_Season_4"	"OLD - Premier League Season 4"
"DOTA_WearableType_Claws"	"Klør"
"DOTA_Item_Chained_Snatcher"	"Chained Snatcher"
"DOTA_Item_Chained_Chopper"	"Chained Chopper"
"DOTA_Item_The_Premier_League_Season_4_ADMIN"	"Premier League Season 4 ADMIN"
"DOTA_Item_Skywrath_Mages_Shoulders"	"Skywrath Mages skuldre"
"DOTA_Item_Royal_Dagger_of_the_Tahlin_Watch__OffHand"	"Royal Dagger of the Tahlin Watch – Off-Hand"
"DOTA_WearableType_Flask"	"Flaske"
"DOTA_WearableType_Bat"	"Flaggermus"
"DOTA_Item_Shoulders_of_the_Hidden_Talent"	"Shoulders of the Hidden Talent"
"DOTA_Item_Chains_of_the_EcclesiastKing"	"Chains of the Ecclesiast-King"
"DOTA_Item_Arcane_Staff_of_the_Ancients"	"Arcane Staff of the Ancients"
"DOTA_Item_Ragestone_Axe"	"Ragestone Axe"
"DOTA_Item_Ember_Tipped_Carapace"	"Ember Tipped Carapace"
"DOTA_Item_Ember_Tipped_Striders"	"Ember Tipped Striders"
"DOTA_Item_Ember_Tipped_Manipulators"	"Ember Tipped Manipulators"
"DOTA_Item_Ember_Tipped_Antennae"	"Ember Tipped Antennae"
"DOTA_Item_Ember_Tipped_Carapace_Set"	"Sett: Ember Tipped Carapace"
"DOTA_WearableType_Artifact"	"Artefakt"
"DOTA_Item_Cloak_of_Inscrutable_Zeal"	"Cloak of Inscrutable Zeal"
"DOTA_Item_Rikis_Sange_and_Yasha"	"Riki's Sange and Yasha"
"DOTA_Item_Tidehunters_Barbed_Belt"	"Tidehunter's Barbed Belt"
"DOTA_WearableType_Horse"	"Hest"
"DOTA_Item_Nimble_Ben"	"Nimble Ben"
"DOTA_Item_Desc_Copy_of_bristelback_weapon"	"Denne nye gjenstanden har ingen beskrivelse."
"DOTA_Item_Desc_Copy_of_bristelback_back"	"Denne nye gjenstanden har ingen beskrivelse."
"DOTA_Item_Desc_Copy_of_bristelback_bracer"	"Denne nye gjenstanden har ingen beskrivelse."
"DOTA_Item_Desc_Copy_of_bristelback_head"	"Denne nye gjenstanden har ingen beskrivelse."
"DOTA_Item_Legion_Commander_Banners"	"Legion Commanders faner"
"DOTA_Item_Legion_Commander_Bracers"	"Legion Commanders armbeskyttere"
"DOTA_Item_Legion_Commander_Helmet"	"Legion Commanders hjelm"
"DOTA_Item_Legion_Commander_Shoulders"	"Legion Commanders skuldre"
"DOTA_Item_Legion_Commander_Weapon"	"Legion Commanders våpen"
"DOTA_Item_Chain_of_Enduring_Torment"	"Chain of Enduring Torment"
"DOTA_WearableType_Ice"	"Is"
"DOTA_Item_Desc_Copy_of_Vengeful_Wings"	"Denne nye gjenstanden har ingen beskrivelse."
"DOTA_Item_Desc_Copy_of_Vengeful_Skirt"	"Denne nye gjenstanden har ingen beskrivelse."
"DOTA_Item_Vengeful_Shoulders"	"Vengeful Shoulders"
"DOTA_Item_Desc_Copy_of_Vengeful_Bracers"	"Denne nye gjenstanden har ingen beskrivelse."
"DOTA_Item_Desc_Copy_of_Vengeful_Shoulders"	"Denne nye gjenstanden har ingen beskrivelse."
"DOTA_Item_Desc_Copy_of_Vengeful_Hair"	"Denne nye gjenstanden har ingen beskrivelse."
"DOTA_Item_Desc_Copy_of_Vengeful_Weapon"	"Denne nye gjenstanden har ingen beskrivelse."
"DOTA_Item_Netolic_Pro_League_2nd_edition"	"Netolic Pro League 2nd edition"
"DOTA_Item_Netolic_Pro_League_2nd_edition__ADMIN"	"Netolic Pro League 2nd edition – ADMIN"
"DOTA_Item_Radiant_Crystal_Haul"	"Radiant Crystal Haul"
"DOTA_Item_Blade_of_the_Subtle_Demon__OffHand"	"Blade of the Subtle Demon – Off-Hand"
"DOTA_Item_AMD_Dota2_Premier_League"	"AMD Dota2 Premier League"
"DOTA_Item_Desc_AMD_Dota2_Premier_League"	"AMD, i samarbeid med DotaTalk, er stolte av å gi deg AMD Premier League. I turneringen møtes Sør-Asias fremste lag for å konkurrere om en total premiepott på $5000. To måneder med intens action vil bli kommentert av GoDz, LD, Luminous og Blaze fra BeyondthesummitTV."
"DOTA_Item_AMD_Dota2_Premier_League_ADMIN"	"AMD Dota2 Premier League -ADMIN"
"DOTA_Item_Desc_AMD_Dota2_Premier_League_ADMIN"	"AMD, i samarbeid med DotaTalk, er stolte av å gi deg AMD Premier League. I turneringen møtes Sør-Asias fremste lag for å konkurrere om en total premiepott på $5000. To måneder med intens action vil bli kommentert av GoDz, LD, Luminous og Blaze fra BeyondthesummitTV."
"DOTA_WearableType_Face"	"Ansikt"
"DOTA_Item_Young_Alchemists_Knot"	"Young Alchemist's Knot"
"DOTA_Item_Young_Alchemists_Protection"	"Young Alchemist's Protection"
"DOTA_Item_Taunt_Victory_Jig"	"Hån: Victory Jig"
"DOTA_Item_Sandworn_Visage_of_the_Ancient_Sovereign"	"Sandworn Visage of the Ancient Sovereign"
"DOTA_Item_Taunt_Celebration_of_Death"	"Hån: Celebration of Death"
"DOTA_Item_Nature"	"Nature"
"DOTA_Item_Arctic_Hunter_Set"	"Sett: Arctic Hunter"
"DOTA_Item_Arctic_Hunters_Glove"	"Arctic Hunter's Glove"
"DOTA_Item_Arctic_Hunters_Hood"	"Arctic Hunter's Hood"
"DOTA_Item_Arctic_Hunters_Ice_Axe"	"Arctic Hunter's Ice Axe"
"DOTA_Item_Arctic_Hunters_Parka"	"Arctic Hunter's Parka"
"DOTA_Item_Arctic_Hunters_Snack"	"Arctic Hunter's Snack"
"DOTA_Item_Arctic_Hunters_Tusks"	"Arctic Hunter's Tusks"
"DOTA_Item_Rapture_Gaming_Network_League"	"Rapture Gaming Network League"
"DOTA_Item_Rapture_Gaming_Network_League__ADMIN"	"Rapture Gaming Network League – ADMIN"
"DOTA_Item_Desc_Stone_Ruin"	"Se opp for kaoset fra fortiden. 

Inkludert med Premier League Season 5-billetten."
"DOTA_Item_Premier_League_Season_5"	"Premier League Season 5"
"DOTA_Item_Premier_League_Season_5__ADMIN"	"Premier League Season 5 - ADMIN"
"DOTA_Item_RaidCall_EMS_One_Summer_2013"	"RaidCall EMS One Summer 2013"
"DOTA_Item_RaidCall_EMS_One_Summer_2013__ADMIN"	"RaidCall EMS One Summer 2013 – ADMIN"
"DOTA_Item_RaidCall_Dota_2_League_Season_3"	"RaidCall Dota 2 League Season 3"
"DOTA_Item_RaidCall_Dota_2_League_Season_3__ADMIN"	"RaidCall Dota 2 League Season 3 – ADMIN"
"DOTA_Item_Taunt_Sharp_Blade"	"Hån: Sharp Blade"
"DOTA_Item_Taunt__Shake_Your_Money_Maker"	"Hån: Shake Your Money Maker"
"DOTA_Item_Desc_Copy_of_Lunas_Helmet"	"Denne nye gjenstanden har ingen beskrivelse."
"DOTA_Item_Desc_Copy_of_Lunas_Mount"	"Denne nye gjenstanden har ingen beskrivelse."
"DOTA_Item_Desc_Copy_of_Lunas_Shield"	"Denne nye gjenstanden har ingen beskrivelse."
"DOTA_Item_Desc_Copy_of_Lunas_Weapon"	"Denne nye gjenstanden har ingen beskrivelse."
"DOTA_Item_Gemmed_Bracers_of_the_Priest_Kings"	"Gemmed Bracers of the Priest Kings"
"DOTA_Item_Gemmed_Mitre_of_the_Priest_Kings"	"Gemmed Mitre of the Priest Kings"
"DOTA_Item_Gemmed_Pauldrons_of_the_Priest_Kings"	"Gemmed Pauldrons of the Priest Kings"
"DOTA_Item_Lunas_Head"	"Lunas hode"
"DOTA_Item_Lunas_Helmet"	"Lunas hjelm"
"DOTA_Item_Lunas_Mount"	"Lunas ridedyr"
"DOTA_Item_Lunas_Shield"	"Lunas skjold"
"DOTA_Item_Lunas_Shoulder_Armor"	"Lunas skulderrustning"
"DOTA_Item_Lunas_Weapon"	"Lunas våpen"
"DOTA_Item_Abaddons_Cape"	"Abaddons kappe"
"DOTA_Item_Abaddons_Helmet"	"Abaddons hjelm"
"DOTA_Item_Abaddons_Mount"	"Abaddons ridedyr"
"DOTA_Item_Abaddons_Shoulder_Armor"	"Abaddons skulderrustning"
"DOTA_Item_Abaddons_Weapon"	"Abaddons våpen"
"DOTA_Item_Axe_of_the_Red_Conqueror"	"Axe of the Red Conqueror"
"DOTA_Item_Desc_Copy_of_Abaddons_Cape"	"Denne nye gjenstanden har ingen beskrivelse."
"DOTA_Item_Desc_Copy_of_Abaddons_Helmet"	"Denne nye gjenstanden har ingen beskrivelse."
"DOTA_Item_Desc_Copy_of_Abaddons_Shoulder_Armor"	"Denne nye gjenstanden har ingen beskrivelse."
"DOTA_Item_Desc_Copy_of_Abaddons_Weapon"	"Denne nye gjenstanden har ingen beskrivelse."
"DOTA_Item_Dragon_Shield"	"Dragon Shield"
"DOTA_Item_Nails_in_the_Mad_Harvester"	"Nails in the Mad Harvester"
"DOTA_Item_Nightwatchers_Belt"	"Nightwatcher's Belt"
"DOTA_Item_Nightwatchers_Bracers"	"Nightwatcher's Bracers"
"DOTA_Item_Nightwatchers_Helm"	"Nightwatcher's Helm"
"DOTA_Item_Nightwatchers_Pauldrons"	"Nightwatcher's Pauldrons"
"DOTA_Item_Nightwatchers_Set"	"Sett: Nightwatchers"
"DOTA_Item_Svens_Sword"	"Svens sverd"
"DOTA_Item_AMD_Dota2_Premier_League_Season_2"	"AMD Dota2 Premier League Season 2"
"DOTA_Item_AMD_Dota2_Premier_League_Season_2__ADMIN"	"AMD Dota2 Premier League Season 2 - ADMIN"
"DOTA_Item_Armguard_of_the_Steppe"	"Armguard of the Steppe"
"DOTA_Item_Desc_AMD_Dota2_Premier_League_Season_2"	"Den etterlengtede AMD Premier League Season Two er tilbake. Se på at Sørøst-Asias fremste lag; Orange, Zenith, Mufc, Vici Gaming og flere konkurrerer om en total premiepott på $5000. Denne ene måneden med intens action vil bli brakt til deg av DotaTalk og drevet av AMD."
"DOTA_Item_Desc_Copy_of_AMD_Dota2_Premier_League_Season_2"	"Den etterlengtede AMD Premier League Season Two er tilbake. Se på at Sør-Asias fremste lag; Tongfu, Zenith, Orange og flere konkurrerer om en total premiepott på $5000. Denne ene måneden med intens action vil bli brakt til deg av DotaTalk og drevet av AMD."
"DOTA_Item_Nexon_Starter_League"	"Nexon Starter League"
"DOTA_Item_Nexon_Starter_League__ADMIN"	"Nexon Starter League – ADMIN"
"DOTA_Item_Cloak_of_the_Nimble_Edge"	"Cloak of the Nimble Edge"
"DOTA_Item_Elder_Bark"	"Elder Bark"
"DOTA_Item_Gloves_of_Retribution"	"Gloves of Retribution"
"DOTA_Item_Rack_of_Sundering"	"Rack of Sundering"
"DOTA_Item_Taunt_Keep_an_Ear_Out"	"Hån: Keep an Ear Out"
"DOTA_Item_Taunt_Shake_Your_Money_Maker"	"Hån: Shake Your Money Maker"
"DOTA_Item_Taunt_The_Magic_Ends_Here"	"Hån: The Magic Ends Here"
"DOTA_Item_Yonexs_Rage"	"Yonex's Rage"
"DOTA_WearableType_Wolf"	"Ulv"
"DOTA_Item_Desc_AMD_Dota2_Premier_League_Season_2__ADMIN"	"Den etterlengtede AMD Premier League Season Two er tilbake. Se på at Sør-Asias fremste lag; Orange, Zenith, Mufc, Vici Gaming og flere konkurrerer om en total premiepott på $5000. Denne ene måneden med intens action vil bli brakt til deg av DotaTalk og drevet av AMD."
"DOTA_Item_Desc_Copy_of_Earthshakers_Bracers"	"Denne nye gjenstanden har ingen beskrivelse."
"DOTA_Item_Desc_Copy_of_Earthshakers_Totem"	"Denne nye gjenstanden har ingen beskrivelse."
"DOTA_Item_Earthshakers_Belt"	"Earthshakers belte"
"DOTA_Item_Earthshakers_Bracers"	"Earthshakers armbeskyttere"
"DOTA_Item_Earthshakers_Totem"	"Earthshakers totem"
"DOTA_Item_NightHunters_Belt"	"NightHunters Belt"
"DOTA_Item_NightHunters_Bracers"	"NightHunters Bracers"
"DOTA_Item_NightHunters_Tail"	"NightHunters Tail"
"DOTA_Item_NightHunters_Wings"	"NightHunters Wings"
"DOTA_Item_NightHunters_helmet"	"NightHunters helmet"
"DOTA_Item_Battleseeker_Shoulders"	"Battleseeker Shoulders"
"DOTA_Item_Blade_of_the_Blood_Covenant__OffHand"	"Blade of the Blood Covenant – Off-Hand"
"DOTA_Item_Blood_Covenant_Blade_Pack"	"Blood Covenant Blade Pack"
"DOTA_Item_Bloodstone_of_the_Ancestor"	"Bloodstone of the Ancestor"
"DOTA_Item_Bloodstone_of_the_Founder"	"Bloodstone of the Founder"
"DOTA_Item_Bloodstone_of_the_Precursor"	"Bloodstone of the Precursor"
"DOTA_Item_Mok"	"Mok"
"DOTA_Item_Nomads_Barbed_Edge"	"Nomad's Barbed Edge"
"DOTA_Item_Nomads_Edge__OffHand"	"Nomad's Edge – Off-Hand"
"DOTA_Item_Nomads_Guards"	"Nomad's Guards"
"DOTA_Item_Nomads_Shelter"	"Nomad's Shelter"
"DOTA_Item_Rachel_the_Mordebat"	"Rachel the Morde-bat"
"DOTA_Item_Tinkers_Shoulders"	"Tinkers skuldre"
"DOTA_WearableType_Arm"	"Arm"
"DOTA_WearableType_Passport_Fantasy_Team"	"Kompendium-fantasilag"
"DOTA_Item_Abaddons_Cowl_Down"	"Abaddon's Cowl Down"
"DOTA_Item_Abaddons_Gryphon"	"Abaddon's Gryphon"
"DOTA_Item_Abaddons_Raven_Shoulders"	"Abaddon's Raven Shoulders"
"DOTA_Item_Abaddons_Talon_Cape"	"Abaddon's Talon Cape"
"DOTA_Item_Arc_of_the_Northern_Wind"	"Arc of the Northern Wind"
"DOTA_Item_Arctic_Bracers_of_the_North"	"Arctic Bracers of the North"
"DOTA_Item_Ataxia"	"Ataxia"
"DOTA_Item_Autograph"	"Autograf"
"DOTA_Item_Bite_of_the_Slithereen_Knight__OffHand"	"Bite of the Slithereen Knight – Off-Hand"
"DOTA_Item_Chaos_Knights_Armlet_of_Mordiggian"	"Chaos Knight's Armlet of Mordiggian"
"DOTA_Item_Cloak_of_the_Boreal_Watch"	"Cloak of the Boreal Watch"
"DOTA_Item_Cloak_of_the_Northern_Wind"	"Cloak of the Northern Wind"
"DOTA_Item_Dragon_Forged_Armor"	"Dragon Forged Armor"
"DOTA_Item_Dragon_Forged_Set"	"Sett: Dragon Forged"
"DOTA_Item_Dragon_Forged_Staff"	"Dragon Forged Staff"
"DOTA_Item_Dragon_Forged_Stare"	"Dragon Forged Stare"
"DOTA_Item_Dragon_Forged_Wings"	"Dragon Forged Wings"
"DOTA_Item_Dragon_Sword"	"Dragon Sword"
"DOTA_Item_Embers_of_Endless_Havoc_Set"	"Sett: Embers of Endless Havoc"
"DOTA_Item_Heat"	"Hete"
"DOTA_Item_Kunkkas_Shadow_Blade"	"Kunkka's Shadow Blade"
"DOTA_Item_Natures_Grip"	"Nature's Grip"
"DOTA_Item_Neolution_GosuCup"	"Neolution GosuCup"
"DOTA_Item_Neolution_GosuCup__ADMIN"	"Neolution GosuCup – ADMIN"
"DOTA_Item_Nightblades_of_the_Hypnos"	"Nightblades of the Hypnos"
"DOTA_Item_Nyx_Assassins_Dagon"	"Nyx Assassin's Dagon"
"DOTA_Item_Raven_Scythe"	"Raven Scythe"
"DOTA_Item_Shadow_Armor_of_the_Hypnos"	"Shadow Armor of the Hypnos"
"DOTA_Item_Shadowshard"	"Shadowshard"
"DOTA_Item_Shadowshard__OffHand"	"Shadowshard – Off-Hand"
"DOTA_Item_Shadowshards"	"Shadowshards"
"DOTA_Item_Shoulders_of_the_North"	"Shoulders of the North"
"DOTA_Item_Spectral_Light"	"Spectral Light"
"DOTA_Item_Spirit_of_the_Atniw"	"Spirit of the Atniw"
"DOTA_Item_Starlight_Armguards"	"Starlight Armguards"
"DOTA_Item_Tahlin_Occult_Dagger__OffHand"	"Tahlin Occult Dagger – Off-Hand"
"DOTA_WearableType_Beast"	"Beist"
"DOTA_Item_Bladebreaker_Armguards"	"Bladebreaker Armguards"
"DOTA_Item_Bladebreaker_Dagger__OffHand"	"Bladebreaker Dagger – Off-Hand"
"DOTA_Item_Chained_Beauty"	"Chained Beauty"
"DOTA_Item_Chained_Guard"	"Chained Guard"
"DOTA_Item_Chained_Spur"	"Chained Spur"
"DOTA_Item_Chained_Wings"	"Chained Wings"
"DOTA_Item_Cloak_of_the_Dark_Wraith"	"Cloak of the Dark Wraith"
"DOTA_Item_Gift_of_the_Sea_Shoulders"	"Gift of the Sea Shoulders"
"DOTA_Item_Netolic_Pro_League_3rd_Edition"	"Netolic Pro League 3rd Edition"
"DOTA_Item_Netolic_Pro_League_3rd_Edition__ADMIN"	"Netolic Pro League 3rd Edition – ADMIN"
"DOTA_Item_The_Gallows_Understudy_Blade__OffHand"	"Gallows Understudy Blade – Off-Hand"
"DOTA_WearableType_Masks"	"Masker"
"DOTA_Item_Nibbles_the_Wartoise"	"Nibbles the Wartoise"
"DOTA_Item_RaidCall_EMS_One_Fall_2013"	"RaidCall EMS One Fall 2013"
"DOTA_Item_RaidCall_EMS_One_Fall_2013ADMIN"	"RaidCall EMS One Fall 2013 – ADMIN"
"DOTA_Item_StarSeries_Season_7"	"StarSeries sesong 7"
"DOTA_Item_StarSeries_Season_7ADMIN"	"StarSeries sesong 7-ADMIN"
"DOTA_Item_NADota_Elite_League"	"NADota Elite League"
"DOTA_Item_NADota_Elite_League__ADMIN"	"NADota Elite League – ADMIN"
"DOTA_Item_Tidehunter_Blink_Dagger"	"Tidehunter Blink Dagger"
"DOTA_Item_Nexon_Sponsorship_League"	"Nexon Sponsorship League"
"DOTA_Item_Nexon_Sponsorship_League__ADMIN"	"Nexon Sponsorship League – ADMIN"
"DOTA_Item_Arc_of_Manta"	"Arc of Manta"
"DOTA_Item_Arc_of_Manta__OffHand"	"Arc of Manta – Off-Hand"
"DOTA_Item_Arcs_of_Manta_Pack"	"Arcs of Manta Pack"
"DOTA_Item_Gyrocopters_head"	"Gyrocopters hode"
"DOTA_Item_Nightwatchers_Guard"	"Nightwatcher's Guard"
"DOTA_Item_Nightwatchers_Mask"	"Nightwatcher's Mask"
"DOTA_Item_Nightwatchers_Staff"	"Nightwatcher's Staff"
"DOTA_Item_Raiment_of_the_Chiseled_Guard"	"Raiment of the Chiseled Guard"
"DOTA_Item_Baekho"	"Baekho"
"DOTA_Item_Desc_Copy_of_WETA_Placeholder_1"	"Denne nye gjenstanden har ingen beskrivelse."
"DOTA_Item_Desc_Copy_of_WETA_Placeholder_2"	"Denne nye gjenstanden har ingen beskrivelse."
"DOTA_Item_Desc_Copy_of_WETA_Placeholder_3"	"Denne nye gjenstanden har ingen beskrivelse."
"DOTA_Item_Shadow_Brand"	"Shadow Brand"
"DOTA_Item_Hare_Hunt_Shoulders"	"Hare Hunt Shoulders"
"DOTA_Item_Neptunian_Sabre"	"Neptunian Sabre"
"DOTA_Item_Netolic_Pro_League_4"	"Netolic Pro League 4"
"DOTA_Item_Netolic_Pro_League_4__Admin"	"Netolic Pro League 4 – Admin"
"DOTA_Item_Spirit_Crusher"	"Spirit Crusher"
"DOTA_Item_Desc_Copy_of_SteelSeries_Malaysia_Cup__October"	"Denne nye gjenstanden har ingen beskrivelse."
"DOTA_Item_Arcane_Drapings"	"Arcane Drapings"
"DOTA_Item_Arcane_Fist"	"Arcane Fist"
"DOTA_Item_Arcane_Shield"	"Arcane Shield"
"DOTA_Item_Arcane_Sight"	"Arcane Sight"
"DOTA_Item_Eki_Bukaw_Wand__OffHand"	"Eki Bukaw Wand – Off-Hand"
"DOTA_Item_Necklace_of_Scarlet_Raven"	"Necklace of Scarlet Raven"
"DOTA_Item_Reprieve_of_the_Clergy_Ascetic__OffHand"	"Reprieve of the Clergy Ascetic – Off-Hand"
"DOTA_Item_Talon_of_the_Scarlet_Raven__OffHand"	"Talon of the Scarlet Raven – Off-Hand"
"DOTA_Item_Temper_of_the_Highborn__OffHand"	"Temper of the Highborn – Off-Hand"
"DOTA_Item_Nexon_Invitational_Super_Match"	"Nexon Invitational Super Match"
"DOTA_Item_Nexon_Invitational_Super_Match__ADMIN"	"Nexon Invitational Super Match – ADMIN"
"DOTA_Item_Azuremir"	"Azuremir"
"DOTA_Item_NADota_Elite_League_Season_2"	"NADota Elite League Season 2"
"DOTA_Item_NADota_Elite_League_Season_2__ADMIN"	"NADota Elite League Season 2 – ADMIN"
"DOTA_Item_Nexon_Invitational_Super_Match_"	"Nexon Invitational Super Match"
"DOTA_Teams_Absolute_Legends"	"Absolute Legends"
"DOTA_Teams_Alliance"	"Alliance"
"DOTA_Teams_CLG"	"CLG"
"DOTA_Teams_Complexity"	"Complexity"
"DOTA_Teams_Darer"	"Darer"
"DOTA_Teams_Dignitas"	"Dignitas"
"DOTA_Teams_DK"	"DK"
"DOTA_Teams_EHOME"	"EHOME"
"DOTA_Teams_EvilGeniuses"	"Evil Geniuses"
"DOTA_Teams_Fnatic"	"Fnatic"
"DOTA_Teams_iG"	"iG"
"DOTA_Teams_LGD"	"LGD"
"DOTA_Teams_LGD_Int"	"LGD.Int"
"DOTA_Teams_Liquid"	"Liquid"
"DOTA_Teams_Mousesports"	"Mousesports"
"DOTA_Teams_mTw"	"mTw"
"DOTA_Teams_MUFC"	"MUFC"
"DOTA_Teams_NaVi"	"NaVi"
"DOTA_Teams_Orange"	"Orange"
"DOTA_Teams_TongFu"	"TongFu"
"DOTA_Teams_WorldElite"	"World Elite"
"DOTA_Teams_Zenith"	"Zenith"
"DOTA_Corporations_Liquid_ixmike88"	"Liquid`ixmike88"
"DOTA_Corporations_iceiceice"	"iceiceice"
"DOTA_Corporations_BurNIng"	"BurNIng"
"DOTA_Corporations_Kuroky"	"Kuroky"
"DOTA_Corporations_Sing"	"Sing"
"DOTA_Item_Bloodstone_Blade"	"Bloodstone Blade"
"DOTA_Item_Bloodstone_Blade_Pack"	"Bloodstone Blade Pack"
"DOTA_Item_Bloodstone_Blade__OffHand"	"Bloodstone Blade – Off-Hand"
"DOTA_Item_Desc_Bloodstone_Blade"	" 
"
"DOTA_Item_Desc_Bloodstone_Blade__OffHand"	" "
"DOTA_Item_Desc_Copy_of_Ember_Spirits_Back_Item"	"Denne nye gjenstanden har ingen beskrivelse."
"DOTA_Item_Desc_Copy_of_Ember_Spirits_Belt_Item"	"Denne nye gjenstanden har ingen beskrivelse."
"DOTA_Item_Desc_Copy_of_Ember_Spirits_Head_Item"	"Denne nye gjenstanden har ingen beskrivelse."
"DOTA_Item_Desc_Copy_of_Ember_Spirits_Main_Weapon"	"Denne nye gjenstanden har ingen beskrivelse."
"DOTA_Item_Desc_Copy_of_Ember_Spirits_Offhand_Weapon"	"Denne nye gjenstanden har ingen beskrivelse."
"DOTA_Item_Desc_Copy_of_Ember_Spirits_Shoulders"	"Denne nye gjenstanden har ingen beskrivelse."
"DOTA_Item_Desc_Crown_of_Omoz"	" "
"DOTA_Item_Desc_Dark_Tracer"	" "
"DOTA_Item_Desc_Demonic_Collar"	" "
"DOTA_Item_Desc_Demonshard"	" "
"DOTA_Item_Desc_Dorsal_Doom"	" "
"DOTA_Item_Desc_Hook_of_the_Sorrowful_Prey"	" 
"
"DOTA_Item_Desc_Icewrack_Pack"	" 
"
"DOTA_Item_Desc_Lighted_Scepter_of_Serendipity"	" 
"
"DOTA_Item_Desc_Mantle_of_the_Crystalline_Queen"	" 
"
"DOTA_Item_Desc_Monarch"	" 
"
"DOTA_Item_Desc_Mr_Depth_Driller"	" 
"
"DOTA_Item_Desc_Sanurok_the_Ever_Able"	" 
"
"DOTA_Item_Desc_Spell_Devourer"	" 
"
"DOTA_Item_Desc_The_Elder_Shield"	" 
"
"DOTA_Item_Desc_The_Torchbearer"	" 
"
"DOTA_Item_Desc_Tiara_of_the_Crystalline_Queen"	" 
"
"DOTA_Item_Earth_Spirits_Arms"	"Earth Spirits armer"
"DOTA_Item_Earth_Spirits_Belt"	"Earth Spirits belte"
"DOTA_Item_Earth_Spirits_Hat"	"Earth Spirits hatt"
"DOTA_Item_Earth_Spirits_Head"	"Earth Spirits hode"
"DOTA_Item_Earth_Spirits_Staff"	"Earth Spirits stav"
"DOTA_Item_Earth_Spirits_Torso"	"Earth Spirits torso"
"DOTA_Item_Ember_Spirits_Arm_Item"	"Ember Spirits armgjenstand"
"DOTA_Item_Ember_Spirits_Back_Item"	"Ember Spirits ryggjenstand"
"DOTA_Item_Ember_Spirits_Belt_Item"	"Ember Spirits beltegjenstand"
"DOTA_Item_Ember_Spirits_Head_Item"	"Ember Spirits hodegjenstand"
"DOTA_Item_Ember_Spirits_Main_Weapon"	"Ember Spirits hovedvåpen"
"DOTA_Item_Ember_Spirits_Offhand_Weapon"	"Ember Spirits sekundærvåpen"
"DOTA_Item_Ember_Spirits_Shoulders"	"Ember Spirits skuldre"
"DOTA_Item_Lunacy_Bringer_Set"	"Sett: Lunacy Bringer"
"DOTA_Item_Necropolis"	"Necropolis"
"DOTA_Item_Phantoms_Reaper"	"Phantom's Reaper"
"DOTA_Item_Piercing_Umbrage__OffHand"	"Piercing Umbrage – Off-Hand"
"DOTA_Item_Shoulders_of_the_Death_Charge"	"Shoulders of the Death Charge"
"DOTA_Item_Shoulders_of_the_Forest_Hermit"	"Shoulders of the Forest Hermit"
"DOTA_Item_Slashing_Quickslicer__OffHand"	"Slashing Quickslicer – Off-Hand"
"DOTA_Item_Vestments_of_the_Ten_Plagues_Shoulders"	"Vestments of the Ten Plagues Shoulders"
"DOTA_WearableType_Loading_Screen"	"Lasteskjerm"
"DOTA_WearableType_Shoulders_and_Mask"	"Skuldre og maske"
"DOTA_Item_Dazzles_Shoulders"	"Dazzles skuldre"
"DOTA_Item_Axe_of_Phractos"	"Axe of Phractos"
"DOTA_Item_Doom_of_Ithogoaki"	"Doom of Ithogoaki"
"DOTA_Item_Necrophoss_Beard"	"Necrophos' skjegg"
"DOTA_Item_Necrophoss_Headdress"	"Necrophos' hodeplagg"
"DOTA_Item_Necrophoss_Sickle"	"Necrophos' sigd"
"DOTA_Item_Necrophoss_Vestments"	"Necrophos' klesdrakt"
"DOTA_Item_Netherax_Nightmare_of_the_Mist"	"Netherax, Nightmare of the Mist"
"DOTA_Item_Nexon_Sponsorship_League_Season_2"	"Nexon Sponsorship League Season 2"
"DOTA_Item_Nexon_Sponsorship_League_Season_2__ADMIN"	"Nexon Sponsorship League Season 2 – ADMIN"
"DOTA_Item_Pudges_Belt"	"Pudges belte"
"DOTA_Item_Desc_Copy_of_Saratov_Cup_Open_Finals"	"Denne nye gjenstanden har ingen beskrivelse."
"DOTA_Item_Noriet_the_Dusky_Guardian"	"Noriet the Dusky Guardian"
"DOTA_Item_Raidcall_Southeast_Asian_Invitational_League"	"Raidcall Southeast Asian Invitational League"
"DOTA_Item_Raidcall_Southeast_Asian_Invitational_League__ADMIN"	"Raidcall Southeast Asian Invitational League – ADMIN"
"DOTA_Item_Razer_Pinoy_Cup_Season_1"	"Razer Pinoy Cup Season 1"
"DOTA_Item_Razer_Pinoy_Cup_Season_1__ADMIN"	"Razer Pinoy Cup Season 1 – ADMIN"
"DOTA_Item_80_Battle_Point_Booster_500_minutes"	"80% Battle Point Booster (500 minutter)"
"DOTA_Item_Blood_Chaser"	"Blood Chaser"
"DOTA_Item_Blood_Drainer_Hook"	"Blood Drainer Hook"
"DOTA_Item_Blood_Shard"	"Blood Shard"
"DOTA_Item_Desc_Clash_of_Heroes_II"	"Denne nye gjenstanden har ingen beskrivelse."
"DOTA_Item_Elder_Shield"	"Elder Shield"
"DOTA_Item_Gallows_Understudy_Blade__OffHand"	"Gallows Understudy Blade – Off-Hand"
"DOTA_Item_Lone_Travelers_Beret"	"Lone Traveler's Beret"
"DOTA_Item_Raiders_Patch"	"Raider's Patch"
"DOTA_Item_Shoulders_of_the_Fungal_Lord"	"Shoulders of the Fungal Lord"
"DOTA_Item_Spectral_Blade"	"Spectral Blade"
"DOTA_Item_Spirit_of_the_Howling_Wolf_Set"	"Sett: Spirit of the Howling Wolf"
"DOTA_Item_Spiritual_Spirits"	"Spiritual Spirits"
"DOTA_Item_Sri_Lanka_Cyber_Games_2013"	"Sri Lanka Cyber Games 2013"
"DOTA_Item_Wings_of_Obelis_Shoulders"	"Wings of Obelis Shoulders"
"DOTA_Item_Wraith_Kings_Cape"	"Wraith Kings kappe"
"DOTA_Item_Wraith_Kings_Gauntlet"	"Wraith Kings stridshanske"
"DOTA_Item_Wraith_Kings_Shoulder"	"Wraith Kings skuldre"
"DOTA_Item_Wraith_Kings_Weapon"	"Wraith Kings våpen"
"DOTA_Item_Wraith_Kings_head"	"Wraith Kings hode"
"DOTA_Item_Wraith_Kings_Favor"	"Wraith King's Favor"
"DOTA_WearableType_Collector_of_Shining_Fragments"	"Battle Point Booster"
"DOTA_Item_Desc_Copy_of_Invokers_Bracer"	"Denne nye gjenstanden har ingen beskrivelse."
"DOTA_Item_Desc_Hallowed_Horde"	" "
"DOTA_Item_Alchemists_Infuser"	"Alchemists Infuser"
"DOTA_Item_Iceforged_Shoulders"	"Iceforged Shoulders"
"DOTA_Item_Omnivus"	"Omnivus"
"DOTA_Item_Rune_Forged_Shoulders"	"Rune Forged Shoulders"
"DOTA_Item_WraithNight_Feretory"	"Wraith-Night Feretory"
"DOTA_Corporations_D2L"	"D2L"
"DOTA_Item_NADota_Elite_League_Season_3"	"NADota Elite League Season 3"
"DOTA_Item_NADota_Elite_League_Season_3__ADMIN"	"NADota Elite League Season 3 – ADMIN"
"DOTA_Item_Nexon_Sponroship_League_Season_3"	"Nexon Sponsorship League Season 3"
"DOTA_Item_Nexon_Sponroship_League_Season_3__ADMIN"	"Nexon Sponsorship League Season 3 – ADMIN"
"DOTA_Item_Nexon_Sponsorship_League_Season_3"	"Nexon Sponsorship League Season 3"
"DOTA_Item_Nexon_Sponsorship_League_Season_3_Bundle"	"Pakke: Nexon Sponsorship League Season 3"
"DOTA_Corporations_BZZ"	"BZZ"
"DOTA_Corporations_CaspeRRR"	"CaspeRRR"
"DOTA_Item_Nether_Heart"	"Nether Heart"
"DOTA_Item_Nether_Lords_Belt"	"Nether Lord's Belt"
"DOTA_Item_Nether_Lords_Bracer"	"Nether Lord's Bracer"
"DOTA_Item_Nether_Lords_Cape"	"Nether Lord's Cape"
"DOTA_Item_Nether_Lords_Devourer"	"Nether Lord's Devourer"
"DOTA_Item_Nether_Lords_Hat"	"Nether Lord's Hat"
"DOTA_Item_Nether_Lords_Regalia_Set"	"Sett: Nether Lord's Regalia"
"DOTA_Item_Nether_Lords_Scepter"	"Nether Lord's Scepter"
"DOTA_WearableType_Armbands"	"Armbånd"
"DOTA_WearableType_Fur"	"Pels"
"DOTA_Item_Chaos_Legion_Drapes"	"Chaos Legion Drapes"
"DOTA_Item_Chaos_Legion_Helm"	"Chaos Legion Helm"
"DOTA_Item_Chaos_Legion_Mount"	"Chaos Legion Mount"
"DOTA_Item_Chaos_Legion_Set"	"Sett: Chaos Legion"
"DOTA_Item_Chaos_Legion_Shield"	"Chaos Legion Shield"
"DOTA_Item_Chaos_Legion_Weapon"	"Chaos Legion Weapon"
"DOTA_Item_Netolic_Pro_League_5_East"	"Netolic Pro League 5 East"
"DOTA_Item_Netolic_Pro_League_5_East_Bundle"	"Pakke: Netolic Pro League 5 East"
"DOTA_Item_Netolic_Pro_League_5_East__ADMIN"	"Netolic Pro League 5 East – ADMIN"
"DOTA_Item_Netolic_Pro_League_5_West"	"Netolic Pro League 5 West"
"DOTA_Item_Netolic_Pro_League_5_West_Bundle"	"Pakke: Netolic Pro League 5 West"
"DOTA_Item_Netolic_Pro_League_5_West__ADMIN"	"Netolic Pro League 5 West – ADMIN"
"DOTA_Item_Oblivion_Headmaster_Shoulders"	"Oblivion Headmaster Shoulders"
"DOTA_Item_Ashtongue"	"Ashtongue"
"DOTA_Item_Ember_Crane"	"Ember Crane"
"DOTA_Item_Ember_Crane_Set"	"Sett: Ember Crane"
"DOTA_Item_Ember_Pauldrons_of_Prosperity"	"Ember Pauldrons of Prosperity"
"DOTA_Item_Ember_Spirits_Hat"	"Ember Spirit's Hat"
"DOTA_Item_Face_of_Delicacies_of_Butchery"	"Face of Delicacies of Butchery"
"DOTA_Item_Gyrotechnic_Assault"	"Gyrotechnic Assault"
"DOTA_Item_Gyrotechnic_Dragon_Launchers"	"Gyrotechnic Dragon Launchers"
"DOTA_Item_Gyrotechnic_Mask"	"Gyrotechnic Mask"
"DOTA_Item_Gyrotechnic_Propeller"	"Gyrotechnic Propeller"
"DOTA_Item_Gyrotechnic_Skyrocket"	"Gyrotechnic Skyrocket"
"DOTA_Item_Gyrotechnic_Wings"	"Gyrotechnic Wings"
"DOTA_Item_Gyrotechnics_Set"	"Sett: Gyrotechnics"
"DOTA_Item_Necklace_of_the_Demon_Stone"	"Necklace of the Demon Stone"
"DOTA_Item_Northern_Round_Shield"	"Northern Round Shield"
"DOTA_Item_Northman_Shoulders"	"Northman Shoulders"
"DOTA_Item_Phoenix_Helm_of_Prosperity"	"Phoenix Helm of Prosperity"
"DOTA_WearableType_Sniper_Rifle"	"Snikskytterrifle"
"DOTA_Item_Fire_Tribunal_Shoulders"	"Fire Tribunal Shoulders"
"DOTA_Item_Netolic_Amateur_League_Season_1"	"Netolic Amateur League Season 1"
"DOTA_Item_Netolic_Amateur_League_Season_1_Bundle"	"Pakke: Netolic Amateur League Season 1"
"DOTA_Item_Netolic_Amateur_League_Season_1__ADMIN"	"Netolic Amateur League Season 1 – ADMIN"
"DOTA_Item_Sentinel_Shoulders"	"Sentinel Shoulders"
"DOTA_Item_Antiquity"	"Antiquity"
"DOTA_Item_Lifestealers_Belt"	"Lifestealers belte"
"DOTA_Item_Lifestealers_Chains"	"Lifestealers lenker"
"DOTA_Item_Nether_Grandmasters_Bite"	"Nether Grandmaster's Bite"
"DOTA_Item_Nether_Grandmasters_Bracers"	"Nether Grandmaster's Bracers"
"DOTA_Item_Nether_Grandmasters_Cape"	"Nether Grandmaster's Cape"
"DOTA_Item_Nether_Grandmasters_Covering"	"Nether Grandmaster's Covering"
"DOTA_Item_Nether_Grandmasters_Points"	"Nether Grandmaster's Points"
"DOTA_Item_Nether_Grandmasters_Waistcloth"	"Nether Grandmaster's Waistcloth"
"DOTA_Item_Nether_Grandmasters_Ward"	"Nether Grandmaster's Ward"
"DOTA_Item_Heavenly_General_Shoulders"	"Heavenly General Shoulders"
"DOTA_Item_Noctis_the_Heavenly_Qilin_Guardian"	"Noctis the Heavenly Qilin Guardian"
"DOTA_Item_Phasma_Phasmatis"	"Phasma Phasmatis"
"DOTA_Item_Phasma_Phasmatis_Belt"	"Phasma Phasmatis Belt"
"DOTA_Item_Phasma_Phasmatis_Blade"	"Phasma Phasmatis Blade"
"DOTA_Item_Phasma_Phasmatis_Head"	"Phasma Phasmatis Head"
"DOTA_Item_Phasma_Phasmatis_Shoulders"	"Phasma Phasmatis Shoulders"
"DOTA_Item_Shoulders_of_the_Arsenal_Magus"	"Shoulders of the Arsenal Magus"
"DOTA_Item_Shoulders_of_the_Silent_Champion"	"Shoulders of the Silent Champion"
"DOTA_Item_Starrider_of_the_Crescent_Steel_Shoulders"	"Starrider of the Crescent Steel Shoulders"
"DOTA_Item_Netolic_Amateur_League_Season_1_Ticket"	"Billett: Netolic Amateur League Season 1"
"DOTA_Item_Netolic_Pro_League_5_East_Ticket"	"Billett: Netolic Pro League 5 East"
"DOTA_Item_Netolic_Pro_League_5_West_Ticket"	"Billett: Netolic Pro League 5 West"
"DOTA_Item_Clockwerk_Watcher"	"Clockwerk Watcher"
"DOTA_Item_Clockwerks_Head"	"Clockwerks hode"
"DOTA_Item_Clockwerks_Things"	"Clockwerks ting"
"DOTA_Item_Clockwerks_Weapon"	"Clockwerks våpen"
"DOTA_Item_Forge_of_Iron_Will_Shoulders"	"Forge of Iron Will Shoulders"
"DOTA_Item_Gombangdae_Dosa_Shoulders"	"Gombangdae Dosa Shoulders"
"DOTA_Item_Dosa_Shoulders"	"Dosa Shoulders"
"DOTA_Item_PantheonES_Cup"	"PantheonES Cup"
"DOTA_Item_Axe_of_the_Black_Death_Executioner"	"Axe of the Black Death Executioner"
"DOTA_Corporations_Danil__Dendi__Ishutin"	"Danil «Dendi» Ishutin"
"DOTA_Corporations_Clinton__Fear__Loomis"	"Clinton «Fear» Loomis"
"DOTA_Corporations_Benedict__HyHy__Lim"	"Benedict «HyHy» Lim"
"DOTA_Item_Shoulders_of_Damnation"	"Shoulders of Damnation"
"DOTA_Item_Anunkasan"	"Anunkasan"
"DOTA_Item_Axe_of_the_Chaos_Hound"	"Axe of the Chaos Hound"
"DOTA_Item_Desc_Helm_of_the_Light_Hunter"	"
"
"DOTA_Item_Ragged_Shoulders_of_the_Ravenous_Fiend"	"Ragged Shoulders of the Ravenous Fiend"
"DOTA_Item_Ravenous_Fiend_Loading_Screen"	"Lasteskjerm: Ravenous Fiend"
"DOTA_Item_Shoulders_of_the_Eternal_Seasons"	"Shoulders of the Eternal Seasons"
"DOTA_Item_Shoulders_of_the_Valkyrie"	"Shoulders of the Valkyrie"
"DOTA_WearableType_Eagle"	"Ørn"
"DOTA_Item_Axe_of_the_Warstomp_Clan"	"Axe of the Warstomp Clan"
"DOTA_Item_Netolic_Amateur_League_Season_2"	"Netolic Amateur League Season 2"
"DOTA_Item_Netolic_Amateur_League_Season_2_Ticket"	"Billett: Netolic Amateur League Season 2"
"DOTA_Item_Nvidia_Dota_2_Vietnam_Tournament"	"Nvidia Dota 2 Vietnam Tournament"
"DOTA_Item_Sands_of_Luxor"	"Sands of Luxor"
"DOTA_Item_Sands_of_Luxor_Loading_Screen"	"Lasteskjerm: Sands of Luxor"
"DOTA_Item_Scepter_of_Shades__OffHand"	"Scepter of Shades – Off-Hand"
"DOTA_Item_Shoulders_of_the_Wild_West"	"Shoulders of the Wild West"
"DOTA_Item_Wild_West"	"Wild West"
"DOTA_Item_Shadow_Flame"	"Shadow Flame"
"DOTA_Item_Shadow_Flame_Arms"	"Shadow Flame Arms"
"DOTA_Item_Shadow_Flame_Dress"	"Shadow Flame Dress"
"DOTA_Item_Shadow_Flame_Guards"	"Shadow Flame Guards"
"DOTA_Item_Shadow_Flame_Headdress"	"Shadow Flame Headdress"
"DOTA_Item_Noble_Warrior"	"Noble Warrior"
"DOTA_Item_Noble_Warrior_Armlet"	"Noble Warrior Armlet"
"DOTA_Item_Noble_Warrior_Belt"	"Noble Warrior Belt"
"DOTA_Item_Noble_Warrior_Shoulder"	"Noble Warrior Shoulder"
"DOTA_Item_Noble_Warrior_Spear"	"Noble Warrior Spear"
"DOTA_Item_Clockwerks_Rocket"	"Clockwerks rakett"
"DOTA_Item_Blade_of_Tustakuri__OffHand"	"Blade of Tustakuri – Off-Hand"
"DOTA_Item_Desc_Timbersaws_Shoulders"	"Timbersaws standardskuldre"
"DOTA_Item_Kunkka_Parrot"	"Kunkka Parrot"
"DOTA_Item_Shadow_Fiends_Arms"	"Shadow Fiends armer"
"DOTA_Item_Shadow_Fiends_Head"	"Shadow Fiends hode"
"DOTA_Item_Shadow_Fiends_Shoulders"	"Shadow Fiends skuldre"
"DOTA_Item_Shoulders_of_Tustakuri"	"Shoulders of Tustakuri"
"DOTA_Item_Timbersaws_Armor"	"Timbersaws rustning"
"DOTA_Item_Timbersaws_Hat"	"Timbersaws hatt"
"DOTA_Item_Timbersaws_Left_Arm"	"Timbersaws venstrearm"
"DOTA_Item_Timbersaws_Right_Arm"	"Timbersaws høyrearm"
"DOTA_Item_Timbersaws_Shoulders"	"Timbersaws skuldre"
"DOTA_Item_Timbersaws_Torso"	"Timbersaws torso"
"DOTA_Item_Timbersaws_Waist_Saw"	"Timbersaws beltesag"
"DOTA_Item_Venomancers_Shoulders"	"Venomancers skuldre"
"DOTA_Item_Desc_Pin_Natures_Prophet"	"En samlepins du kan vise frem på Steam-profilen."
"DOTA_Item_Classic_Pin_Natures_Prophet"	"Klassisk pins: Nature's Prophet"
"DOTA_WearableType_Collectors_Pin"	"Samlepins"
"DOTA_Item_Axe_of_the_Harbinger"	"Axe of the Harbinger"
"DOTA_Item_Clock_Master"	"Clock Master"
"DOTA_Item_Clock_Master_Loading_Screen"	"Lasteskjerm: Clock Master"
"DOTA_Item_Clock_Masters_Bunker_Rocket"	"Clock Master's Bunker Rocket"
"DOTA_Item_Clock_Masters_Helmet"	"Clock Master's Helmet"
"DOTA_Item_Clock_Masters_Hook"	"Clock Master's Hook"
"DOTA_Item_Clock_Masters_Power_Cogs"	"Clock Master's Power Cogs"
"DOTA_Item_Clock_Masters_Survival_Gear"	"Clock Master's Survival Gear"
"DOTA_Item_Desc_Copy_of_Pin_Bristleback"	"En samlepins du kan vise frem på Steam-profilen."
"DOTA_Item_Desc_Copy_of_Pin_Clockwerk"	"En samlepins du kan vise frem på Steam-profilen."
"DOTA_Item_Desc_Copy_of_Pin_Courier_Donkey"	"En samlepins du kan vise frem på Steam-profilen."
"DOTA_Item_Desc_Copy_of_Pin_Crystal_Maiden"	"En samlepins du kan vise frem på Steam-profilen."
"DOTA_Item_Desc_Copy_of_Pin_Faceless_Void"	"En samlepins du kan vise frem på Steam-profilen."
"DOTA_Item_Desc_Copy_of_Pin_Lina"	"En samlepins du kan vise frem på Steam-profilen."
"DOTA_Item_Desc_Copy_of_Pin_Naga_Siren"	"En samlepins du kan vise frem på Steam-profilen."
"DOTA_Item_Desc_Copy_of_Pin_Natures_Prophet"	"En samlepins du kan vise frem på Steam-profilen."
"DOTA_Item_Desc_Copy_of_Pin_Puck"	"En samlepins du kan vise frem på Steam-profilen."
"DOTA_Item_Desc_Copy_of_Pin_Pudge"	"En samlepins du kan vise frem på Steam-profilen."
"DOTA_Item_Desc_Copy_of_Pin_Pugna"	"En samlepins du kan vise frem på Steam-profilen."
"DOTA_Item_Desc_Copy_of_Pin_Roshan"	"En samlepins du kan vise frem på Steam-profilen."
"DOTA_Item_Desc_Copy_of_Pin_Sand_King"	"En samlepins du kan vise frem på Steam-profilen."
"DOTA_Item_Desc_Copy_of_Pin_Shopkeeper"	"En samlepins du kan vise frem på Steam-profilen."
"DOTA_Item_Desc_Copy_of_Pin_Tusk"	"En samlepins du kan vise frem på Steam-profilen."
"DOTA_Item_Desc_Copy_of_Pin_Visage"	"En samlepins du kan vise frem på Steam-profilen."
"DOTA_Item_Desc_Copy_of_Pin_Wisp"	"En samlepins du kan vise frem på Steam-profilen."
"DOTA_Item_Classic_Pin_Bristleback"	"Klassisk pins: Bristleback"
"DOTA_Item_Classic_Pin_Clockwerk"	"Klassisk pins: Clockwerk"
"DOTA_Item_Classic_Pin_Courier_Donkey"	"Klassisk pins: Courier Donkey"
"DOTA_Item_Classic_Pin_Crystal_Maiden"	"Klassisk pins: Crystal Maiden"
"DOTA_Item_Classic_Pin_Faceless_Void"	"Klassisk pins: Faceless Void"
"DOTA_Item_Classic_Pin_Lina"	"Klassisk pins: Lina"
"DOTA_Item_Classic_Pin_Naga_Siren"	"Klassisk pins: Naga Siren"
"DOTA_Item_Classic_Pin_Puck"	"Klassisk pins: Puck"
"DOTA_Item_Classic_Pin_Pudge"	"Klassisk pins: Pudge"
"DOTA_Item_Classic_Pin_Pugna"	"Klassisk pins: Pugna"
"DOTA_Item_Classic_Pin_Roshan"	"Klassisk pins: Roshan"
"DOTA_Item_Classic_Pin_Sand_King"	"Klassisk pins: Sand King"
"DOTA_Item_Classic_Pin_Shopkeeper"	"Klassisk pins: Shopkeeper"
"DOTA_Item_Pin_The_International_2014_Attendee"	"Pins: The International 2014-deltaker"
"DOTA_Item_Classic_Pin_Tusk"	"Klassisk pins: Tusk"
"DOTA_Item_Classic_Pin_Visage"	"Klassisk pins: Visage"
"DOTA_Item_Pin_Wisp"	"Pins: Wisp"
"DOTA_Item_Worldforgers_Shoulders"	"Worldforger's Shoulders"
"DOTA_WearableType_Anvil"	"Ambolt"
"DOTA_WearableType_Jaw"	"Kjeve"
"DOTA_Teams_Cloud9"	"Cloud9"
"DOTA_Item_NACDEC"	"NACDEC"
"DOTA_Item_Rampage_Dota_2_League_Season_2"	"Rampage Dota 2 League Season 2"
"DOTA_Item_Desc_Copy_of_Wraith_Kings_head"	"Denne nye gjenstanden har ingen beskrivelse."
"DOTA_Item_Neptunian_Servant"	"Neptunian Servant"
"DOTA_Item_Neptunian_Servant_Loading_Screen"	"Lasteskjerm: Neptunian Servant"
"DOTA_Item_Nightwatch_Keys_to_the_City"	"Nightwatch Keys to the City"
"DOTA_Item_Rapture"	"Rapture"
"DOTA_Item_Wraith_Kings_Chest"	"Wraith Kings bryst"
"DOTA_WearableType_Armguards"	"Armbeskyttere"
"DOTA_Item_Shoulders_of_the_Black_Wind_Raven"	"Shoulders of the Black Wind Raven"
"DOTA_Item_Axe_of_the_Savage_God"	"Axe of the Savage God"
"DOTA_Item_Bloodlust_Fork"	"Bloodlust Fork"
"DOTA_Item_Shoulders_of_Quas_Precor"	"Shoulders of Quas Precor"
"DOTA_Item_Svens_Revenge"	"Sven's Revenge"
"DOTA_Teams_Zephyr"	"Zephyr"
"DOTA_Item_Blood_Drainer"	"Blood Drainer"
"DOTA_Item_Bloodrage_Axe"	"Bloodrage Axe"
"DOTA_Item_National_Esports_League"	"National Esports League"
"DOTA_Teams_ViciGaming"	"ViCi Gaming"
"DOTA_Item_Rampant_Outrage"	"Rampant Outrage"
"DOTA_Item_Bounty_Hunter_Series"	"Bounty Hunter Series"
"DOTA_Item_Bounty_Hunter_Series_Ticket"	"Billett: Bounty Hunter Series"
"DOTA_Item_Raiq"	"Raiq"
"DOTA_Teams_Titan"	"Titan"
"DOTA_Teams_Team_Empire"	"Team Empire"
"DOTA_Teams_NewBee"	"NewBee"
"DOTA_Item_Dragonterror"	"Dragonterror"
"DOTA_Item_Dragonterror_Armor"	"Dragonterror Armor"
"DOTA_Item_Dragonterror_Belt"	"Dragonterror Belt"
"DOTA_Item_Dragonterror_Cape"	"Dragonterror Cape"
"DOTA_Item_Dragonterror_Helmet"	"Dragonterror Helmet"
"DOTA_Item_Dragonterror_Loading_Screen"	"Lasteskjerm: Dragonterror"
"DOTA_Item_Dragonterror_Sword"	"Dragonterror Sword"
"DOTA_Item_Spirit_of_the_Iron_Claw"	"Spirit of the Iron Claw"
"DOTA_Item_Nvidia_Dota_2_Vietnam_Tournament_Season_2"	"Nvidia Dota 2 Vietnam Tournament Season 2"
"DOTA_Item_Pudge_Cup"	"Pudge Cup"
"DOTA_Item_Razer_Gate_Dota_2_Champions_League_#1"	"Razer Gate Dota 2 Champions League #1"
"DOTA_Corporations_DD"	"DD"
"DOTA_Corporations_Ars_Art"	"Ars-Art"
"DOTA_Corporations_SOLO"	"SOLO"
"DOTA_Corporations_YYF"	"YYF"
"DOTA_Corporations_ZSMJ"	"ZSMJ"
"DOTA_Corporations_NS"	"NS"
"DOTA_Corporations_Funn1k"	"Funn1k"
"DOTA_Item_Dragon_Wall_Totem"	"Dragon Wall Totem"
"DOTA_Item_Dragonblade"	"Dragonblade"
"DOTA_Item_Dragonblade_OffHand"	"Dragonblade Off-Hand"
"DOTA_Item_Dragonfire"	"Dragonfire"
"DOTA_Item_Dragonfire_Loading_Screen"	"Lasteskjerm: Dragonfire"
"DOTA_Item_Dragons_Ascension"	"Dragon's Ascension"
"DOTA_Item_Dragons_Ascension_Loading_Screen"	"Lasteskjerm: Dragon's Ascension"
"DOTA_Item_Medallion_of_the_Divine_Anchor"	"Medallion of the Divine Anchor"
"DOTA_Item_Shoulders_of_Cadenza_Magic_Master"	"Shoulders of Cadenza Magic Master"
"DOTA_Item_Shoulders_of_the_Dark_Angel"	"Shoulders of the Dark Angel"
"DOTA_Item_Shoulders_of_the_Static_Lord"	"Shoulders of the Static Lord"
"DOTA_Item_Shoulders_of_the_Witch_Hunter"	"Shoulders of the Witch Hunter"
"DOTA_Item_Timberthaw"	"Timberthaw"
"DOTA_Item_Timberthaw_Armor"	"Timberthaw Armor"
"DOTA_Item_Timberthaw_Back"	"Timberthaw Back"
"DOTA_Item_Timberthaw_Claw"	"Timberthaw Claw"
"DOTA_Item_Timberthaw_Hat"	"Timberthaw Hat"
"DOTA_Item_Timberthaw_Loading_Screen"	"Lasteskjerm: Timberthaw"
"DOTA_Item_Timberthaw_Ripsaw"	"Timberthaw Ripsaw"
"DOTA_Item_Timberthaw_Shoulders"	"Timberthaw Shoulders"
"DOTA_Item_Rainmaker"	"Rainmaker"
"DOTA_Item_Epitaphic_Bonds_Shoulders"	"Epitaphic Bonds Shoulders"
"DOTA_Item_Shoulders_of_the_Bladesrunner"	"Shoulders of the Bladesrunner"
"DOTA_Item_Spirit_of_Anger"	"Spirit of Anger"
"DOTA_WearableType_Bomb"	"Bombe"
"DOTA_Corporations_Arteezy"	"Arteezy"
"DOTA_Corporations_Mushi"	"Mushi"
"DOTA_Corporations_BuLba"	"BuLba"
"DOTA_Item_Nightsilver_Gryphon"	"Nightsilver Gryphon"
"DOTA_Item_Shadow_Flame_Loading_Screen"	"Lasteskjerm: Shadow Flame"
"DOTA_Item_Doomling"	"Doomling"
"DOTA_Item_Golden_Doomling"	"Golden Doomling"
"DOTA_Item_Classic_Pin_Io"	"Klassisk pins: Io"
"DOTA_Item_NADota_Elite_League_August"	"NADota Elite League August"
"DOTA_Item_Spirits_of_the_Mourning_Mother"	"Spirits of the Mourning Mother"
"DOTA_WearableType_Head_"	"Hode"
"DOTA_Item_Red_Dragon_Shoulders"	"Red Dragon Shoulders"
"DOTA_Item_Spider_Shoulders_of_Purple_Nightmare"	"Spider Shoulders of Purple Nightmare"
"DOTA_WearableType_Bundle_"	"Pakke"
"DOTA_Item_NADota_Elite_League_September"	"NADota Elite League September"
"DOTA_WearableType_Tree"	"Tre"
"DOTA_Item_Axes_Access"	"Axe's Access"
"DOTA_Item_Dark_Gabriel_Shoulders"	"Dark Gabriel Shoulders"
"DOTA_Item_Nilbog_the_Mad"	"Nilbog the Mad"
"DOTA_Item_Shadow_Fiend_Arcana_Arms"	"Shadow Fiend Arcana Arms"
"DOTA_Item_The_International_2014_Music_Pack"	"Musikkpakke: The International 2014"
"DOTA_WearableType_Music"	"Musikk"
"DOTA_WearableType_Music_Pack"	"Musikkpakke"
"DOTA_Item_Rage_of_the_Three"	"Rage of the Three"
"DOTA_Item_Rage_of_the_Three_Loading_Screen"	"Lasteskjerm: Rage of the Three"
"DOTA_Item_Nvidia_Game24_Invitational"	"Nvidia Game24 Invitational"
"DOTA_Item_FireFly_Shoulders"	"FireFly Shoulders"
"DOTA_Item_Rainmaker_Loading_Screen"	"Lasteskjerm: Rainmaker"
"DOTA_Item_Shadow_of_the_Volatile_Firmament"	"Shadow of the Volatile Firmament"
"DOTA_Item_Shoulders_of_the_Volatile_Firmament"	"Shoulders of the Volatile Firmament"
"DOTA_Item_Arctic_Watchtower"	"Arctic Watchtower"
"DOTA_Item_Neokin_Faierie_Ward"	"Neokin Faierie Ward"
"DOTA_Item_Shoulders_of_the_Fullmetal_Machinist"	"Shoulders of the Fullmetal Machinist"
"DOTA_Item_Ravenous_Woodfang"	"Ravenous Woodfang"
"DOTA_Item_Necklace_of_the_Warhawk_Vestiments"	"Necklace of the Warhawk Vestiments"
"DOTA_Item_Shoulders_of_the_Maniacal_Machinist"	"Shoulders of the Maniacal Machinist"
"DOTA_Corporations_Aren__VeRsuta__Zurabyan"	"Aren «VeRsuta» Zurabyan"
"DOTA_Item_Pantaloons_of_the_Bladekeeper"	"Pantaloons of the Bladekeeper"
"DOTA_Item_War_Machine"	"War Machine"
"DOTA_Item_War_Machine_Blaster_Shell"	"War Machine Blaster Shell"
"DOTA_Item_War_Machine_Body_Armor"	"War Machine Body Armor"
"DOTA_Item_War_Machine_Electro_Cog"	"War Machine Electro Cog"
"DOTA_Item_War_Machine_Loading_Screen_1"	"Lasteskjem: War Machine 1"
"DOTA_Item_War_Machine_Loading_Screen_2"	"Lasteskjem: War Machine 2"
"DOTA_Item_War_Machine_Metal_Mask"	"War Machine Metal Mask"
"DOTA_Item_War_Machine_Trench_Digger"	"War Machine Trench Digger"
"DOTA_Item_Wargod_of_the_Bladekeeper"	"Wargod of the Bladekeeper"
"DOTA_Set_Acidic_Flytrap"	"Acidic Flytrap"
"DOTA_Set_Agaric_Flourish"	"Agaric Flourish"
"DOTA_Set_Balance_of_the_Bladekeeper"	"Balance of the Bladekeeper"
"DOTA_Set_Battletrap"	"Battletrap"
"DOTA_Set_Champion_of_Discord"	"Champion of Discord"
"DOTA_Set_Eldwurms_Touch"	"Eldwurm's Touch"
"DOTA_Set_Frozen_Emperor"	"Frozen Emperor"
"DOTA_Set_Ghastly_Matriarch"	"Ghastly Matriarch"
"DOTA_Set_Keen_Machine"	"Keen Machine"
"DOTA_Set_Legacy_of_Infernal_Wings"	"Legacy of Infernal Wings"
"DOTA_Set_Monstrous_Reprisal"	"Monstrous Reprisal"
"DOTA_Set_Scavenger_of_the_Basilisk"	"Scavenger of the Basilisk"
"DOTA_Set_The_Fiend_Cleaver"	"The Fiend Cleaver"
"DOTA_Set_The_Ol_Steam_Chopper"	"The Ol' Steam Chopper"
"DOTA_Set_War_Machine"	"War Machine"
"DOTA_WearableType_Beads"	"Perler"
"DOTA_WearableType_Cog"	"Tannhjul"
"DOTA_WearableType_Gun"	"Skytevåpen"
"DOTA_WearableType_Jawbone"	"Kjeveben"
"DOTA_WearableType_Mandible"	"Underkjeve"
"DOTA_WearableType_Set"	"Sett"
"DOTA_WearableType_Shovel"	"Spade"
"DOTA_WearableType_Tentacles"	"Tentakler"
"DOTA_Item_Desc_Balance_of_the_Bladekeeper"	"Kjøp av dette settet bidrar til premiepotten for XMG Captain's Draft 2.0."
"DOTA_WearableType_Bo"	"Bo"
"DOTA_Item_Antipode_Couriers"	"Antipode Couriers"
"DOTA_Item_Nexon_Hyeonmu_Turtle"	"Nexon Hyeonmu Turtle"
"DOTA_Item_The_Sabre_of_the_Sea_Empress"	"Hav-keiserinnens sabel"
"DOTA_Item_Sri_Lanka_Cyber_Games_SLCG_2014"	"Sri Lanka Cyber Games (SLCG) 2014"
"DOTA_Item_UnderCastleLeague_Season_1"	"UnderCastleLeague Season 1"
"DOTA_Item_Bloodfeather_Wings"	"Bloodfeather Wings"
"DOTA_Item_Brood_Hunter"	"Brood Hunter"
"DOTA_Item_Brood_Hunter_Bundle"	"Pakke: Brood Hunter"
"DOTA_Item_Brood_Hunter_Loading_Screen"	"Lasteskjerm: Brood Hunter"
"DOTA_Item_Nightsbane"	"Nightsbane"
"DOTA_Item_Noble_and_Imperial_Pride"	"Noble and Imperial Pride"
"DOTA_Item_Phantasm"	"Lasteskjerm: Phantasm"
"DOTA_Item_Vespertine_Guard_Shoulders"	"Vespertine Guard Shoulders"
"DOTA_Item_Dragon_Axe"	"Dragon Axe"
"DOTA_Item_NADotA_Elite_League_January"	"NADotA Elite League January"
"DOTA_Item_NCups_Season_1"	"NCups Season 1"
"DOTA_Item_RAGEQUIT_CUP"	"RAGEQUIT CUP"
"DOTA_Item_Drowned_Horseman"	"Drowned Horseman"
"DOTA_Item_Drowned_Horsemans_Axe_and_Buckler"	"Drowned Horseman's Axe and Buckler"
"DOTA_Item_Drowned_Horsemans_Cape"	"Drowned Horseman's Cape"
"DOTA_Item_Drowned_Horsemans_Helm"	"Drowned Horseman's Helm"
"DOTA_Item_Drowned_Horsemans_Mount"	"Drowned Horseman's Mount"
"DOTA_Item_Drowned_Horsemans_Pauldrons"	"Drowned Horseman's Pauldrons"
"DOTA_Item_NRS_Gaming_Online_Tournament"	"NRS Gaming Online Tournament"
"DOTA_Item_NADotA_Elite_League_February"	"NADotA Elite League February"
"DOTA_Item_NN_Dota_2_League_Season_2"	"NN Dota 2 League Season 2"
"DOTA_Item_Rapier_of_the_Burning_God"	"Rapier of the Burning God"
"DOTA_Item_Rapier_of_the_Burning_God_Offhand"	"Rapier of the Burning God Offhand"
"DOTA_Item_Rapiers_of_the_Burning_God"	"Rapiers of the Burning God"
"DOTA_Item_Arms_of_the_Onyx_Crucible_Shoulders"	"Arms of the Onyx Crucible Shoulders"
"DOTA_Item_Bloody_Ripper"	"Bloody Ripper"
"DOTA_Item_Bloody_Ripper_Loading_Screen"	"Lasteskjerm: Bloody Ripper"
"DOTA_Item_Compendium_Arms_of_the_Onyx_Crucible_Shoulders"	"Compendium Arms of the Onyx Crucible Shoulders"
"DOTA_Item_Compendium_Rider_of_Avarice_Shoulders"	"Compendium Rider of Avarice Shoulders"
"DOTA_Item_Compendium_Umbra_Rider_Shoulders"	"Compendium Umbra Rider Shoulders"
"DOTA_Item_Desc_Harmonies_of_New_Bloom_Music_Pack"	"Komponert av samfunnsartisten Pumodi."
"DOTA_Item_Harmonies_of_New_Bloom_Music_Pack"	"Musikkpakke: Harmonies of New Bloom"
"DOTA_Item_No_Mercy_IV"	"No Mercy IV"
"DOTA_Item_Rider_of_Avarice_Shoulders"	"Rider of Avarice Shoulders"
"DOTA_Item_Umbra_Rider_Shoulders"	"Umbra Rider Shoulders"
"DOTA_Item_NCups_Season_2"	"NCups Season 2"
"DOTA_Item_Rams_Head_Blade"	"Ram's Head Blade"
"DOTA_Item_Raiments_of_the_Sacrosanct"	"Raiments of the Sacrosanct"
"DOTA_Item_Shoulders_of_the_Sacrosanct"	"Shoulders of the Sacrosanct"
"DOTA_WearableType_Armplates"	"Armplater"
"DOTA_Item_Antipodean_Allies"	"Antipodean Allies"
"DOTA_Item_NEL_March_2015"	"NEL March 2015"
"DOTA_Item_Razer_Think_Fast_Season_2"	"Razer Think Fast Season 2"
"DOTA_Item_Razer_Think_Fast_Season_2_Ticket"	"Billett: Razer Think Fast Season 2"
"DOTA_Item_North_American_Solo_Mid_1v1"	"North American Solo Mid 1v1"
"DOTA_Item_NN_Dota_2_League_Season_3"	"NN Dota 2 League Season 3"
"DOTA_Item_NEL_April_2015"	"NEL April 2015"
"DOTA_Item_NeoGAF_Dota_2_Inhouse_League_"	"NeoGAF Dota 2 Inhouse League "
"DOTA_Item_North_American_Solo_Mid_1v1_Season_2"	"North American Solo Mid 1v1 Season 2"
"DOTA_Item_Ragnarok_Dota2_Championship"	"Ragnarok Dota2 Championship"
"DOTA_Item_Ravening_Wings"	"Ravening Wings"
"DOTA_Item_Ravening_Wings_Loading_Screen"	"Lasteskjerm: Ravening Wings"
"DOTA_Item_Shoulders_of_the_Fallen_Cloak"	"Shoulders of the Fallen Cloak"
"DOTA_Item_Shoulders_of_the_Forbidden_Sands"	"Shoulders of the Forbidden Sands"
"DOTA_Item_Desc_Perfect4ths_Music_Pack"	"Komponert av samfunnsartisten Daniel Sadowski"
"DOTA_Item_Heroes_Within_Music_Pack"	"Musikkpakke: Heroes Within"
"DOTA_Item_Pants_of_the_Devilish_Conjurer"	"Pants of the Devilish Conjurer"
"DOTA_Item_Desc_Heroes_Within_Music_Pack"	"Komponert av samfunnsartisten Daniel Sadowski"
"DOTA_Item_AD2L_Season_7"	"AD2L sesong 7"
"DOTA_Item_Luki_ESport"	"Luki E-Sport"
"DOTA_Item_Desc_Stavropol_Dota_League_"	"­"
"DOTA_Item_FACEIT_Pro_League"	"FACEIT Pro League"
"DOTA_Item_Axes_of_the_Wild_Tamer"	"Axes of the Wild Tamer"
"DOTA_Item_Juggernauts_Default_Ward"	"Juggernauts standardward"
"DOTA_Item_NEL_May_2015"	"NEL May 2015"
"DOTA_Item_NFCups_Season_1"	"NFCups Season 1"
"DOTA_Item_NURE_Challenge_for_Students"	"NURE Challenge for Students"
"DOTA_Item_Pin_The_International_2015_Attendee"	"Pins: The International 2015-deltaker"
"DOTA_Item_Rare_pin_1"	"Sjelden pins 1"
"DOTA_Item_Rare_pin_2"	"Sjelden pins 2"
"DOTA_Item_Rare_pin_3"	"Sjelden pins 3"
"DOTA_Item_Rare_pin_4"	"Sjelden pins 4"
"DOTA_Item_ancientone_guise"	"ancientone_guise"
"DOTA_Item_ancientone_horns"	"ancientone_horns"
"DOTA_Item_ancientone_totem"	"ancientone_totem"
"DOTA_Item_diving_armor_armor"	"diving_armor_armor"
"DOTA_Item_diving_armor_head"	"diving_armor_head"
"DOTA_Item_raptorous_wings"	"raptorous_wings"
"DOTA_WearableType_Collectors_Pin_set"	"Samlepins-sett"
"DOTA_Item_EVO_DOTA2_TOURNAMENT"	"EVO DOTA2 TOURNAMENT"
"DOTA_Item_Lampions_League_III"	"Lampions League III"
"DOTA_Item_Rapture_Dota2_Indonesia_League"	"Rapture Dota2 Indonesia League"
"DOTA_Item_Rookie_Cup_Season_1"	"Rookie Cup sesong 1"
"DOTA_Item_Red_Bull_LAN__San_Francisco"	"Red Bull LAN - San Francisco"
"DOTA_Item_Emberbark"	"Emberbark"
"DOTA_Item_Emberbark_Arms"	"Emberbark Arms"
"DOTA_Item_Emberbark_Beard"	"Emberbark Beard"
"DOTA_Item_Emberbark_Loading_Screen"	"Lasteskjerm: Emberbark"
"DOTA_Item_Emberbark_Roots"	"Emberbark Roots"
"DOTA_Item_Emberbark_Shoulders"	"Emberbark Shoulders"
"DOTA_Item_Shoulders_of_the_Shooting_Star"	"Shoulders of the Shooting Star"
"DOTA_Teams_Virtus_Pro"	"Virtus.Pro"
"DOTA_Item_Razer_Think_Fast_2_Finals"	"Razer Think Fast 2 Finals"
"DOTA_Item_FACEIT_Pro_League_Europe"	"FACEIT Pro League Europe"
"DOTA_Item_FACEIT_Pro_League_North_America_"	"FACEIT Pro League North America "
"DOTA_Item_Rappler_Gaming_League_Season_1"	"Rappler Gaming League Season 1"
"DOTA_Item_Bristlebacks_Back"	"Bristlebacks rygg"
"DOTA_Item_Bristlebacks_Bracers"	"Bristlebacks armbeskyttere"
"DOTA_Item_Bristlebacks_Head"	"Bristlebacks hode"
"DOTA_Item_Bristlebacks_Necklace"	"Bristlebacks halskjede"
"DOTA_Item_Bristlebacks_Weapon"	"Bristlebacks våpen"
"DOTA_Item_Desc_Echoes_of_the_Eyrie_Loading_Screen"	" 


"
"DOTA_Item_Faceless_Rex"	"Faceless Rex"
"DOTA_Item_Shadow_of_the_Burning_Scale"	"Shadow of the Burning Scale"
"DOTA_Item_Lumberclaw_Shoulders"	"Lumberclaw Shoulders"
"DOTA_Item_Spirits_of_the_Unkind_Countess"	"Spirits of the Unkind Countess"
"DOTA_Item_Next_Gaming_Championship_Season_2"	"Next Gaming Championship Season 2"
"DOTA_Item_North_Star"	"North Star"
"DOTA_Item_Desc_Pauldrons_of_Tustakuri"	" 


"
"DOTA_Item_Desc_Samurai_Soul_Loading_Screen"	" 


"
"DOTA_Item_Desc_Shoulders_of_Tustakuri"	" 

"
"DOTA_Item_Desc_Totem_of_the_Samurai_Soul"	" 



"
"DOTA_Item_Desc_Vanguard_Fireblade"	" 



"
"DOTA_Item_Neway_Tournament"	"Neway Tournament"
"DOTA_Item_RageQuit_Cup_Season3"	"RageQuit Cup Season3"
"DOTA_Item_The_International_2015_Music_Pack"	"Musikkpakke: The International 2015"
"DOTA_Item_Tidehunters_diving_helmet"	"Tidehunter's diving helmet"
"DOTA_Item_Eztzhok_Blade__OffHand"	"Eztzhok Blade – Off-Hand"
"DOTA_Item_Immortal_Shoulders"	"Immortal Shoulders"
"DOTA_Item_deadmau5_temp_title_music_pack"	"Musikkpakke: deadmau5 (midlertidig tittel)"
"DOTA_Item_Desc_Magnus"	"En samlepins du kan vise frem på Steam-profilen."
"DOTA_Item_Desc_Pin_Axe"	"En samlepins du kan vise frem på Steam-profilen."
"DOTA_Item_Desc_Pin_Batrider"	"En samlepins du kan vise frem på Steam-profilen."
"DOTA_Item_Desc_Pin_Cosplay_2015"	"En eksklusiv samlepins for Dota 2-cosplayere, som kan vises frem på Steam-profilen."
"DOTA_Item_Desc_Pin_Death_Prophet"	"En samlepins du kan vise frem på Steam-profilen."
"DOTA_Item_Desc_Pin_Earth_Spirit"	"En samlepins du kan vise frem på Steam-profilen."
"DOTA_Item_Desc_Pin_Ember_Spirit"	"En samlepins du kan vise frem på Steam-profilen."
"DOTA_Item_Desc_Pin_Juggernaut"	"En samlepins du kan vise frem på Steam-profilen."
"DOTA_Item_Desc_Pin_Kunkka"	"En samlepins du kan vise frem på Steam-profilen."
"DOTA_Item_Desc_Pin_Ogre_Magi"	"En samlepins du kan vise frem på Steam-profilen."
"DOTA_Item_Desc_Pin_Queen_of_Pain"	"En samlepins du kan vise frem på Steam-profilen."
"DOTA_Item_Desc_Pin_Sniper"	"En samlepins du kan vise frem på Steam-profilen."
"DOTA_Item_Desc_Pin_Storm_Spirit"	"En samlepins du kan vise frem på Steam-profilen."
"DOTA_Item_Desc_Pin_Sven"	"En samlepins du kan vise frem på Steam-profilen."
"DOTA_Item_Desc_Pin_The_International_2015_Attendee"	"En samlepins du kan vise frem på Steam-profilen."
"DOTA_Item_Desc_Pin_Tidehunter"	"En samlepins du kan vise frem på Steam-profilen."
"DOTA_Item_Desc_Pin_Ursa"	"En samlepins du kan vise frem på Steam-profilen."
"DOTA_Item_Desc_Rare_pin_1"	"En samlepins du kan vise frem på Steam-profilen."
"DOTA_Item_Pin_Abaddon"	"Pins: Abaddon"
"DOTA_Item_Pin_Axe"	"Pins: Axe"
"DOTA_Item_Pin_Batrider"	"Pins: Batrider"
"DOTA_Item_Pin_Cosplay_2015"	"Pins: Cosplay 2015"
"DOTA_Item_Pin_Death_Prophet"	"Pins: Death Prophet"
"DOTA_Item_Pin_Earth_Spirit"	"Pins: Earth Spirit"
"DOTA_Item_Pin_Ember_Spirit"	"Pins: Ember Spirit"
"DOTA_Item_Pin_Juggernaut"	"Pins: Juggernaut"
"DOTA_Item_Pin_Kunkka"	"Pins: Kunkka"
"DOTA_Item_Pin_Magnus"	"Pins: Magnus"
"DOTA_Item_Pin_Ogre_Magi"	"Pins: Ogre Magi"
"DOTA_Item_Pin_Pack_1"	"Pinspakke 1"
"DOTA_Item_Pin_Pack_2"	"Pinspakke 2"
"DOTA_Item_Pin_Pack_3"	"Pinspakke 3"
"DOTA_Item_Pin_Queen_of_Pain"	"Pins: Queen of Pain"
"DOTA_Item_Pin_Sniper"	"Pins: Sniper"
"DOTA_Item_Pin_Storm_Spirit"	"Pins: Storm Spirit"
"DOTA_Item_Pin_Sven"	"Pins: Sven"
"DOTA_Item_Pin_Tidehunter"	"Pins: Tidehunter"
"DOTA_Item_Pin_Ursa"	"Pins: Ursa"
"DOTA_Item_Tidehunters_diving_gold_helmet"	"Tidehunter's diving gold helmet"
"DOTA_Item_deadmau5_dieback_music_pack"	"Musikkpakke: deadmau5 dieback"
"DOTA_Item_Razzils_Midas_Knuckles"	"Razzil's Midas Knuckles"
"DOTA_Item_Thirst_of_Eztzhok__OffHand"	"Thirst of Eztzhok – Off-Hand"
"DOTA_Item_Nanyang_Championships"	"Nanyang Championships"
"DOTA_Item_Phoenix_Cup"	"Phoenix Cup"
"DOTA_Item_Antimages_Shoulders"	"Anti-Mages skuldre"
"DOTA_Item_Beastmasters_Boar"	"Beastmasters villsvin"
"DOTA_Item_Beastmasters_Hawk"	"Beastmasters hauk"
"DOTA_Item_Bounty_Hunters_Arms"	"Bounty Hunters armer"
"DOTA_Item_Broodmothers_Default_Head"	"Broodmothers hode"
"DOTA_Item_Broodmothers_Default_Miscellaneous"	"Broodmothers diverse"
"DOTA_Item_Broodmothers_Default_Spiderlings"	"Broodmothers spiderlings"
"DOTA_Item_Clockwerks_Default_Cogs"	"Clockwerks tannhjul"
"DOTA_Item_Elder_Drake_of_Blazing_Oblivion"	"Elder Drake of Blazing Oblivion"
"DOTA_Item_Kunkkas_Default_Back"	"Kunkkas standardrygg"
"DOTA_Item_Kunkkas_Default_Neck"	"Kunkkas standardhals"
"DOTA_Item_Legionnaire_Ray_Sword"	"Legionnaire Ray Sword"
"DOTA_Item_Lifestealers_Default_Back"	"Lifestealers rygg"
"DOTA_Item_Lifestealers_Default_Head"	"Lifestealers hode"
"DOTA_Item_Lycans_Default_Head_Accessory"	"Lycans hodetilbehør"
"DOTA_Item_Lycans_Default_Wolves"	"Lycans ulver"
"DOTA_Item_Morphlings_Default_Arms"	"Morphlings armer"
"DOTA_Item_Morphlings_Default_Back"	"Morphlings rygg"
"DOTA_Item_Morphlings_Default_Head"	"Morphlings hode"
"DOTA_Item_Morphlings_Default_Miscellaneous"	"Morphlings diverse"
"DOTA_Item_Morphlings_Default_Shoulders"	"Morphlings skuldre"
"DOTA_Item_Nightstalkers_Default_Arms"	"Night Stalkers armer"
"DOTA_Item_Nightstalkers_Default_Head"	"Night Stalkers hode"
"DOTA_Item_Nyxs_Default_Miscellaneous"	"Nyx' diverse"
"DOTA_Item_Omniknights_Default_Miscellaneous"	"Omniknights diverse"
"DOTA_Item_Spectres_Default_Miscellaneous"	"Spectres diverse"
"DOTA_Item_Spectres_Default_Voice"	"Spectres standardstemme"
"DOTA_Item_Svens_Default_Back"	"Svens rygg"
"DOTA_Item_Tidehunters_Default_Back"	"Tidehunters rygg"
"DOTA_Item_Tidehunters_Default_Head"	"Tidehunters hode"
"DOTA_Item_Undyings_Default_Tombstone"	"Undyings gravstein"
"DOTA_Wearable_All_Heroes_DefaultPet"	"Intet kjæledyr"
"DOTA_Wearable_All_Heroes_DefaultTaunt"	"Ingen hån"
"DOTA_Item_NQ_Dota_2_League_Season_#_2"	"NQ Dota 2 League Season # 2"
"DOTA_Item_Arc_Wardens_Back"	"Arc Wardens rygg"
"DOTA_Item_Arc_Wardens_Bracers"	"Arc Wardens armbeskyttere"
"DOTA_Item_Arc_Wardens_Shoulders"	"Arc Wardens skuldre"
"DOTA_Item_NGA_Master_League"	"NGA Master League"
"DOTA_Item_Ratio_Amateur_Cup"	"Ra:tio Amateur Cup"
"DOTA_Item_Nxtgame_Eternal_Dota_League_Season_4"	"Nxtgame Eternal Dota League Season 4"
"DOTA_Item_Next_Gaming_Championship_III"	"Next Gaming Championship III"
"DOTA_Item_Description_Tag"	"Merkelapp"
"DOTA_Item_Templar_Assassins_Default_Shoulders"	"Templar Assassins standardskuldre"
"DOTA_Item_Sri_Lanka_Cyber_Games_SLCG_2015"	"Sri Lanka Cyber Games (SLCG) 2015"
"DOTA_Item_Alchemists_Gauntlets"	"Alchemists stridshansker"
"DOTA_Item_Axes_Hair"	"Axes hår"
"DOTA_Item_Axes_Miscellaneous"	"Axes diverse"
"DOTA_Item_Axes_Shoulder_Guard"	"Axes skulderbeskytter"
"DOTA_Item_Blood_Seekers_Offhand_Blade"	"Bloodseekers sekundærkniv"
"DOTA_Item_Bounty_Hunters_Armor"	"Bounty Hunters rustning"
"DOTA_Item_Broodmothers_Head"	"Broodmothers hode"
"DOTA_Item_Broodmothers_Miscellaneous"	"Broodmothers diverse"
"DOTA_Item_Broodmothers_Spiderlings"	"Broodmothers spiderlings"
"DOTA_Item_Centaur_Warrunners_Axe"	"Centaur Warrunners øks"
"DOTA_Item_Centaur_Warrunners_Belt"	"Centaur Warrunners belte"
"DOTA_Item_Centaur_Warrunners_Bracers"	"Centaur Warrunners armbeskyttere"
"DOTA_Item_Centaur_Warrunners_Head"	"Centaur Warrunners hode"
"DOTA_Item_Centaur_Warrunners_Shoulders"	"Centaur Warrunners skuldre"
"DOTA_Item_Centaur_Warrunners_Tail"	"Centaur Warrunners hale"
"DOTA_Item_Centaur_Warrunners_Trophies"	"Centaur Warrunners trofeer"
"DOTA_Item_Chaos_Knights_Helmet"	"Chaos Knights hjelm"
"DOTA_Item_Chaos_Knights_Shield"	"Chaos Knights skjold"
"DOTA_Item_Chaos_Knights_Shoulder_Guards"	"Chaos Knights skulderbeskyttere"
"DOTA_Item_Chaos_Knights_Weapon"	"Chaos Knights våpen"
"DOTA_Item_Clockwerks_Armor"	"Clockwerks rustning"
"DOTA_Item_Clockwerks_Power_Cogs"	"Clockwerks strømtannhjul"
"DOTA_Item_Desc_Axes_Miscellaneous"	"tom standardplass"
"DOTA_Item_Dooms_Helmet"	"Dooms hjelm"
"DOTA_Item_Earth_Spirits_Neck"	"Earth Spirits hals"
"DOTA_Item_Elder_Titans_Back_Totem"	"Elder Titans ryggtotem"
"DOTA_Item_Elder_Titans_Bracers"	"Elder Titans armbeskyttere"
"DOTA_Item_Elder_Titans_Head"	"Elder Titans hode"
"DOTA_Item_Elder_Titans_Shoulders"	"Elder Titans skuldre"
"DOTA_Item_Elder_Titans_Weapon"	"Elder Titans våpen"
"DOTA_Item_Ember_Spirits_Arms"	"Ember Spirits armer"
"DOTA_Item_FACEIT_League"	"FACEIT League"
"DOTA_Item_Faceless_Voids_Belt"	"Faceless Voids belte"
"DOTA_Item_Faceless_Voids_Bracer"	"Faceless Voids armbeskytter"
"DOTA_Item_Faceless_Voids_Head"	"Faceless Voids hode"
"DOTA_Item_Faceless_Voids_Shoulder"	"Faceless Voids skuldre"
"DOTA_Item_Faceless_Voids_Weapon"	"Faceless Voids våpen"
"DOTA_Item_Juggernauts_Legs"	"Juggernauts bein"
"DOTA_Item_Juggernauts_Mask"	"Juggernauts maske"
"DOTA_Item_Kunkkas_Back"	"Kunkkas rygg"
"DOTA_Item_Kunkkas_Neck"	"Kunkkas hals"
"DOTA_Item_Legion_Commanders_Banners"	"Legion Commanders faner"
"DOTA_Item_Legion_Commanders_Bracers"	"Legion Commanders armbeskyttere"
"DOTA_Item_Legion_Commanders_Helmet"	"Legion Commanders hjelm"
"DOTA_Item_Legion_Commanders_Shoulder_Armor"	"Legion Commanders skulderrustning"
"DOTA_Item_Legion_Commanders_Sword"	"Legion Commanders sverd"
"DOTA_Item_Lifestealers_Back"	"Lifestealers rygg"
"DOTA_Item_Lifestealers_Head"	"Lifestealers hode"
"DOTA_Item_Lions_Shoulders"	"Lions skuldre"
"DOTA_Item_Lone_Druids_Tunic"	"Lone Druids tunika"
"DOTA_Item_Lycans_Head_Accessory"	"Lycans hodetilbehør"
"DOTA_Item_Lycans_Wolves"	"Lycans ulver"
"DOTA_Item_Magnus_Belt"	"Magnus' belte"
"DOTA_Item_Magnus_Bracers"	"Magnus' armbeskyttere"
"DOTA_Item_Magnus_Hair"	"Magnus' hår"
"DOTA_Item_Magnus_Horn"	"Magnus' horn"
"DOTA_Item_Magnus_Weapon"	"Magnus' våpen"
"DOTA_Item_Morphlings_Arms"	"Morphlings armer"
"DOTA_Item_Morphlings_Back"	"Morphlings rygg"
"DOTA_Item_Morphlings_Head"	"Morphlings hode"
"DOTA_Item_Morphlings_Miscellaneous"	"Morphlings diverse"
"DOTA_Item_Morphlings_Shoulders"	"Morphlings skuldre"
"DOTA_Item_Naga_Sirens_Head"	"Naga Sirens hode"
"DOTA_Item_Natures_Prophet_Beard"	"Nature's Prophets skjegg"
"DOTA_Item_Natures_Prophet_Bracers"	"Nature's Prophets armbeskyttere"
"DOTA_Item_Natures_Prophet_Cape"	"Nature's Prophets kappe"
"DOTA_Item_Natures_Prophet_Horns"	"Nature's Prophets horn"
"DOTA_Item_Natures_Prophet_Necklace"	"Nature's Prophets halskjede"
"DOTA_Item_Natures_Prophet_Staff"	"Nature's Prophets stav"
"DOTA_Item_Natures_Prophet_Treant"	"Nature's Prophets treant"
"DOTA_Item_Necrophos_Beard"	"Necrophos' skjegg"
"DOTA_Item_Necrophos_Headdress"	"Necrophos' hodeplagg"
"DOTA_Item_Necrophos_Sickle"	"Necrophos' sigd"
"DOTA_Item_Necrophos_Vestments"	"Necrophos' klesdrakt"
"DOTA_Item_Nested_Treasure_II"	"Nested Treasure II"
"DOTA_Item_Nightstalkers_Arms"	"Night Stalkers armer"
"DOTA_Item_Nightstalkers_Head"	"Night Stalkers hode"
"DOTA_Item_Nyxs_Claws"	"Nyx' klør"
"DOTA_Item_Nyxs_Miscellaneous"	"Nyx' diverse"
"DOTA_Item_Omniknights_Miscellaneous"	"Omniknights diverse"
"DOTA_Item_Pudges_Back_Rings_and_Apron"	"Pudges ryggringer og forkle"
"DOTA_Item_Sand_Kings_Claws"	"Sand Kings klør"
"DOTA_Item_Shadow_Shamans_Belt"	"Shadow Shamans belte"
"DOTA_Item_Spectres_Head"	"Spectres hode"
"DOTA_Item_Spectres_Miscellaneous"	"Spectres diverse"
"DOTA_Item_Spectres_Shoulders"	"Spectres skuldre"
"DOTA_Item_Spirit_Breakers_Belt"	"Spirit Breakers belte"
"DOTA_Item_Svens_Back"	"Svens rygg"
"DOTA_Item_Svens_Belt"	"Svens belte"
"DOTA_Item_Svens_Gauntlet"	"Svens stridshanske"
"DOTA_Item_Svens_Mask"	"Svens maske"
"DOTA_Item_Svens_Shoulder"	"Svens skulder"
"DOTA_Item_Templar_Assassins_Armor"	"Templar Assassins rustning"
"DOTA_Item_Templar_Assassins_Hair"	"Templar Assassins hår"
"DOTA_Item_Templar_Assassins_Shoulders"	"Templar Assassins skuldre"
"DOTA_Item_Tidehunters_Back"	"Tidehunters rygg"
"DOTA_Item_Tidehunters_Head"	"Tidehunters hode"
"DOTA_Item_Undyings_Tombstone"	"Undyings gravstein"
"DOTA_WearableType_Cogs"	"Tannhjul"
"DOTA_Item_PandaFx_Tournament_1Vs1"	"PandaFx Tournament 1Vs1"
"DOTA_Item_NCups_Season_3"	"NCups Season 3"
"DOTA_Item_NGT_Season_4"	"NGT Season 4"
"DOTA_Item_Nepal_InHouse_League"	"Nepal In-House League"
"DOTA_Item_NFCups_Season_2"	"NFCups Season 2"
"DOTA_Item_Neva_Championship_Season_1"	"Neva Championship Season 1"
"DOTA_Item_Arcane_Defiance"	"Arcane Defiance"
"DOTA_Item_Bloodroot_Guard"	"Bloodroot Guard"
"DOTA_Item_Bloodroot_Guard_Loading_Screen"	"Lasteskjerm: Bloodroot Guard"
"DOTA_Item_Raiments_of_Twilight_Shade"	"Raiments of Twilight Shade"
"DOTA_Item_Raiments_of_Twilight_Shade_Loading_Screen"	"Lasteskjerm: Raiments of Twilight Shade"
"DOTA_Item_Desc_Desert_Music_Pack"	"Komponert av samfunnsartisten Matt Hawken. Kunst av samfunnskunstneren Scott Wade."
"DOTA_Item_Desert_Music_Pack"	"Musikkpakke: Desert"
"DOTA_Teams_Arrow_Gaming"	"Arrow Gaming"
"DOTA_Teams_CIS_Game"	"CIS Game"
"DOTA_Teams_Evil_Geniuses"	"Evil Geniuses"
"DOTA_Teams_MVP_Phoenix"	"MVP Phoenix"
"DOTA_Teams_NaVi_NA"	"NaVi NA"
"DOTA_Teams_ViCi_Gaming"	"ViCi Gaming"
"DOTA_Teams_World_Elite"	"World Elite"
"DOTA_Item_AD2L_Season_10"	"AD2L sesong 10"
"DOTA_Item_Desc_Eyes_of_the_Watchroot"	" ­"
"DOTA_Item_NHK_League_Season_One"	"NHK League Season One"
"DOTA_Item_NN_Dota_2_League_Season_4"	"NN Dota 2 League Season 4"
"DOTA_Item_Necklace_of_the_Vehement_Plume"	"Necklace of the Vehement Plume"
"DOTA_Item_Narcissistic_Leech"	"Narcissistic Leech"
"DOTA_Item_Narcissistic_Leech_Loading_Screen"	"Lasteskjerm: Narcissistic Leech"
"DOTA_Item_Ram_of_Enveloping_Despair"	"Ram of Enveloping Despair"
"DOTA_Item_Raikage_Warrior"	"Raikage Warrior"
"DOTA_Item_Raikage_Warrior_Loading_Screen"	"Lasteskjerm: Raikage Warrior"
"DOTA_Item_AquaCup_#1"	"AquaCup #1"
"DOTA_Item_Desc_AquaCup_#1"	"Velkommen til den første Aqua Cup. Vi håper å kunne tilby engasjerende turneringer for amatører i DotA 2. Alle lag, uansett ferdighetsnivå, er velkomne til å delta i denne enkle turneringen. Turneringen opererer med \"single elimination\"-utslagsregler."
"DOTA_Item_Desc_CZSK_Dota_2_League_Season_7"	"Den sjuende sesongen av Czech-Slovakia-ligaen vil finne sted over en periode på to måneder. Vinneren vil motta en pengepremie!"
"DOTA_Item_Desc_Gamers_Lounge_WinterCup"	"Faraoer fra hele Egypt konkurrerer om Gamers Lounge WinterCup-tittelen!"
"DOTA_Item_Desc_Glazov_Cup"	"Spillere fra Udmurtia og CIS-samveldet kommer til å spille en internliga"
"DOTA_Item_Desc_Hell_League_"	"Registrer ditt lag og kjemp dere gjennom gruppespillet mot finalen"
"DOTA_Item_Desc_IGA_amateur_league_S1"	"Dette er den første fullstendige amatørligaen for DOTA 2 i midtøsten, holdt på nett. Amatørlag konkurrerer med hverandre for å nå høyere rangeringer i DOTA 2-samfunnet"
"DOTA_Item_Desc_Sudamerican_Master_4"	"Fjerde utgave av en av de største turneringene i Amerika. De beste lagene i Sør- og Nord-Amerika konkurrerer om å vinne over $4000."
"DOTA_Item_Desc_Venezuela_Dota_2_cup_Season_2"	"Venezuela-turneringen samler 16 lag for å konkurrere om en plass i finalen."
"DOTA_Item_Desc_Vortex_Gaming_Tournament_by_MOL_Indonesia"	"Nividia ICafe Vortex Gaming Jambi Dota 2-turnering organisert av MOL Indonesia
IDR 25.000.000"
"DOTA_Item_Desc_joinDOTA_League_#9"	"Den globale Dota 2-ligaen for alle. Dette inkluderer de fleste kamper fra den semi-profesjonelle divisjon 2 og noen kamper fra amatørdivisjonene."
"DOTA_Item_ESL_One_Manila_2016"	"ESL One Manila 2016"
"DOTA_Item_Gamers_Lounge_WinterCup"	"Gamers Lounge WinterCup"
"DOTA_Item_Glazov_Cup"	"Glazov Cup"
"DOTA_Item_Hell_League_"	"Hell League "
"DOTA_Item_IGA_amateur_league_S1"	"IGA amateur league S1"
"DOTA_Item_LANSKILL_WINTER_2016"	"LANSKILL WINTER 2016"
"DOTA_Item_Respawn_League_Dota_2_Edition_2016"	"Respawn League: Dota 2 Edition 2016"
"DOTA_Item_Sudamerican_Master_4"	"Sudamerican Master 4"
"DOTA_Item_The_Kaolin_Cup"	"The Kaolin Cup"
"DOTA_Item_Vortex_Gaming_Tournament_by_MOL_Indonesia"	"Vortex Gaming Tournament av MOL Indonesia"
"DOTA_Item_joinDOTA_League_#9"	"joinDOTA League #9"
"DOTA_Item_Blade_of_the_Rekindled_Ashes"	"Blade of the Rekindled Ashes"
"DOTA_Item_Guard_of_the_Rekindled_Ashes"	"Guard of the Rekindled Ashes"
"DOTA_Item_Headdress_of_the_Rekindled_Ashes"	"Headdress of the Rekindled Ashes"
"DOTA_Item_Nacion_Gamers_Tournaments"	"Nacion Gamers Tournaments"
"DOTA_Item_OffHand_Blade_of_the_Rekindled_Ashes"	"Off-Hand Blade of the Rekindled Ashes"
"DOTA_Item_Rekindled_Ashes"	"Rekindled Ashes"
"DOTA_Item_Robe_of_the_Rekindled_Ashes"	"Robe of the Rekindled Ashes"
"DOTA_Item_Shoulders_of_the_Rekindled_Ashes"	"Shoulders of the Rekindled Ashes"
"DOTA_Set_Rekindled_Ashes"	"Rekindled Ashes"
"DOTA_Item_Rage_of_the_Dark_Wood"	"Rage of the Dark Wood"
"DOTA_Item_Rage_of_the_Dark_Wood_Loading_Screen"	"Lasteskjerm: Rage of the Dark Wood"
"DOTA_Item_Shadows_of_the_Wuxia"	"Shadows of the Wuxia"
"DOTA_Item_Shadows_of_the_Wuxia_Loading_Screen"	"Lasteskjerm: Shadows of the Wuxia"
"DOTA_Item_Spirit_of_the_Dark_Wood"	"Spirit of the Dark Wood"
"DOTA_Item_Wraith_of_the_Merqueen"	"Wraith of the Merqueen"
"DOTA_Item_Spirit_of_the_Emeraldine_Rider"	"Spirit of the Emeraldine Rider"
"DOTA_Item_Spirit_of_the_Emeraldine_Rider_Loading_Screen"	"Lasteskjerm: Spirit of the Emeraldine Rider"
"DOTA_Item_JJ_Lins_Timekeeper_Music_Pack"	"Musikkpakke: JJ Lin's Timekeeper"
"DOTA_Item_JJ_Lins_Timekeeper_Music_Pack_Bundle"	"Pakke: JJ Lin's Timekeeper (musikkpakke)"
"DOTA_Item_Shadowpath_Scholar"	"Shadowpath Scholar"
"DOTA_Item_Desc_The_Gathering_2016"	"The Gathering er Norges største datatreff og har eksistert siden 1992. Årets Dota 2-turnering har en premiepott på 39 000 kroner (4 000 dollar)."
"DOTA_Item_Mace_of_Aeons"	"Mace of Aeons"
"DOTA_Item_Matt_Lange_Abstraction_Music_Pack"	"Musikkpakke: Matt Lange Abstraction"
"DOTA_Item_Phantom_Lancer_immortal_shard"	"Phantom Lancer immortal shard"
"DOTA_Item_Phoenixs_Head"	"Phoenix' hode"
"DOTA_Item_omniknight_ti6_immortal"	"omniknight_ti6_immortal"
"DOTA_Item_rainbow_spear"	"rainbow_spear"
"DOTA_Item_Raiments_of_the_Eventide"	"Raiments of the Eventide"
"DOTA_Item_Raiments_of_the_Eventide_Set_Loading_Screen"	"Lasteskjerm: Raiments of the Eventide"
"DOTA_Item_Next_Gaming_Championship_IV__LAN"	"Next Gaming Championship IV – LAN"
"DOTA_Item_Adoring_Wingfall"	"Adoring Wingfall"
"DOTA_Item_Backplates_of_the_Razorwyrm"	"Backplates of the Razorwyrm"
"DOTA_Item_Belt_of_the_Razorwyrm"	"Belt of the Razorwyrm"
"DOTA_Item_Bindings_of_the_Battleranger"	"Bindings of the Battleranger"
"DOTA_Item_Bow_of_the_Battleranger"	"Bow of the Battleranger"
"DOTA_Item_Bow_of_the_Urushin_Huntsman"	"Bow of the Urushin Huntsman"
"DOTA_Item_Cloak_of_the_Battleranger"	"Cloak of the Battleranger"
"DOTA_Item_Controlled_Burn"	"Controlled Burn"
"DOTA_Item_Copa_de_Abertura_LBEE"	"Copa de Abertura LBEE"
"DOTA_Item_DA_5v5_Team_Series"	"DA 5v5 Team Series"
"DOTA_Item_Desc_Copy_of_Pin_AntiMage"	"En samlepins du kan vise frem på Steam-profilen."
"DOTA_Item_Desc_Copy_of_Pin_Earthshaker"	"En samlepins du kan vise frem på Steam-profilen."
"DOTA_Item_Desc_Copy_of_Pin_Enigma"	"En samlepins du kan vise frem på Steam-profilen."
"DOTA_Item_Desc_Copy_of_Pin_Invoker_"	"En samlepins du kan vise frem på Steam-profilen."
"DOTA_Item_Desc_Copy_of_Pin_Io"	"En samlepins du kan vise frem på Steam-profilen."
"DOTA_Item_Desc_Copy_of_Pin_Meepo"	"En samlepins du kan vise frem på Steam-profilen."
"DOTA_Item_Desc_Copy_of_Pin_Riki"	"En samlepins du kan vise frem på Steam-profilen."
"DOTA_Item_Desc_Copy_of_Pin_Sniper"	"En samlepins du kan vise frem på Steam-profilen."
"DOTA_Item_Desc_Copy_of_Pin_Tiny"	"En samlepins du kan vise frem på Steam-profilen."
"DOTA_Item_Desc_Copy_of_Pin_Tusk_"	"En samlepins du kan vise frem på Steam-profilen."
"DOTA_Item_Desc_Copy_of_Pin_Warlock"	"En samlepins du kan vise frem på Steam-profilen."
"DOTA_Item_Desc_Copy_of_Pin_Wraith_King_"	"En samlepins du kan vise frem på Steam-profilen."
"DOTA_Item_Gauntlets_of_the_Razorwyrm"	"Gauntlets of the Razorwyrm"
"DOTA_Item_Golden_Fortunes_Tout"	"Golden Fortune's Tout"
"DOTA_Item_Immortal_Gardens"	"Immortal Gardens"
"DOTA_Item_Nanyang_Championships_Season_2"	"Nanyang Championships Season 2"
"DOTA_Item_Onibi"	"Onibi"
"DOTA_Item_Pauldrons_of_the_Battleranger"	"Pauldrons of the Battleranger"
"DOTA_Item_Phantom_Concord"	"Phantom Concord"
"DOTA_Item_Pin_AntiMage"	"Pins: Anti-Mage"
"DOTA_Item_Pin_Bristleback"	"Pins: Bristleback"
"DOTA_Item_Pin_Crystal_Maiden"	"Pins: Crystal Maiden"
"DOTA_Item_Pin_Earthshaker"	"Pins: Earthshaker"
"DOTA_Item_Pin_Enigma"	"Pins: Enigma"
"DOTA_Item_Pin_Invoker_"	"Pins: Invoker "
"DOTA_Item_Pin_Io"	"Pins: Io"
"DOTA_Item_Pin_Lina"	"Pins: Lina"
"DOTA_Item_Pin_Meepo"	"Pins: Meepo"
"DOTA_Item_Pin_Pack_4"	"Pinspakke 4"
"DOTA_Item_Pin_Pack_5"	"Pinspakke 5"
"DOTA_Item_Pin_Pack_6"	"Pinspakke 6"
"DOTA_Item_Pin_Phoenix"	"Pins: Phoenix"
"DOTA_Item_Pin_Pudge"	"Pins: Pudge"
"DOTA_Item_Pin_Riki"	"Pins: Riki"
"DOTA_Item_Pin_Tiny"	"Pins: Tiny"
"DOTA_Item_Pin_Tusk_"	"Pins: Tusk "
"DOTA_Item_Pin_Warlock"	"Pins: Warlock"
"DOTA_Item_Pin_Wraith_King_"	"Pins: Wraith King "
"DOTA_Item_Portfolio_of_Heroes_Ascendant"	"Portfolio of Heroes Ascendant"
"DOTA_Item_Quiver_of_the_Battleranger"	"Quiver of the Battleranger"
"DOTA_Item_Quiver_of_the_Urushin_Huntsman"	"Quiver of the Urushin Huntsman"
"DOTA_Item_Reflex_League"	"Reflex League"
"DOTA_Item_STAN_Dota_2"	"STAN Dota 2"
"DOTA_Item_Scale_of_the_Razorwyrm"	"Scale of the Razorwyrm"
"DOTA_Item_Sentinels_of_the_Urushin_Huntsman"	"Sentinels of the Urushin Huntsman"
"DOTA_Item_Skull_of_the_Razorwyrm"	"Skull of the Razorwyrm"
"DOTA_Item_Smeevils_Penance"	"Smeevil's Penance"
"DOTA_Item_Style_of_the_Battleranger"	"Style of the Battleranger"
"DOTA_Item_Talons_of_the_Urushin_Huntsman"	"Talons of the Urushin Huntsman"
"DOTA_Item_The_International_2016"	"The International 2016"
"DOTA_Item_The_International_2016_HUD"	"The International 2016 HUD"
"DOTA_Item_The_International_2016_Music_Pack"	"Musikkpakke: The International 2016"
"DOTA_Item_UGC_League_Dota_2_Premium_2016"	"UGC League Dota 2 Premium 2016"
"DOTA_Item_Urushin_Huntsman"	"Urushin Huntsman"
"DOTA_Item_Virgas_Arc"	"Virga's Arc"
"DOTA_Item_Weather_Ash"	"Weather Ash"
"DOTA_Item_Weather_Aurora"	"Weather Aurora"
"DOTA_Item_Weather_Spring"	"Weather Spring"
"DOTA_Item_World_Electronic_sports_games"	"World Electronic sports games"
"DOTA_Item_Wrap_of_the_Urushin_Huntsman"	"Wrap of the Urushin Huntsman"
"DOTA_Item_Desc_Copy_of_Pin_The_International_2015_Attendee"	"En samlepins du kan vise frem på Steam-profilen."
"DOTA_Item_Pin_The_International_2016_Attendee"	"Pins: The International 2016-deltaker"
"DOTA_Item_Undyings_Belt"	"Undyings belte"
"DOTA_Item_Doomsday_Ripper"	"Doomsday Ripper"
"DOTA_Item_Doomsday_Ripper_Arms"	"Doomsday Ripper Arms"
"DOTA_Item_Doomsday_Ripper_Back"	"Doomsday Ripper Back"
"DOTA_Item_Doomsday_Ripper_Belt"	"Doomsday Ripper Belt"
"DOTA_Item_Doomsday_Ripper_Head"	"Doomsday Ripper Head"
"DOTA_Item_Doomsday_Ripper_Loading_Screen_Loading_Screen"	"Lasteskjerm: Doomsday Ripper"
"DOTA_Item_Doomsday_Ripper_OffHand"	"Doomsday Ripper Off-Hand"
"DOTA_Item_Doomsday_Ripper_Shoulder"	"Doomsday Ripper Shoulder"
"DOTA_Item_Doomsday_Ripper_Weapon"	"Doomsday Ripper Weapon"
"DOTA_Item_Nightsilvers_Resolve"	"Nightsilver's Resolve"
"DOTA_Item_Nightsilvers_Resolve_Loading_Screen"	"Lasteskjerm: Nightsilver's Resolve"
"DOTA_Item_Shoulders_of_the_Fortified_Fabricator"	"Shoulders of the Fortified Fabricator"
"DOTA_Item_The_Family_Values_Shoulders"	"The Family Values Shoulders"
"DOTA_Item_NEA2016"	"NEA2016"
"DOTA_Item_Boris_Baumhauer"	"Boris Baumhauer"
"DOTA_WearableType_Grass_Cutter_Extraordinaire"	"Ekstraordinær gressklipper"
"DOTA_Item_NEL"	"NEL"
"DOTA_Item_NFCups_Season_3"	"NFCups Season 3"
"DOTA_Item_Nxt_Evo_Dota_2_SEA"	"Nxt Evo Dota 2 SEA"
"DOTA_Item_Underlords_Armor"	"Underlords rustning"
"DOTA_Item_Underlords_Head"	"Underlords hode"
"DOTA_Item_Underlords_Head_Item"	"Underlords hodegjenstand"
"DOTA_Item_Underlords_Weapon"	"Underlords våpen"
"DOTA_Item_Desc_Pin_Cosplay_2016"	"En eksklusiv samlepins for Dota 2-cosplayere, som kan vises frem på Steam-profilen."
"DOTA_Item_Nothlic_Burden"	"Nothlic Burden"
"DOTA_Item_Nothlic_Burden_of_the_Crimson_Witness"	"Nothlic Burden of the Crimson Witness"
"DOTA_Item_Pin_Cosplay_2016"	"Pins: Cosplay 2016"
"DOTA_Item_Arc_of_Skarsnik"	"Arc of Skarsnik"
"DOTA_Item_Arc_of_Warlord_Skarsnik"	"Arc of Warlord Skarsnik"
"DOTA_Item_Axes_of_the_Chaos_Wastes"	"Axes of the Chaos Wastes"
"DOTA_Item_Chaos_Chosen"	"Chaos Chosen"
"DOTA_Item_NCups__Clan_Wars"	"NCups: Clan Wars"
"DOTA_Item_Noble_Crown_of_Frostheart"	"Noble Crown of Frostheart"
"DOTA_Item_Noble_Frostheart"	"Noble Frostheart"
"DOTA_Item_Noble_Wings_of_Frostheart"	"Noble Wings of Frostheart"
"DOTA_Item_Raven_of_the_Chaos_Wastes"	"Raven of the Chaos Wastes"
"DOTA_Item_Shoulders_of_Skarsnik"	"Shoulders of Skarsnik"
"DOTA_Item_Shoulders_of_Warlord_Skarsnik"	"Shoulders of Warlord Skarsnik"
"DOTA_Item_Northern_Arena_BEAT_Invitational_presented_by_Bell"	"Northern Arena BEAT Invitational presented by Bell"
"DOTA_Item_Chaos_of_the_Infernal_Maw"	"Chaos of the Infernal Maw"
"DOTA_Item_NYC_Cruise_Cup"	"NYC Cruise Cup"
"DOTA_Item_Shoulders_of_the_Survivor"	"Shoulders of the Survivor"
"DOTA_Item_NFCups_Season_4"	"NFCups Season 4"
"DOTA_Item_NFCups_Season_5"	"NFCups Season 5"
"DOTA_Item_Shoulders_of_the_Bladeform_Aesthete"	"Shoulders of the Bladeform Aesthete"
"DOTA_Item_Shoulders_of_the_Infernal_Rambler"	"Shoulders of the Infernal Rambler"
"DOTA_Item_Shoulders_of_the_Silent_Edict"	"Shoulders of the Silent Edict"
"DOTA_Item_Play4Series"	"Play4Series"
"DOTA_Teams_Ad_Finem"	"Ad Finem"
"DOTA_Teams_Faceless"	"Faceless"
"DOTA_Teams_IG_Vitality"	"IG.Vitality"
"DOTA_Teams_LGD_ForeverYoung"	"LGD.ForeverYoung"
"DOTA_Teams_NP"	"NP"
"DOTA_Teams_WarriorsGaming_Unity"	"WarriorsGaming.Unity"
"DOTA_Item_Shoulders_of_the_Dark_Moon_Stalker"	"Shoulders of the Dark Moon Stalker"
"DOTA_Item_Desc_Vipers_Head"	"Tom standardplass"
"DOTA_Item_Monkey_King_Armor"	"Monkey Kings rustning"
"DOTA_Item_Monkey_King_Head"	"Monkey Kings hode"
"DOTA_Item_Monkey_King_Weapon"	"Monkey Kings våpen"
"DOTA_Item_Phoenix_Supernova"	"Phoenix' supernova"
"DOTA_Item_Phoenix_Wings"	"Phoenix' vinger"
"DOTA_Item_Rancorous_Nemesis"	"Rancorous Nemesis"
"DOTA_Item_Rancorous_Nemesis_Loading_Screen"	"Lasteskjerm: Rancorous Nemesis"
"DOTA_Item_Necklace_of_the_Jiang_Shis_Revenge"	"Necklace of the Jiang Shi's Revenge"
"DOTA_Item_Nomad_of_the_Burning_Decree"	"Nomad of the Burning Decree"
"DOTA_Item_Shoulders_of_the_Ageless_Witness"	"Shoulders of the Ageless Witness"
"DOTA_Item_Shoulders_of_the_Burning_Decree"	"Shoulders of the Burning Decree"
"DOTA_Item_Desc_Northern_Winds_Music_Pack"	"Komponert av samfunnsartisten John Boberg"
"DOTA_Item_Northern_Winds_Music_Pack"	"Musikkpakke: Northern Winds"
"DOTA_Item_Spirits_of_the_Mothbinder"	"Spirits of the Mothbinder"
"DOTA_Item_Juggernaut_Gaming_#1_Supported_by_UniPin_and_Gomers"	"Juggernaut Gaming #1 Supported by UniPin and Gomers"
"DOTA_Item_Dragon_of_the_Outland_Ravager"	"Dragon of the Outland Ravager"
"DOTA_Item_Radiance_Dota_2_2017"	"Radiance Dota 2 -2017"
"DOTA_Item_Medallion_of_the_Ghastly_Gourmand"	"Medallion of the Ghastly Gourmand"
"DOTA_Item_Desc_Elemental_Fury_Music_Pack"	"Komponert av samfunnsartisten Daniel Sadowski"
"DOTA_Item_Elemental_Fury_Music_Pack"	"Musikkpakke: Elemental Fury"
"DOTA_Item_Niu_League_2017_Season_2"	"Niu League 2017 Season 2"
"DOTA_Item_Desc_TI7_League"	"http://steamcommunity.com/sharedfiles/filedetails/?id=876336836"
"DOTA_Item_Rarities_of_the_Benefactor_2017"	"Rarities of the Benefactor 2017"
"DOTA_Item_Razor_Spines_of_the_Sunken_Gaoler"	"Razor Spines of the Sunken Gaoler"
"DOTA_Item_The_International_2017_Music_Pack"	"Musikkpakke: The International 2017"
"DOTA_Item_Ios_Head"	"Ios hode"
"DOTA_Item_Necklaces_of_the_Coastal_Kingdom"	"Necklaces of the Coastal Kingdom"
"DOTA_Item_Pantaloons_of_the_Vodou_Rover"	"Pantaloons of the Vodou Rover"
"DOTA_Item_Brewmasters_Headitem"	"Brewmasters hodegjenstand"
"DOTA_Item_Desc_Brewmasters_Headitem"	"Tom standardplass"
"DOTA_Item_Blood_In_The_Streets_BITS"	"Blood In The Streets (BITS)"
"DOTA_Item_NESO_4th_National_ESports_ShenZhen_Open_Tournament_Galaxy_Battles"	"NESO 4th National E-Sports ShenZhen Open Tournament- Galaxy Battles"
"DOTA_Item_Niu_League_2017_Season_3"	"Niu League 2017 Season 3"
"DOTA_Item_Chaos_Fulcrum"	"Chaos Fulcrum"
"DOTA_Item_Faceit_League_B"	"Faceit League B"
"DOTA_Item_Desc_Pin_The_International_2017_Attendee"	"En samlepins du kan vise frem på Steam-profilen."
"DOTA_Item_Pin_The_International_2017_Attendee"	"Pins: The International 2017-deltaker"
"DOTA_Item_Desc_Pin_Cosplay_2017"	"En eksklusiv samlepins for Dota 2-cosplayere, som kan vises frem på Steam-profilen."
"DOTA_Item_Pin_Cosplay_2017"	"Pins: Cosplay 2017"
"DOTA_Item_Lifestone"	"Lifestone"
"DOTA_Item_Naginata_of_the_Allure"	"Naginata of the Allure"
"DOTA_Item_Naginata_of_the_Allure_OffHand"	"Naginata of the Allure Off-Hand"
"DOTA_Item_Rambling_Fatebender"	"Rambling Fatebender"
"DOTA_Item_Rambling_Fatebender_Loading_Screen"	"Lasteskjerm: Rambling Fatebender"
"DOTA_Item_Ancient_Apparitions_Shoulders"	"Ancient Apparitions skuldre"
"DOTA_Item_Pangolier_Head"	"Pangoliers hode"
"DOTA_Item_Pangoliers_Armor"	"Pangoliers rustning"
"DOTA_Item_Pangoliers_OffHand"	"Pangoliers sekundær"
"DOTA_Item_Pangoliers_Weapon"	"Pangoliers våpen"
"DOTA_Item_Phantom_Lancers_Hat"	"Phantom Lancers hatt"
"DOTA_Item_Juggernauts_Default_Voice"	"Juggernauts standardstemme"
"DOTA_Item_Arctic_Recluse"	"Arctic Recluse"
"DOTA_Item_Nova_of_Golden_Nirvana"	"Nova of Golden Nirvana"
"DOTA_Item_Raucous_Gatecrasher"	"Raucous Gatecrasher"
"DOTA_Item_Raucous_Gatecrasher_Loading_Screen"	"Lasteskjerm: Raucous Gatecrasher"
"DOTA_Item_Neck_of_the_Boilerplate_Bruiser"	"Neck of the Boilerplate Bruiser"
"DOTA_Item_Razors_of_the_Iron_Hog"	"Razors of the Iron Hog"
"DOTA_Item_Spirit_Bear_of_the_WarBurrow_Ravager"	"Spirit Bear of the War-Burrow Ravager"
"DOTA_Item_Axes_of_the_Icewrack_Marauder"	"Axes of the Icewrack Marauder"
"DOTA_Item_Elder_Convergence"	"Elder Convergence"
"DOTA_Item_Face_of_the_Iron_Hog"	"Face of the Iron Hog"
"DOTA_Item_Arc_Wardens_Head"	"Arc Wardens hode"
"DOTA_Item_Monkey_King_Shoulders"	"Monkey Kings skuldre"
"DOTA_Item_Shoulders_of_the_Dragon_Palace"	"Shoulders of the Dragon Palace"
"DOTA_Item_Shoulders_of_the_Icewrack_Marauder"	"Shoulders of the Icewrack Marauder"
"DOTA_Item_Shoulders_of_the_Imperious_Command"	"Shoulders of the Imperious Command"
"DOTA_Item_Shoulders_of_the_Riptide_Raider"	"Shoulders of the Riptide Raider"
"DOTA_Item_AWOLNATION__Magic_Sticks_of_Dynamite_Music_Pack"	"Musikkpakke: AWOLNATION – Magic Sticks of Dynamite"
"DOTA_Item_Desc_AWOLNATION__Magic_Sticks_of_Dynamite_Music_Pack"	"Komponert av AWOLNATION"
"DOTA_Item_CHINA_DOTA2_SUPER_MAJOR"	"CHINA DOTA2 SUPER MAJOR"
"DOTA_Item_ESL_One_Birmingham_2018_powered_by_Intel"	"ESL One Birmingham 2018 sponset av Intel"
"DOTA_Item_Legion_Commanders_Legs_Armor"	"Legion Commanders beinrustning"
"DOTA_Item_Necrophos_Skirt"	"Necrophos' skjørt"
"DOTA_Item_Rarities_of_the_Benefactor_2018"	"Rarities of the Benefactor 2018"
"DOTA_Item_The_International_2018_Music_Pack"	"Musikkpakke: The International 2018"
"DOTA_Item_Raptures_of_the_Abyssal_Kin"	"Raptures of the Abyssal Kin"
"DOTA_Item_Dragon_Form_of_the_Third_Awakening"	"Dragon Form of the Third Awakening"
"DOTA_Item_Raiments_of_the_Obsidian_Forge"	"Raiments of the Obsidian Forge"
"DOTA_Item_Bloodfeather_Feast"	"Bloodfeather Feast"
"DOTA_Item_Desc_Pin_The_International_2018_Attendee"	"En samlepins du kan vise frem på Steam-profilen."
"DOTA_Item_Pin_The_International_2018_Attendee"	"Pins: The International 2018-deltaker"
"DOTA_Item_Trove_Carafe_2018_Autographed_by_Alex_Bafik_Bafadarov"	"Trove Carafe 2018: Signert av Alex «Bafik» Bafadarov"
"DOTA_Item_Trove_Carafe_2018_Autographed_by_Alex_Machine_Richardson"	"Trove Carafe 2018: Signert av Alex «Machine» Richardson"
"DOTA_Item_Trove_Carafe_2018_Autographed_by_Alexey_Lex_Filippov"	"Trove Carafe 2018: Signert av Alexey «Lex» Filippov"
"DOTA_Item_Trove_Carafe_2018_Autographed_by_Andrey_Dread_Golubev"	"Trove Carafe 2018: Signert av Andrey «Dread» Golubev"
"DOTA_Item_Trove_Carafe_2018_Autographed_by_Antonina_Tonya_Predko"	"Trove Carafe 2018: Signert av Antonina «Tonya» Predko"
"DOTA_Item_Trove_Carafe_2018_Autographed_by_Artem_Fng_Barshack"	"Trove Carafe 2018: Signert av Artem «Fng» Barshack"
"DOTA_Item_Trove_Carafe_2018_Autographed_by_Artur_Goblak_Kostenko"	"Trove Carafe 2018: Signert av Artur «Goblak» Kostenko"
"DOTA_Item_Trove_Carafe_2018_Autographed_by_Austin_Capitalist_Walsh"	"Trove Carafe 2018: Signert av Austin «Capitalist» Walsh"
"DOTA_Item_Trove_Carafe_2018_Autographed_by_Brian_BSJ_Canavan"	"Trove Carafe 2018: Signert av Brian «BSJ» Canavan"
"DOTA_Item_Trove_Carafe_2018_Autographed_by_Charles_Nahaz_Bester"	"Trove Carafe 2018: Signert av Charles «Nahaz» Bester"
"DOTA_Item_Trove_Carafe_2018_Autographed_by_Chen_AMS_Juan"	"Trove Carafe 2018: Signert av Chen AMS Juan"
"DOTA_Item_Trove_Carafe_2018_Autographed_by_Chen_JophyA_Ya"	"Trove Carafe 2018: Signert av Chen «JophyA» Ya"
"DOTA_Item_Trove_Carafe_2018_Autographed_by_Chu_Shadow_Zeyu"	"Trove Carafe 2018: Signert av Chu «Shadow» Zeyu"
"DOTA_Item_Trove_Carafe_2018_Autographed_by_David_GoDz_Parker"	"Trove Carafe 2018: Signert av David «GoDz» Parker"
"DOTA_Item_Trove_Carafe_2018_Autographed_by_David_Luminous_Zhang"	"Trove Carafe 2018: Signert av David «Luminous» Zhang"
"DOTA_Item_Trove_Carafe_2018_Autographed_by_Dmitrij_Droog_Chumachenko"	"Trove Carafe 2018: Signert av Dmitrij «Droog» Chumachenko"
"DOTA_Item_Trove_Carafe_2018_Autographed_by_Dmitriy_LighTofHeaveN_Kupriyanov"	"Trove Carafe 2018: Signert av Dmitriy «LighTofHeaveN» Kupriyanov"
"DOTA_Item_Trove_Carafe_2018_Autographed_by_Dmitry_CrystalMay_Korchevinin"	"Trove Carafe 2018: Signert av Dmitry «CrystalMay» Korchevinin"
"DOTA_Item_Trove_Carafe_2018_Autographed_by_Dominik_Black_Reitmeier"	"Trove Carafe 2018: Signert av Dominik «Black^» Reitmeier"
"DOTA_Item_Trove_Carafe_2018_Autographed_by_Dong_DC_Can"	"Trove Carafe 2018: Signert av Dong «DC» Can"
"DOTA_Item_Trove_Carafe_2018_Autographed_by_Du_78_Junnan"	"Trove Carafe 2018: Signert av Du 78 Junnan"
"DOTA_Item_Trove_Carafe_2018_Autographed_by_Egor_JotM_Surkov"	"Trove Carafe 2018: Signert av Egor «JotM» Surkov"
"DOTA_Item_Trove_Carafe_2018_Autographed_by_Gabriel_Lyrical_Cryz"	"Trove Carafe 2018: Signert av Gabriel «Lyrical» Cryz"
"DOTA_Item_Trove_Carafe_2018_Autographed_by_Grant_GranDGrant_Harris"	"Trove Carafe 2018: Signert av Grant «GranDGrant» Harris"
"DOTA_Item_Trove_Carafe_2018_Autographed_by_Hao_Freeagain_Peng"	"Trove Carafe 2018: Signert av Hao Freeagain Peng"
"DOTA_Item_Trove_Carafe_2018_Autographed_by_Helen_XiiTuzi_Xu"	"Trove Carafe 2018: Signert av Helen «XiiTuzi» Xu"
"DOTA_Item_Trove_Carafe_2018_Autographed_by_Henrik_Admiral_Bulldog_Ahnberg"	"Trove Carafe 2018: Signert av Henrik «Admiral Bulldog» Ahnberg"
"DOTA_Item_Trove_Carafe_2018_Autographed_by_Ilya_Lil_Ilyuk"	"Trove Carafe 2018: Signert av Ilya «Lil» Ilyuk"
"DOTA_Item_Trove_Carafe_2018_Autographed_by_Ioannis_Fogged_Loucas"	"Trove Carafe 2018: Signert av Ioannis «Fogged» Loucas"
"DOTA_Item_Trove_Carafe_2018_Autographed_by_Ivan_Faker_Demkin"	"Trove Carafe 2018: Signert av Ivan «Faker» Demkin"
"DOTA_Item_Trove_Carafe_2018_Autographed_by_Jake_SirActionSlacks_Kanner"	"Trove Carafe 2018: Signert av Jake «SirActionSlacks» Kanner"
"DOTA_Item_Trove_Carafe_2018_Autographed_by_Johan_Weppas_Westberg"	"Trove Carafe 2018: Signert av Johan Weppas Westberg"
"DOTA_Item_Trove_Carafe_2018_Autographed_by_Jonathan_PimpmuckL_Liebig"	"Trove Carafe 2018: Signert av Jonathan «PimpmuckL» Liebig"
"DOTA_Item_Trove_Carafe_2018_Autographed_by_Jorien_Sheever_van_der_Heijden"	"Trove Carafe 2018: Signert av Jorien «Sheever» van der Heijden"
"DOTA_Item_Trove_Carafe_2018_Autographed_by_Josh_AutumnWindz_Lee"	"Trove Carafe 2018: Signert av Josh «AutumnWindz» Lee"
"DOTA_Item_Trove_Carafe_2018_Autographed_by_Kaci_Aitchison"	"Trove Carafe 2018: Signert av Kaci Aitchison"
"DOTA_Item_Trove_Carafe_2018_Autographed_by_Ken_Hot_Bid_Chen"	"Trove Carafe 2018: Signert av Ken «Hot_Bid» Chen"
"DOTA_Item_Trove_Carafe_2018_Autographed_by_Kevin_Purge_Godec"	"Trove Carafe 2018: Signert av Kevin «Purge» Godec"
"DOTA_Item_Trove_Carafe_2018_Autographed_by_Kyle_Freedman"	"Trove Carafe 2018: Signert av Kyle Freedman"
"DOTA_Item_Trove_Carafe_2018_Autographed_by_Li_AA_Qiming"	"Trove Carafe 2018: Signert av Li «AA» Qiming"
"DOTA_Item_Trove_Carafe_2018_Autographed_by_Litt_Winter_Chan"	"Trove Carafe 2018: Signert av Litt «Winter» Chan"
"DOTA_Item_Trove_Carafe_2018_Autographed_by_Luo_430_Feichi"	"Trove Carafe 2018: Signert av Luo «430» Feichi"
"DOTA_Item_Trove_Carafe_2018_Autographed_by_Marcus_djWHEAT_Graham"	"Trove Carafe 2018: Signert av Marcus «djWHEAT» Graham"
"DOTA_Item_Trove_Carafe_2018_Autographed_by_Maxim_TpoH_Vernikov"	"Trove Carafe 2018: Signert av Maxim «TpoH» Vernikov"
"DOTA_Item_Trove_Carafe_2018_Autographed_by_Nikita_4ce_Kotkov"	"Trove Carafe 2018: Signert av Nikita «4ce» Kotkov"
"DOTA_Item_Trove_Carafe_2018_Autographed_by_Oleg_Feaver_Skarzhinsky"	"Trove Carafe 2018: Signert av Oleg «Feaver» Skarzhinsky"
"DOTA_Item_Trove_Carafe_2018_Autographed_by_Oleksander_XBOCT_Dashkevych"	"Trove Carafe 2018: Signert av Oleksander «XBOCT» Dashkevych"
"DOTA_Item_Trove_Carafe_2018_Autographed_by_Owen_ODPixel_Davies"	"Trove Carafe 2018: Signert av Owen «ODPixel» Davies"
"DOTA_Item_Trove_Carafe_2018_Autographed_by_Paul_Redeye_Chaloner"	"Trove Carafe 2018: Signert av Paul «Redeye» Chaloner"
"DOTA_Item_Trove_Carafe_2018_Autographed_by_Rikard_skrff_Holm_Melin"	"Trove Carafe 2018: Signert av Rikard «skrff» Holm Melin"
"DOTA_Item_Trove_Carafe_2018_Autographed_by_Roman_CaspeRRR_Lepokhin"	"Trove Carafe 2018: Signert av Roman «CaspeRRR» Lepokhin"
"DOTA_Item_Trove_Carafe_2018_Autographed_by_Rui_Mrrr_Meng"	"Trove Carafe 2018: Signert av Rui «Mrrr» Meng"
"DOTA_Item_Trove_Carafe_2018_Autographed_by_Sergey_Smile_Revin"	"Trove Carafe 2018: Signert av Sergey «Smile» Revin"
"DOTA_Item_Trove_Carafe_2018_Autographed_by_Shi_CC_Cancan"	"Trove Carafe 2018: Signert av Shi «CC» Cancan"
"DOTA_Item_Trove_Carafe_2018_Autographed_by_Shi_SDN_Danni"	"Trove Carafe 2018: Signert av Shi «SDN» Danni"
"DOTA_Item_Trove_Carafe_2018_Autographed_by_Taewon_March_Park"	"Trove Carafe 2018: Signert av Taewon «March» Park"
"DOTA_Item_Trove_Carafe_2018_Autographed_by_Ted_Pyrion_Flax_Forsyth"	"Trove Carafe 2018: Signert av Ted Pyrion Flax Forsyth"
"DOTA_Item_Trove_Carafe_2018_Autographed_by_Toby_TobiWan_Dawson"	"Trove Carafe 2018: Signert av Toby «TobiWan» Dawson"
"DOTA_Item_Trove_Carafe_2018_Autographed_by_Trent_TrentPax_MacKenzie"	"Trove Carafe 2018: Signert av Trent «TrentPax» MacKenzie"
"DOTA_Item_Trove_Carafe_2018_Autographed_by_Troels_syndereN_Nielsen"	"Trove Carafe 2018: Signert av Troels «syndereN» Nielsen"
"DOTA_Item_Trove_Carafe_2018_Autographed_by_Viktor_GodHunt_Volkov"	"Trove Carafe 2018: Signert av Viktor «GodHunt» Volkov"
"DOTA_Item_Trove_Carafe_2018_Autographed_by_Vitalii_v1lat_Volochai"	"Trove Carafe 2018: Signert av Vitalii «v1lat» Volochai"
"DOTA_Item_Trove_Carafe_2018_Autographed_by_Vladimir_Maelstorm_Kuzminov"	"Trove Carafe 2018: Signert av Vladimir «Maelstorm» Kuzminov"
"DOTA_Item_Trove_Carafe_2018_Autographed_by_Wang_Wind_Zhibo"	"Trove Carafe 2018: Signert av Wang «Wind» Zhibo"
"DOTA_Item_Trove_Carafe_2018_Autographed_by_Wang_Yuno_Jing"	"Trove Carafe 2018: Signert av Wang Yuno Jing"
"DOTA_Item_Trove_Carafe_2018_Autographed_by_Wei_CD_Tao"	"Trove Carafe 2018: Signert av Wei «CD» Tao"
"DOTA_Item_Trove_Carafe_2018_Autographed_by_William_Blitz_Lee"	"Trove Carafe 2018: Signert av William «Blitz» Lee"
"DOTA_Item_Trove_Carafe_2018_Autographed_by_William_Chobra_Cho"	"Trove Carafe 2018: Signert av William «Chobra» Cho"
"DOTA_Item_Trove_Carafe_2018_Autographed_by_Yaroslav_NS_Kuznetso"	"Trove Carafe 2018: Signert av Yaroslav «NS» Kuznetso"
"DOTA_Item_Trove_Carafe_2018_Autographed_by_Yu_MS_Xiang"	"Trove Carafe 2018: Signert av Yu «MS» Xiang"
"DOTA_Item_Trove_Carafe_2018_Autographed_by_Zhang_BBC_Hongsheng"	"Trove Carafe 2018: Signert av Zhang BBC Hongsheng"
"DOTA_Item_Trove_Carafe_2018_Autographed_by_Zhang_Dove_Tiange"	"Trove Carafe 2018: Signert av Zhang «Dove» Tiange"
"DOTA_Item_Trove_Carafe_2018_Autographed_by_Zhang_xiao8_Ning"	"Trove Carafe 2018: Signert av Zhang «xiao8» Ning"
"DOTA_Item_Trove_Carafe_2018_Autographed_by_Xu_BurNIng_Zhilei"	"Trove Carafe 2018: Signert av Xu «BurNIng» Zhilei"
"DOTA_Item_Grimstrokes_Armor"	"Grimstrokes rustning"
"DOTA_Item_Grimstrokes_Belt"	"Grimstrokes belte"
"DOTA_Item_Grimstrokes_Mask"	"Grimstrokes maske"
"DOTA_Item_Grimstrokes_Weapon"	"Grimstrokes våpen"
"DOTA_Item_Trove_Carafe_2018_Autographed_by_Ben_Merlini_Wu"	"Trove Carafe 2018: Signert av Ben «Merlini» Wu"
"DOTA_Item_Desc_The_FatRat__Warrior_Songs"	"Komponert av TheFatRat"
"DOTA_Item_Tail_of_Darkheart_Pursuit"	"Tail of Darkheart Pursuit"
"DOTA_Item_The_FatRat__Warrior_Songs_Music_Pack"	"Musikkpakke: TheFatRat Warrior Songs"
"DOTA_Item_Adornments_of_the_Crystal_Path"	"Adornments of the Crystal Path"
"DOTA_Item_Anvil_of_the_Earthwright"	"Anvil of the Earthwright"
"DOTA_Item_Armguards_of_the_Equilibrium"	"Armguards of the Equilibrium"
"DOTA_Item_Armor_of_the_Crystal_Path"	"Armor of the Crystal Path"
"DOTA_Item_Armor_of_the_Emerald_Insurgence"	"Armor of the Emerald Insurgence"
"DOTA_Item_Armor_of_the_Equilibrium"	"Armor of the Equilibrium"
"DOTA_Item_Armor_of_the_Lionsguard"	"Armor of the Lionsguard"
"DOTA_Item_Armor_of_the_Narrow_Fates"	"Armor of the Narrow Fates"
"DOTA_Item_Armor_of_the_Winged_Harvest"	"Armor of the Winged Harvest"
"DOTA_Item_Basket_of_the_Fae_Forager"	"Basket of the Fae Forager"
"DOTA_Item_Bastion_of_the_Lionsguard"	"Bastion of the Lionsguard"
"DOTA_Item_Bastion_of_the_Lionsguard_Loading_Screen"	"Lasteskjerm: Bastion of the Lionsguard"
"DOTA_Item_Beard_of_the_Emerald_Insurgence"	"Beard of the Emerald Insurgence"
"DOTA_Item_Belt_of_Empiric_Incendiary"	"Belt of Empiric Incendiary"
"DOTA_Item_Belt_of_the_Emerald_Insurgence"	"Belt of the Emerald Insurgence"
"DOTA_Item_Belt_of_the_Forsaken_Flame"	"Belt of the Forsaken Flame"
"DOTA_Item_Belt_of_the_Lionsguard"	"Belt of the Lionsguard"
"DOTA_Item_Belt_of_the_Narrow_Fates"	"Belt of the Narrow Fates"
"DOTA_Item_Bracers_of_the_Earthwright"	"Bracers of the Earthwright"
"DOTA_Item_Bracers_of_the_Forsaken_Flame"	"Bracers of the Forsaken Flame"
"DOTA_Item_Bracers_of_the_Lionsguard"	"Bracers of the Lionsguard"
"DOTA_Item_Bracers_of_the_Narrow_Fates"	"Bracers of the Narrow Fates"
"DOTA_Item_Cage_of_the_Fae_Forager"	"Cage of the Fae Forager"
"DOTA_Item_Cap_of_the_Fae_Forager"	"Cap of the Fae Forager"
"DOTA_Item_Cape_of_Empiric_Incendiary"	"Cape of Empiric Incendiary"
"DOTA_Item_Clarity_of_the_Crystal_Path"	"Clarity of the Crystal Path"
"DOTA_Item_Crow_of_Empiric_Incendiary"	"Crow of Empiric Incendiary"
"DOTA_Item_Desc_Anvil_of_the_Earthwright"	"Inneholder settet «Anvil of the Earthwright» til Earthshaker."
"DOTA_Item_Desc_Bastion_of_the_Lionsguard"	"Inneholder settet «Bastion of the Lionsguard» til Skywrath Mage, samt lasteskjermen."
"DOTA_Item_Desc_Clarity_of_the_Crystal_Path"	"Inneholder settet «Clarity of the Crystal Path» til Oracle."
"DOTA_Item_Desc_Empiric_Incendiary"	"Inneholder settet «Empiric Incendiary» til Batrider."
"DOTA_Item_Desc_Iris_of_the_Equilibrium"	"Inneholder settet «Iris of the Equilibrium» til Ancient Apparition."
"DOTA_Item_Desc_Magister_of_the_Narrow_Fates"	"Inneholder settet «Magister of the Narrow Fates» til Razor, samt lasteskjermen."
"DOTA_Item_Desc_Mischief_of_the_Fae_Forager"	"Inneholder settet «Mischief of the Fae Forager» til Dark Willow, samt lasteskjermen."
"DOTA_Item_Desc_Sanction_of_the_Winged_Harvest"	"Inneholder settet «Sanction of the Winged Harvest» til Visage, samt lasteskjermen."
"DOTA_Item_Desc_Treasure_of_the_Carmine_Cascade"	"Inneholder nye sett til Earthshaker, Dark Willow, Oracle, Visage og mange flere!"
"DOTA_Item_Desc_Vanguard_of_the_Emerald_Insurgence"	"Inneholder settet «Vanguard of the Emerald Insurgence» til Nature's Prophet."
"DOTA_Item_Desc_Visions_of_the_Forsaken_Flame"	"Inneholder settet «Visions of the Forsaken Flame» til Ember Spirit."
"DOTA_Item_Desc_recycling_october_2018_treasure"	"Gjenvinn uåpnede sett for en skatt og Dota Plus-skår."
"DOTA_Item_Dress_of_the_Fae_Forager"	"Dress of the Fae Forager"
"DOTA_Item_Empiric_Incendiary"	"Empiric Incendiary"
"DOTA_Item_Familiar_of_the_Winged_Harvest"	"Familiar of the Winged Harvest"
"DOTA_Item_Hat_of_Empiric_Incendiary"	"Hat of Empiric Incendiary"
"DOTA_Item_Head_of_the_Winged_Harvest"	"Head of the Winged Harvest"
"DOTA_Item_Helm_of_the_Crystal_Path"	"Helm of the Crystal Path"
"DOTA_Item_Helm_of_the_Earthwright"	"Helm of the Earthwright"
"DOTA_Item_Helm_of_the_Equilibrium"	"Helm of the Equilibrium"
"DOTA_Item_Helm_of_the_Lionsguard"	"Helm of the Lionsguard"
"DOTA_Item_Helm_of_the_Narrow_Fates"	"Helm of the Narrow Fates"
"DOTA_Item_Hood_of_the_Forsaken_Flame"	"Hood of the Forsaken Flame"
"DOTA_Item_Iris_of_the_Equilibrium"	"Iris of the Equilibrium"
"DOTA_Item_Lakad_Coconut_of_the_Emerald_Insurgence"	"Lakad Coconut of the Emerald Insurgence"
"DOTA_Item_Lance_of_the_Lionsguard"	"Lance of the Lionsguard"
"DOTA_Item_Magister_of_the_Narrow_Fates"	"Magister of the Narrow Fates"
"DOTA_Item_Magister_of_the_Narrow_Fates_Loading_Screen"	"Lasteskjerm: Magister of the Narrow Fates"
"DOTA_Item_Mischief_of_the_Fae_Forager"	"Mischief of the Fae Forager"
"DOTA_Item_Mischief_of_the_Fae_Forager_Loading_Screen"	"Lasteskjerm: Mischief of the Fae Forager"
"DOTA_Item_OffHand_Weapon_of_the_Forsaken_Flame"	"Off-Hand Weapon of the Forsaken Flame"
"DOTA_Item_Sanction_of_the_Winged_Harvest"	"Sanction of the Winged Harvest"
"DOTA_Item_Sanction_of_the_Winged_Harvest_Loading_Screen"	"Lasteskjerm: Sanction of the Winged Harvest"
"DOTA_Item_Shield_of_the_Emerald_Insurgence"	"Shield of the Emerald Insurgence"
"DOTA_Item_Staff_of_the_Emerald_Insurgence"	"Staff of the Emerald Insurgence"
"DOTA_Item_Style_of_the_Emerald_Insurgence"	"Style of the Emerald Insurgence"
"DOTA_Item_Tail_of_the_Equilibrium"	"Tail of the Equilibrium"
"DOTA_Item_Toolbelt_of_the_Earthwright"	"Toolbelt of the Earthwright"
"DOTA_Item_Totem_of_the_Earthwright"	"Totem of the Earthwright"
"DOTA_Item_Treasure_of_the_Carmine_Cascade"	"Treasure of the Carmine Cascade"
"DOTA_Item_Vanguard_of_the_Emerald_Insurgence"	"Vanguard of the Emerald Insurgence"
"DOTA_Item_Vetments_of_the_Forsaken_Flame"	"Vestments of the Forsaken Flame"
"DOTA_Item_Visions_of_the_Forsaken_Flame"	"Visions of the Forsaken Flame"
"DOTA_Item_Weapon_of_the_Crystal_Path"	"Weapon of the Crystal Path"
"DOTA_Item_Weapon_of_the_Forsaken_Flame"	"Weapon of the Forsaken Flame"
"DOTA_Item_Whip_of_the_Narrow_Fates"	"Whip of the Narrow Fates"
"DOTA_Item_Wings_of_the_Fae_Forager"	"Wings of the Fae Forager"
"DOTA_Item_Wings_of_the_Lionsguard"	"Wings of the Lionsguard"
"DOTA_Item_recycling_october_2018_treasure"	"recycling_october_2018_treasure"
"DOTA_Set_Anvil_of_the_Earthwright"	"Anvil of the Earthwright"
"DOTA_Set_Bastion_of_the_Lionsguard"	"Bastion of the Lionsguard"
"DOTA_Set_Clarity_of_the_Crystal_Path"	"Clarity of the Crystal Path"
"DOTA_Set_Empiric_Incendiary"	"Empiric Incendiary"
"DOTA_Set_Iris_of_the_Equilibrium"	"Iris of the Equilibrium"
"DOTA_Set_Magister_of_the_Narrow_Fates"	"Magister of the Narrow Fates"
"DOTA_Set_Mischief_of_the_Fae_Forager"	"Mischief of the Fae Forager"
"DOTA_Set_Sanction_of_the_Winged_Harvest"	"Sanction of the Winged Harvest"
"DOTA_Set_Vanguard_of_the_Emerald_Insurgence"	"Vanguard of the Emerald Insurgence"
"DOTA_Set_Visions_of_the_Forsaken_Flame"	"Visions of the Forsaken Flame"
}
}
