"lang"
{
"Language"	"norwegian"
"Tokens"
{
"addon_game_name"	"Aghanims labyrint"
"[english]addon_game_name"	"Aghanim's Labyrinth"
"DOTA_GameMode_15"	"Aghanims labyrint"
"[english]DOTA_GameMode_15"	"Aghanim's Labyrinth"
"DOTA_GameMode_19"	"Aghanims labyrint"
"[english]DOTA_GameMode_19"	"Aghanim's Labyrinth"
"aghanim_bonus_round_time_left"	"TID IGJEN"
"[english]aghanim_bonus_round_time_left"	"TIME LEFT"
"dota_game_end_victory_title_radiant"	"Dere overvant kontinuumshvelvet"
"[english]dota_game_end_victory_title_radiant"	"You have bested the Continuum Vault"
"dota_game_end_victory_title_dire"	"Gruppen bukket under for kontinuumshvelvet"
"[english]dota_game_end_victory_title_dire"	"The Continuum Vault claims your party"
"DOTA_HUD_EnemiesRemaining"	"RESTERENDE FIENDER:"
"[english]DOTA_HUD_EnemiesRemaining"	"ENEMIES REMAINING:"
"DOTA_HUD_TimeRemaining"	"RESTERENDE TID:"
"[english]DOTA_HUD_TimeRemaining"	"TIME REMAINING:"
"DOTA_HUD_Victory"	"SEIER!"
"[english]DOTA_HUD_Victory"	"VICTORY!"
"DOTA_HUD_Defeat"	"TAP!"
"[english]DOTA_HUD_Defeat"	"DEFEAT!"
"DOTA_HUD_Kills"	"DRAP"
"[english]DOTA_HUD_Kills"	"KILLS"
"DOTA_HUD_Deaths"	"DØDSFALL"
"[english]DOTA_HUD_Deaths"	"DEATHS"
"DOTA_HUD_Saves"	"GJENOPPLIVNINGER"
"[english]DOTA_HUD_Saves"	"REVIVES"
"DOTA_HUD_Bags"	"SEKKER"
"[english]DOTA_HUD_Bags"	"BAGS"
"DOTA_HUD_Mute"	"DEMP"
"[english]DOTA_HUD_Mute"	"MUTE"
"DOTA_HUD_PlayAgain"	"Spill igjen?"
"[english]DOTA_HUD_PlayAgain"	"Play Again?"
"DOTA_HUD_Yes"	"JA"
"[english]DOTA_HUD_Yes"	"YES"
"DOTA_HUD_No"	"NEI"
"[english]DOTA_HUD_No"	"NO"
"DOTA_HUD_Score"	"POENG"
"[english]DOTA_HUD_Score"	"SCORE"
"DOTA_HUD_GoldBags"	"GULLSEKKER PLUKKET OPP"
"[english]DOTA_HUD_GoldBags"	"GOLD BAGS COLLECTED"
"DOTA_HUD_GoldBagsMissed"	"GULLSEKKER MISSET"
"[english]DOTA_HUD_GoldBagsMissed"	"GOLD BAGS MISSED"
"DOTA_HUD_TeamDeaths"	"LAGDØDSFALL"
"[english]DOTA_HUD_TeamDeaths"	"TEAM DEATHS"
"DOTA_HUD_Rewards"	"SEPTERSKÅR"
"[english]DOTA_HUD_Rewards"	"SCEPTER SHARDS"
"DOTA_HUD_Blessings"	"VELSIGNELSER"
"[english]DOTA_HUD_Blessings"	"BLESSINGS"
"DOTA_HUD_RoomRewards"	"Rombelønninger"
"[english]DOTA_HUD_RoomRewards"	"Room Rewards"
"DOTA_HUD_ShowBlessings"	"Vis velsignelser"
"[english]DOTA_HUD_ShowBlessings"	"Show Blessings"
"DOTA_HUD_HideBlessings"	"Skjul velsignelser"
"[english]DOTA_HUD_HideBlessings"	"Hide Blessings"
"DOTA_HUD_Reward_Header"	"Velg belønning"
"[english]DOTA_HUD_Reward_Header"	"Choose your reward"
"DOTA_HUD_Reward_Gold"	"Bonusgull"
"[english]DOTA_HUD_Reward_Gold"	"Bonus Gold"
"DOTA_HUD_Reward_Gold_desc"	"{d:quantity} gull"
"[english]DOTA_HUD_Reward_Gold_desc"	"{d:quantity} Gold"
"DOTA_HUD_Reward_ExtraLives"	"Ekstraliv"
"[english]DOTA_HUD_Reward_ExtraLives"	"Extra Live(s)"
"DOTA_HUD_Reward_ExtraLives_desc"	"{d:quantity} ekstraliv"
"[english]DOTA_HUD_Reward_ExtraLives_desc"	"{d:quantity} Extra Life"
"DOTA_HUD_Reward_Item"	"Nøytral gjenstand"
"[english]DOTA_HUD_Reward_Item"	"Neutral Item"
"DOTA_HUD_Reward_TempBuff"	"Midlertidig styrkelse"
"[english]DOTA_HUD_Reward_TempBuff"	"Temp Buff"
"DOTA_HUD_Reward_Aura"	"Aura"
"[english]DOTA_HUD_Reward_Aura"	"Aura"
"DOTA_HUD_Reward_AbilityUpgrade"	"Aghanims velsignelse"
"[english]DOTA_HUD_Reward_AbilityUpgrade"	"Aghanim's Blessing"
"DOTA_HUD_Reward_MinotrAbilityUpgrade"	"Evneoppgradering"
"[english]DOTA_HUD_Reward_MinotrAbilityUpgrade"	"Ability Upgrade"
"DOTA_HUD_Reward_AdditionalRewards"	"Ytterligere belønninger tildelt"
"[english]DOTA_HUD_Reward_AdditionalRewards"	"Additional Rewards Granted"
"DOTA_HUD_Game_Mode_Header"	"Velkommen til Aghanims labyrint!"
"[english]DOTA_HUD_Game_Mode_Header"	"Welcome To Aghanim's Labyrinth!"
"DOTA_HUD_Rewards_AscensionLevel"	"Oppstigningsgrad: {d:ascension_level}"
"[english]DOTA_HUD_Rewards_AscensionLevel"	"Ascension Level: {d:ascension_level}"
"DOTA_HUD_TopBar_Difficulty"	"{s:difficulty_name}"
"[english]DOTA_HUD_TopBar_Difficulty"	"{s:difficulty_name}"
"DOTA_HUD_BattleRoyaleDamageStarting"	"Gå i striden, feiging!"
"[english]DOTA_HUD_BattleRoyaleDamageStarting"	"Join the battle, coward!"
"DOTA_Tooltip_Ability_item_arcane_fragments"	"Mystiske fragmenter"
"[english]DOTA_Tooltip_Ability_item_arcane_fragments"	"Arcane Fragments"
"DOTA_HUD_Rewards_ShowRewards"	"SEPTERSKÅR TILGJENGELIG"
"[english]DOTA_HUD_Rewards_ShowRewards"	"SCEPTER SHARD AVAILABLE"
"DOTA_HUD_Rewards_Info"	"Se valgte oppgraderinger på resultattavlen"
"[english]DOTA_HUD_Rewards_Info"	"View selected upgrades in the scoreboard"
"DOTA_HUD_REWARD_TIER1_Desc"	"Kategori 1"
"[english]DOTA_HUD_REWARD_TIER1_Desc"	"Tier 1"
"DOTA_HUD_REWARD_TIER2_Desc"	"Kategori 2"
"[english]DOTA_HUD_REWARD_TIER2_Desc"	"Tier 2"
"DOTA_HUD_REWARD_TIER3_Desc"	"Kategori 3"
"[english]DOTA_HUD_REWARD_TIER3_Desc"	"Tier 3"
"DOTA_HUD_REWARD_TIER4_Desc"	"Kategori 4"
"[english]DOTA_HUD_REWARD_TIER4_Desc"	"Tier 4"
"DOTA_HUD_REWARD_TIER5_Desc"	"Kategori 5"
"[english]DOTA_HUD_REWARD_TIER5_Desc"	"Tier 5"
"DOTA_Hud_EncounterDepth"	"Dybde {s:encounter_depth}"
"[english]DOTA_Hud_EncounterDepth"	"Depth {s:encounter_depth}"
"DOTA_Hud_AscenionAbilitiesTitle"	"Ekstra modifikasjoner"
"[english]DOTA_Hud_AscenionAbilitiesTitle"	"Additional Modifiers"
"DOTA_Hud_Elite_Encounter_Discover"	"Eliteoppgjør – 2x belønninger"
"[english]DOTA_Hud_Elite_Encounter_Discover"	"Elite Encounter - 2x Rewards"
"DOTA_Hud_Elite_Encounter"	"Eliteoppgjør"
"[english]DOTA_Hud_Elite_Encounter"	"Elite Encounter"
"DOTA_HUD_Reward_Rarity_Common"	"Velg et <font color='#88A6D9'>VANLIG</font> septerskår"
"[english]DOTA_HUD_Reward_Rarity_Common"	"Choose a <font color='#88A6D9'>COMMON</font> Scepter Shard"
"DOTA_HUD_Reward_Rarity_Elite"	"Velg et <font color='#D02B29'>ELITE</font>-septerskår"
"[english]DOTA_HUD_Reward_Rarity_Elite"	"Choose an <font color='#D02B29'>ELITE</font> Scepter Shard"
"DOTA_HUD_Reward_Rarity_Epic"	"Velg et <font color='#7266FF'>LEGENDARISK</font> septerskår"
"[english]DOTA_HUD_Reward_Rarity_Epic"	"Choose a <font color='#7266FF'>LEGENDARY</font> Scepter Shard"
"DOTA_HUD_REWARD_TYPE_GOLD_Toast"	"{s:player_name} valgte: {d:int_value} <panel class='CombatEventGoldIcon'/>"
"[english]DOTA_HUD_REWARD_TYPE_GOLD_Toast"	"{s:player_name} chose {d:int_value} <panel class='CombatEventGoldIcon'/>"
"DOTA_HUD_REWARD_TYPE_ITEM_Toast"	"{s:player_name} valgte: {s:locstring_value}"
"[english]DOTA_HUD_REWARD_TYPE_ITEM_Toast"	"{s:player_name} chose {s:locstring_value}"
"DOTA_HUD_REWARD_TYPE_ABILITY_UPGRADE_Toast"	"{s:player_name} valgte: {s:locstring_value}"
"[english]DOTA_HUD_REWARD_TYPE_ABILITY_UPGRADE_Toast"	"{s:player_name} chose {s:locstring_value}"
"DOTA_HUD_REWARD_TYPE_EXTRA_LIVES_Toast"	"{s:player_name} valgte: {d:int_value}"
"[english]DOTA_HUD_REWARD_TYPE_EXTRA_LIVES_Toast"	"{s:player_name} chose {d:int_value}"
"DOTA_HUD_REWARD_TYPE_MINOR_ABILITY_UPGRADE_Toast"	"{s:player_name} valgte: %s1"
"[english]DOTA_HUD_REWARD_TYPE_MINOR_ABILITY_UPGRADE_Toast"	"{s:player_name} chose %s1"
"DOTA_HUD_REWARD_TYPE_MINOR_STATS_UPGRADE_Toast"	"{s:player_name} valgte: %s1"
"[english]DOTA_HUD_REWARD_TYPE_MINOR_STATS_UPGRADE_Toast"	"{s:player_name} chose %s1"
"DOTA_HUD_REWARD_TYPE_GOLD_Desc"	"Gull"
"[english]DOTA_HUD_REWARD_TYPE_GOLD_Desc"	"Gold"
"DOTA_HUD_REWARD_TYPE_TREASURE_Desc"	"Skattekiste"
"[english]DOTA_HUD_REWARD_TYPE_TREASURE_Desc"	"Treasure Chest"
"DOTA_HUD_REWARD_TYPE_EXTRA_LIVES_Desc"	"Ekstraliv"
"[english]DOTA_HUD_REWARD_TYPE_EXTRA_LIVES_Desc"	"Extra Lives"
"DOTA_HUD_Claimed_Rewards_Header"	"Innløste belønninger"
"[english]DOTA_HUD_Claimed_Rewards_Header"	"Claimed Rewards"
"DOTA_Hud_Tooltip_Outpost_Title"	"Strid"
"[english]DOTA_Hud_Tooltip_Outpost_Title"	"Combat"
"DOTA_Hud_Tooltip_Outpost_EliteTitle"	"Elitestrid"
"[english]DOTA_Hud_Tooltip_Outpost_EliteTitle"	"Elite Combat"
"DOTA_Hud_Tooltip_Outpost_TrapTitle"	"Felle"
"[english]DOTA_Hud_Tooltip_Outpost_TrapTitle"	"Trap"
"DOTA_Hud_Tooltip_Outpost_BossTitle"	"Boss"
"[english]DOTA_Hud_Tooltip_Outpost_BossTitle"	"Boss"
"DOTA_Hud_Tooltip_Outpost_BonusTitle"	"Bonus"
"[english]DOTA_Hud_Tooltip_Outpost_BonusTitle"	"Bonus"
"DOTA_Hud_Tooltip_Outpost_TransitionTitle"	"Hvile"
"[english]DOTA_Hud_Tooltip_Outpost_TransitionTitle"	"Rest"
"DOTA_Hud_Outpost_ChannelBar_Title"	"Velger STRID"
"[english]DOTA_Hud_Outpost_ChannelBar_Title"	"Selecting COMBAT"
"DOTA_Hud_Outpost_ChannelBar_EliteTitle"	"VELGER <font color='#D02B29'>ELITE</font>STRID"
"[english]DOTA_Hud_Outpost_ChannelBar_EliteTitle"	"Selecting <font color='#D02B29'>ELITE</font> COMBAT"
"DOTA_Hud_Outpost_ChannelBar_TrapTitle"	"Velger <font color='#FF7F37'>FELLER</font>"
"[english]DOTA_Hud_Outpost_ChannelBar_TrapTitle"	"Selecting <font color='#FF7F37'>TRAPS</font>"
"DOTA_Hud_Outpost_ChannelBar_BossTitle"	"Velger <font color='#7266FF'>BOSS</font>"
"[english]DOTA_Hud_Outpost_ChannelBar_BossTitle"	"Selecting <font color='#7266FF'>BOSS</font>"
"DOTA_Hud_Outpost_ChannelBar_BonusTitle"	"Velger <font color='#f9cb4f'>BONUS</font>"
"[english]DOTA_Hud_Outpost_ChannelBar_BonusTitle"	"Selecting <font color='#f9cb4f'>BONUS</font>"
"DOTA_Hud_Outpost_ChannelBar_RestTitle"	"Velger <font color='#f9cb4f'>HVILE</font>"
"[english]DOTA_Hud_Outpost_ChannelBar_RestTitle"	"Selecting <font color='#f9cb4f'>REST</font>"
"defeat_boss_npc_dota_boss_timbersaw"	"Beseir høvelsagen Ribbalder"
"[english]defeat_boss_npc_dota_boss_timbersaw"	"Defeat Rizzrick the Razorsaw"
"npc_dota_crate"	"Trekasse"
"[english]npc_dota_crate"	"Wooden Crate"
"npc_dota_boss_timbersaw"	"Ribbalder"
"[english]npc_dota_boss_timbersaw"	"Rizzrick"
"Aghanim_FoundChestItem"	"{s:player_name} fant en skatt som inneholdt: {s:locstring_value}"
"[english]Aghanim_FoundChestItem"	"{s:player_name} found a treasure containing: {s:locstring_value}"
"Aghanim_FoundChestGold"	"{s:player_name} fant en skatt som inneholdt: <font color='#ffd825'>{s:value}</font><panel class='CombatEventGoldIcon'/>"
"[english]Aghanim_FoundChestGold"	"{s:player_name} found a treasure containing: <font color='#ffd825'>{s:value}</font><panel class='CombatEventGoldIcon'/>"
"Aghanim_FoundChestTrap"	"{s:player_name} fant en skatt som inneholdt: <font color='#ffd825'>{s:locstring_value}</font>!"
"[english]Aghanim_FoundChestTrap"	"{s:player_name} found a treasure containing: <font color='#ffd825'>{s:locstring_value}</font>!"
"Aghanim_FoundLifeRune"	"{s:player_name} fant en {s:locstring_value}!"
"[english]Aghanim_FoundLifeRune"	"{s:player_name} found a {s:locstring_value}!"
"Aghanim_FoundItem"	"{s:player_name} fant en ny gjenstand: <font color='#4ae0bf'>{s:locstring_value}</font>!"
"[english]Aghanim_FoundItem"	"{s:player_name} found a new item: <font color='#4ae0bf'>{s:locstring_value}</font>!"
"Aghanim_FoundConsumableItem"	"{s:player_name} fant en forbruksgjenstand: <font color='#0CF1F1'>{s:locstring_value}</font>!"
"[english]Aghanim_FoundConsumableItem"	"{s:player_name} found a consumable item: <font color='#0CF1F1'>{s:locstring_value}</font>!"
"Aghanim_KilledByCreature"	"{s:player_name} ble drept av {s:locstring_value}"
"[english]Aghanim_KilledByCreature"	"{s:player_name} was killed by {s:locstring_value}"
"Aghanim_BattlePointsFound"	"{s:player_name} fant {d:int_value} battlepoeng til laget!"
"[english]Aghanim_BattlePointsFound"	"{s:player_name} found {d:int_value} Battle Points for the team!"
"Aghanim_ArcaneFragmentsFound"	"{s:player_name} fant {d:int_value} mystiske fragmenter til laget!"
"[english]Aghanim_ArcaneFragmentsFound"	"{s:player_name} found {d:int_value} Arcane Fragments for the team!"
"npc_dota_announcer_aghanim"	"Aghanim"
"[english]npc_dota_announcer_aghanim"	"Aghanim"
"npc_dota_aghanim_clone_mecha"	"Aghanim"
"[english]npc_dota_aghanim_clone_mecha"	"Aghanim"
"npc_dota_aghanim_clone_mad_maghs"	"Aghanim"
"[english]npc_dota_aghanim_clone_mad_maghs"	"Aghanim"
"npc_dota_aghanim_clone_goat"	"Aghanim"
"[english]npc_dota_aghanim_clone_goat"	"Aghanim"
"npc_dota_aghanim_clone_dude"	"Aghanim"
"[english]npc_dota_aghanim_clone_dude"	"Aghanim"
"npc_dota_aghanim_clone_bucket"	"Aghanim"
"[english]npc_dota_aghanim_clone_bucket"	"Aghanim"
"npc_dota_aghanim_clone_blacksmith"	"Aghanim"
"[english]npc_dota_aghanim_clone_blacksmith"	"Aghanim"
"npc_dota_aghanim_clone_barbarian"	"Aghanim"
"[english]npc_dota_aghanim_clone_barbarian"	"Aghanim"
"DOTA_HUD_Upgrades_Cooldown"	"Nedkjølingsreduksjon"
"[english]DOTA_HUD_Upgrades_Cooldown"	"Cooldown Reduction"
"DOTA_HUD_Upgrades_ManaCost"	"Redusert manakostnad"
"[english]DOTA_HUD_Upgrades_ManaCost"	"Mana Cost Reduction"
"DOTA_Tooltip_modifier_polarity_Description"	"Absorber prosjektiler som samsvarer med fargen på skjoldet ditt. Far(g)efullt."
"[english]DOTA_Tooltip_modifier_polarity_Description"	"Absorb projectiles that match the color of your shield. Try not to dye."
"DOTA_Tooltip_Ability_aghsfort_treant_miniboss_natures_guise_Description"	"Gir evnen til å gå gjennom trær og et rotfestende slag."
"[english]DOTA_Tooltip_Ability_aghsfort_treant_miniboss_natures_guise_Description"	"Grants tree-walking and a rooty punch."
"DOTA_Tooltip_modifier_aghsfort_boss_earthshaker_enchant_totem_land_debuff_Description"	"Denne enheten har hemmet bevegelse."
"[english]DOTA_Tooltip_modifier_aghsfort_boss_earthshaker_enchant_totem_land_debuff_Description"	"This unit has slowed movement."
"DOTA_Tooltip_modifier_boss_tinker_laser_debuff_Description"	"100 %% sjanse til å bomme."
"[english]DOTA_Tooltip_modifier_boss_tinker_laser_debuff_Description"	"Has 100%% miss chance."
"DOTA_Tooltip_modifier_boss_tinker_polymorph_Description"	"Enheten er forvandlet."
"[english]DOTA_Tooltip_modifier_boss_tinker_polymorph_Description"	"This unit is transformed."
"DOTA_Tooltip_modifier_aghsfort_treant_miniboss_natures_guise_root_Description"	"Enheten kan ikke bevege seg."
"[english]DOTA_Tooltip_modifier_aghsfort_treant_miniboss_natures_guise_root_Description"	"This unit cannot move."
"DOTA_Tooltip_modifier_twilight_maze_vision_aura_effect_Description"	"Enheten har redusert sikt."
"[english]DOTA_Tooltip_modifier_twilight_maze_vision_aura_effect_Description"	"This unit has reduced vision range."
"DOTA_Tooltip_modifier_fat_golem_burst_debuff_Description"	"Stilnet."
"[english]DOTA_Tooltip_modifier_fat_golem_burst_debuff_Description"	"Silenced."
"DOTA_Tooltip_modifier_skeleton_mage_grenade_Description"	"Tar periodisk skade."
"[english]DOTA_Tooltip_modifier_skeleton_mage_grenade_Description"	"Taking periodic damage."
"DOTA_Tooltip_Ability_trap_room_sprint_Description"	"Gir ekstra bevegelseshastighet."
"[english]DOTA_Tooltip_Ability_trap_room_sprint_Description"	"Grants you bonus movement speed."
"DOTA_Tooltip_Ability_trap_room_sprint_duration"	"VARIGHET:"
"[english]DOTA_Tooltip_Ability_trap_room_sprint_duration"	"DURATION:"
"DOTA_Tooltip_Ability_trap_room_sprint_bonus_movespeed_pct"	"%EKSTRA BEVEGELSESHASTIGHET:"
"[english]DOTA_Tooltip_Ability_trap_room_sprint_bonus_movespeed_pct"	"%BONUS MOVESPEED:"
"DOTA_Tooltip_modifier_trap_room_sprint_Description"	"Enheten har økt bevegelseshastighet."
"[english]DOTA_Tooltip_modifier_trap_room_sprint_Description"	"This unit has increased movespeed."
"DOTA_Tooltip_Ability_trap_room_phase_shift_Description"	"Trosser alle fysiske dimensjoner i en kort periode."
"[english]DOTA_Tooltip_Ability_trap_room_phase_shift_Description"	"Briefly defy all physical dimensions."
"DOTA_Tooltip_Ability_trap_room_phase_shift_duration"	"VARIGHET:"
"[english]DOTA_Tooltip_Ability_trap_room_phase_shift_duration"	"DURATION:"
"DOTA_Tooltip_modifier_trap_room_phase_shift_Description"	"Enheten befinner seg midlertidig utenfor verden."
"[english]DOTA_Tooltip_modifier_trap_room_phase_shift_Description"	"This unit is temporarily out of world."
"DOTA_Tooltip_Ability_trap_room_invuln_Description"	"Beskytter målet ditt med udødelighet."
"[english]DOTA_Tooltip_Ability_trap_room_invuln_Description"	"Protect your target with invulnerability."
"DOTA_Tooltip_Ability_trap_room_invuln_duration"	"VARIGHET:"
"[english]DOTA_Tooltip_Ability_trap_room_invuln_duration"	"DURATION:"
"DOTA_Tooltip_modifier_trap_room_invuln_Description"	"Enheten er udødelig."
"[english]DOTA_Tooltip_modifier_trap_room_invuln_Description"	"This unit is invulnerable."
"DOTA_Tooltip_Ability_aghsfort_trap_room_hookshot_Description"	"Sender ut en krok som fester seg til den første enheten den treffer, og drar deg mot den. Maks rekkevidde: %abilitycastrange%."
"[english]DOTA_Tooltip_Ability_aghsfort_trap_room_hookshot_Description"	"Sends out a hook that latches to the first unit it hits, pulling you to it. Max range: %abilitycastrange%."
"DOTA_Tooltip_Ability_aghsfort_trap_room_hookshot_abilitycastrange"	"REKKEVIDDE:"
"[english]DOTA_Tooltip_Ability_aghsfort_trap_room_hookshot_abilitycastrange"	"RANGE:"
"DOTA_Tooltip_Ability_aghsfort_trap_room_meathook_Description"	"Kaster en blodig krok mot en fiende eller et område. Kroken fester seg til den første enheten den treffer, og haler den inn."
"[english]DOTA_Tooltip_Ability_aghsfort_trap_room_meathook_Description"	"Launches a bloody hook toward a unit or location. The hook will snag the first unit it encounters, dragging it in."
"DOTA_Tooltip_Ability_aghsfort_trap_room_meathook_abilitycastrange"	"REKKEVIDDE:"
"[english]DOTA_Tooltip_Ability_aghsfort_trap_room_meathook_abilitycastrange"	"RANGE:"
"DOTA_Tooltip_modifier_aghsfort_arc_warden_boss_flux_Description"	"Hemmet og tar skade når den ikke er i nærheten av en alliert enhet."
"[english]DOTA_Tooltip_modifier_aghsfort_arc_warden_boss_flux_Description"	"Slowed and taking damage when not near a friendly unit."
"DOTA_HUD_Depth"	"Dybde {d:depth} –"
"[english]DOTA_HUD_Depth"	"Depth {d:depth}  -"
"DOTA_RewardTooltip_WeeklyQuestStars"	"Ukentlige oppdragsstjerner"
"[english]DOTA_RewardTooltip_WeeklyQuestStars"	"Weekly Quest Stars"
"DOTA_HUD_ItemPurchase_Toast"	"{s:player_name} kjøpte {s:locstring_value}"
"[english]DOTA_HUD_ItemPurchase_Toast"	"{s:player_name} purchased {s:locstring_value}"
"DOTA_HUD_ItemPurchaseFail_Toast"	"{s:player_name} hadde ikke råd til {s:locstring_value}"
"[english]DOTA_HUD_ItemPurchaseFail_Toast"	"{s:player_name} could not afford {s:locstring_value}"
"DOTA_HUD_Decline_Toast"	"{s:player_name} avslo tilbudet."
"[english]DOTA_HUD_Decline_Toast"	"{s:player_name} declined the offer."
"DOTA_Hud_Tooltip_Outpost_EventTitle"	"Begivenhet"
"[english]DOTA_Hud_Tooltip_Outpost_EventTitle"	"Event"
"DOTA_Hud_Outpost_ChannelBar_EventTitle"	"Velger <font color='#f9cb4f'>BEGIVENHET</font>"
"[english]DOTA_Hud_Outpost_ChannelBar_EventTitle"	"Selecting <font color='#f9cb4f'>EVENT</font>"
"capture_outposts"	"Kapre utposter"
"[english]capture_outposts"	"Capture Outposts"
"destroy_candy_well"	"Ødelegg godteribrønnen"
"[english]destroy_candy_well"	"Destroy the Candy Well"
"protect_eggs"	"Beskytt drageeggene"
"[english]protect_eggs"	"Protect the Dragon Eggs"
"rescue_penguins"	"Sett pingvinene fri"
"[english]rescue_penguins"	"Free the Penguins"
"objective_saddle_up_on_hoodwink"	"Forvandle deg til Hoodwink!"
"[english]objective_saddle_up_on_hoodwink"	"Transform into Hoodwink!"
"objective_shoot_the_balloons"	"Treff ballongene! Unngå rottene!"
"[english]objective_shoot_the_balloons"	"Hit the Balloons! Avoid the Rats!"
"objective_crypt_gate_stand_on_switches"	"Stå på brytere for å åpne porten"
"[english]objective_crypt_gate_stand_on_switches"	"Stand on Switches to Open Gate"
"objective_smash_the_chickens"	"Knus kyllingene for gull!"
"[english]objective_smash_the_chickens"	"Smash the Chickens For Gold!"
"free_slardar_prisoners"	"Sett fangene fri"
"[english]free_slardar_prisoners"	"Free the Prisoners"
"DOTA_HUD_EncounterGaolers_RescuedPrisoner"	"Du har mottatt {d:int_value} <panel class='CombatEventGoldIcon'/> for å redde {s:locstring_value}!"
"[english]DOTA_HUD_EncounterGaolers_RescuedPrisoner"	"You received {d:int_value} <panel class='CombatEventGoldIcon'/> for rescuing {s:locstring_value}!"
"npc_dota_creature_event_small_tiny"	"Små-Stein Røys"
"[english]npc_dota_creature_event_small_tiny"	"Pebble Tossington"
"npc_dota_creature_event_big_tiny"	"Kampe-Stein Røys"
"[english]npc_dota_creature_event_big_tiny"	"Cobble Tossington"
"DOTA_Hud_EventAlchemist_StealGold"	"{s:player_name} stjal {d:int_value} <panel class='CombatEventGoldIcon'/> fra Calbert!"
"[english]DOTA_Hud_EventAlchemist_StealGold"	"{s:player_name} stole {d:int_value} <panel class='CombatEventGoldIcon'/> from Calbert!"
"npc_dota_creature_event_life_roshan_decline"	"SIKKER DØD"
"[english]npc_dota_creature_event_life_roshan_decline"	"CERTAIN DOOM"
"npc_dota_creature_event_life_roshan_1"	"<i>En smakebit på udødelighet</i><br>Kjøp <font color='#7367ff'>{s:item_name}</font>"
"[english]npc_dota_creature_event_life_roshan_1"	"<i>A single bite of Immortality</i><br>Purchase <font color='#7367ff'>{s:item_name}</font>"
"npc_dota_creature_event_life_roshan_4"	"<i>En urgammel glødende nøkkel</i><br>Kjøp <font color='#7367ff'>{s:item_name}</font>"
"[english]npc_dota_creature_event_life_roshan_4"	"<i>An ancient glowing key</i><br>Purchase <font color='#7367ff'>{s:item_name}</font>"
"DOTA_HUD_LifeRoshan_item_life_rune"	"{s:player_name} er nå forsikret med et ekstra liv."
"[english]DOTA_HUD_LifeRoshan_item_life_rune"	"{s:player_name} is now insured with an extra Life"
"DOTA_HUD_LifeRoshan_item_cheese"	"{s:player_name} var sulten og kjøpte Cheese."
"[english]DOTA_HUD_LifeRoshan_item_cheese"	"{s:player_name} was hungry and bought a Cheese"
"DOTA_HUD_LifeRoshan_item_cursed_key"	"{s:player_name} har lyst til å løfte forbannelsen med Continuum Key."
"[english]DOTA_HUD_LifeRoshan_item_cursed_key"	"{s:player_name} wants to lift the curse with a Continuum Key"
"speak_to_npc_dota_creature_morphling_event"	"Snakk med Lord of Liquid"
"[english]speak_to_npc_dota_creature_morphling_event"	"Speak to the Lord of Liquid"
"DOTA_Tooltip_modifier_tinker_event_range_retrofit_Description"	"Bruksrekkevidde endret av %dMODIFIER_PROPERTY_CAST_RANGE_BONUS_STACKING%. Angrepsrekkevidde endret av %dMODIFIER_PROPERTY_ATTACK_RANGE_BONUS%"
"[english]DOTA_Tooltip_modifier_tinker_event_range_retrofit_Description"	"Cast range modified by %dMODIFIER_PROPERTY_CAST_RANGE_BONUS_STACKING%.  Attack range modified by %dMODIFIER_PROPERTY_ATTACK_RANGE_BONUS%"
"DOTA_HUD_TinkerEvent_AcceptAttackRange"	"{s:player_name} økte angrepsrekkevidde med {d:int_value} og minsket bruksrekkevidde med {d:int_value2} fra Clinker!"
"[english]DOTA_HUD_TinkerEvent_AcceptAttackRange"	"{s:player_name} gained {d:int_value} Attack Range and lost {d:int_value2} Cast Range from Clinker!"
"DOTA_Tooltip_modifier_event_ogre_magi_casino_bloodlust_Description"	"Får %dMODIFIER_PROPERTY_MOVESPEED_BONUS_PERCENTAGE% %% ekstra bevegelseshastighet og %dMODIFIER_PROPERTY_ATTACKSPEED_BONUS_CONSTANT% ekstra angrepshastighet under %dMODIFIER_PROPERTY_TOOLTIP% flere kamper."
"[english]DOTA_Tooltip_modifier_event_ogre_magi_casino_bloodlust_Description"	"Gaining %dMODIFIER_PROPERTY_MOVESPEED_BONUS_PERCENTAGE%%% bonus movement speed and %dMODIFIER_PROPERTY_ATTACKSPEED_BONUS_CONSTANT% bonus attack speed for %dMODIFIER_PROPERTY_TOOLTIP% more combat encounters."
"DOTA_Hud_EventOgreMagi_GambleGold_Jackpot"	"{s:player_name} trillet terninger med Glarf og vant førstepremien på {d:int_value} <panel class='CombatEventGoldIcon'/>!"
"[english]DOTA_Hud_EventOgreMagi_GambleGold_Jackpot"	"{s:player_name} rolled the dice with Glarf and won the jackpot of {d:int_value} <panel class='CombatEventGoldIcon'/>!"
"DOTA_Tooltip_modifier_event_leshrac_pulse_nova_Description"	"Produserer en skadelig pulsering som gjør %dMODIFIER_PROPERTY_TOOLTIP%x av brukerens intelligens som skade i en radius på 525. Nedkjøling: 10 s."
"[english]DOTA_Tooltip_modifier_event_leshrac_pulse_nova_Description"	"Generates a damaging pulse that deals %dMODIFIER_PROPERTY_TOOLTIP%x of caster's Intelligence as damage in 525 radius. Cooldown: 10s."
"DOTA_HUD_EventLeshrac_NoHeal"	"{s:player_name} mente det var lurt å motta Ash's Affliction."
"[english]DOTA_HUD_EventLeshrac_NoHeal"	"{s:player_name} found it wise to receive Ash's Affliction."
"DOTA_HUD_EventLeshrac_PulseNova"	"{s:player_name} føler en pulserende glød inni seg."
"[english]DOTA_HUD_EventLeshrac_PulseNova"	"{s:player_name} feels a pulsing glow within."
"npc_dota_creature_event_necrophos_1"	"<i>Spå innvoller</i><br>Få et skår."
"[english]npc_dota_creature_event_necrophos_1"	"<i>Study Entrails</i><br>Gain a shard."
"DOTA_HUD_EventNecrophos_GetShard"	"{s:player_name} holdt kroppen sin intakt og fikk et skår."
"[english]DOTA_HUD_EventNecrophos_GetShard"	"{s:player_name} kept their body intact and gained a shard."
"DOTA_Tooltip_modifier_aghsfort_swamp_sickness_Description"	"Bevegelseshastighet redusert med %dMODIFIER_PROPERTY_MOVESPEED_BONUS_PERCENTAGE% %%."
"[english]DOTA_Tooltip_modifier_aghsfort_swamp_sickness_Description"	"Movement speed reduced by %dMODIFIER_PROPERTY_MOVESPEED_BONUS_PERCENTAGE%%%."
"DOTA_Tooltip_modifier_aghsfort_arc_warden_boss_spark_wraith_missile_target_Description"	"Dempet, stilnet og avvæpnet av en Spark Wraith på jakt."
"[english]DOTA_Tooltip_modifier_aghsfort_arc_warden_boss_spark_wraith_missile_target_Description"	"Muted, silenced, and disarmed by a hunting Spark Wraith."
"DOTA_Tooltip_modifier_aghsfort_arc_warden_boss_tempest_double"	"Klonet"
"[english]DOTA_Tooltip_modifier_aghsfort_arc_warden_boss_tempest_double"	"Cloned"
"DOTA_Tooltip_modifier_aghsfort_arc_warden_boss_tempest_double_Description"	"Bare en kopi, men fremdeles ganske farlig."
"[english]DOTA_Tooltip_modifier_aghsfort_arc_warden_boss_tempest_double_Description"	"A mere copy, but still quite dangerous."
"DOTA_Tooltip_modifier_aghsfort_arc_warden_boss_magnetic_field_attack_speed_Description"	"Gir total unnvikelse fra angrep utenfor feltet."
"[english]DOTA_Tooltip_modifier_aghsfort_arc_warden_boss_magnetic_field_attack_speed_Description"	"Granting total evasion from attacks outside the field."
"DOTA_Tooltip_modifier_acid_blob_explosion_slow_Description"	"Hastighet redusert fra en syreeksplosjon."
"[english]DOTA_Tooltip_modifier_acid_blob_explosion_slow_Description"	"Reduced speed from an acidic explosion."
"DOTA_Tooltip_ability_item_naginata_Description"	"<h1>Passiv: Omen</h1>Gir hvert angrep en %bonus_chance% %% sjanse til å redusere alle nedkjølinger med %cooldown_reduction_percent% %%."
"[english]DOTA_Tooltip_ability_item_naginata_Description"	"<h1>Passive: Omen</h1>Grants each attack a %bonus_chance%%% chance to reduce all cooldowns by %cooldown_reduction_percent%%%."
"DOTA_Tooltip_ability_item_naginata_bonus_intellect"	"+$int"
"[english]DOTA_Tooltip_ability_item_naginata_bonus_intellect"	"+$int"
"DOTA_Tooltip_ability_item_naginata_bonus_attack_speed"	"+$attack"
"[english]DOTA_Tooltip_ability_item_naginata_bonus_attack_speed"	"+$attack"
"Aghanim_QuestStarFound"	"Laget har funnet en <font color='#4ae0bf'>ukentlig oppdragsstjerne</font>!"
"[english]Aghanim_QuestStarFound"	"The team has found a <font color='#4ae0bf'>Weekly Quest Star</font>!"
"Aghanim_WaitForOtherPlayers"	"{s:player_name} prøvde å snakke med Aghanim før de andre heltene ankom. Vent på dem!"
"[english]Aghanim_WaitForOtherPlayers"	"{s:player_name} tried to talk to Aghanim before the other Heroes arrived. Please wait for them!"
"Aghanim_PlayerTrapRoomComplete"	"{s:player_name} fullførte fellerommet og tjente <font color='#ffd825'>{d:int_value}</font><panel class='CombatEventGoldIcon'/>."
"[english]Aghanim_PlayerTrapRoomComplete"	"{s:player_name} finished the trap room and earned <font color='#ffd825'>{d:int_value}</font><panel class='CombatEventGoldIcon'/>."
"Aghanim_PlayerTrapRoomComplete_NoDeath"	"{s:player_name} fullførte fellerommet uten å dø og tjente <font color='#ffd825'>{d:int_value}</font><panel class='CombatEventGoldIcon'/> – nais."
"[english]Aghanim_PlayerTrapRoomComplete_NoDeath"	"{s:player_name} finished the trap room without dying and earned <font color='#ffd825'>{d:int_value}</font><panel class='CombatEventGoldIcon'/> - Nice."
"Aghanim_PlayerTrapRoomComplete_Perfect"	"{s:player_name} fullførte fellerommet perfekt og tjente <font color='#ffd825'>{d:int_value}</font><panel class='CombatEventGoldIcon'/> – du verden!"
"[english]Aghanim_PlayerTrapRoomComplete_Perfect"	"{s:player_name} finished the trap room perfectly and earned <font color='#ffd825'>{d:int_value}</font><panel class='CombatEventGoldIcon'/> - Wow!"
"DOTA_Tooltip_ability_item_travel_boots_Description"	"Ekstra bevegelseshastighet fra flere støvler stables ikke."
"[english]DOTA_Tooltip_ability_item_travel_boots_Description"	"Movement speed bonuses from multiple pairs of boots do not stack."
"DOTA_Tooltip_ability_item_travel_boots_bonus_movement_speed"	"+$move_speed"
"[english]DOTA_Tooltip_ability_item_travel_boots_bonus_movement_speed"	"+$move_speed"
"DOTA_Tooltip_ability_item_travel_boots_tp_cooldown"	""
"[english]DOTA_Tooltip_ability_item_travel_boots_tp_cooldown"	""
"DOTA_Tooltip_ability_item_travel_boots_2_Description"	"Ekstra bevegelseshastighet fra flere støvler stables ikke."
"[english]DOTA_Tooltip_ability_item_travel_boots_2_Description"	"Movement speed bonuses from multiple pairs of boots do not stack."
"DOTA_Tooltip_ability_item_travel_boots_2_bonus_movement_speed"	"+$move_speed"
"[english]DOTA_Tooltip_ability_item_travel_boots_2_bonus_movement_speed"	"+$move_speed"
"DOTA_Tooltip_ability_item_travel_boots_2_tp_cooldown"	""
"[english]DOTA_Tooltip_ability_item_travel_boots_2_tp_cooldown"	""
"DOTA_Tooltip_modifier_aghsfort_venomancer_poison_nova"	"Poison Nova"
"[english]DOTA_Tooltip_modifier_aghsfort_venomancer_poison_nova"	"Poison Nova"
"DOTA_Tooltip_modifier_aghsfort_venomancer_poison_nova_Description"	"Tar alvorlig ikke-dødelig skade over tid."
"[english]DOTA_Tooltip_modifier_aghsfort_venomancer_poison_nova_Description"	"Taking severe non-lethal damage over time."
"DOTA_Tooltip_modifier_aghsfort_venomancer_poison_sting"	"Poison Sting"
"[english]DOTA_Tooltip_modifier_aghsfort_venomancer_poison_sting"	"Poison Sting"
"DOTA_Tooltip_modifier_aghsfort_venomancer_poison_sting_Description"	"Tar litt skade over tid."
"[english]DOTA_Tooltip_modifier_aghsfort_venomancer_poison_sting_Description"	"Taking slight damage over time."
"DOTA_HUD_Curse_Lifted"	"{s:player_name} har fått løftet en kontinuumsforbannelse!"
"[english]DOTA_HUD_Curse_Lifted"	"{s:player_name} has had a Continuum Curse lifted!"
"DOTA_Tooltip_modifier_kunkka_tidebringer_Description"	"Fysisk skade økt med %dMODIFIER_PROPERTY_PREATTACK_BONUS_DAMAGE% med et angrep som kløyver."
"[english]DOTA_Tooltip_modifier_kunkka_tidebringer_Description"	"Physical damage increased by %dMODIFIER_PROPERTY_PREATTACK_BONUS_DAMAGE% with a cleaving attack."
"DOTA_Tooltip_modifier_kunkka_torrent_slow"	"Torrent – hemming"
"[english]DOTA_Tooltip_modifier_kunkka_torrent_slow"	"Torrent Slow"
"DOTA_Tooltip_modifier_kunkka_torrent_slow_Description"	"Bevegelse hemmet med %dMODIFIER_PROPERTY_MOVESPEED_BONUS_PERCENTAGE% %%"
"[english]DOTA_Tooltip_modifier_kunkka_torrent_slow_Description"	"Movement speed slowed by %dMODIFIER_PROPERTY_MOVESPEED_BONUS_PERCENTAGE%%%"
"DOTA_Tooltip_modifier_kunkka_ghost_ship_damage_absorb_Description"	"Du er full! Bevegelseshastighet økt med %dMODIFIER_PROPERTY_MOVESPEED_BONUS_PERCENTAGE% %%, og du føler midlertidig ikke innkommende skade."
"[english]DOTA_Tooltip_modifier_kunkka_ghost_ship_damage_absorb_Description"	"You're drunk! Movement speed increased by %dMODIFIER_PROPERTY_MOVESPEED_BONUS_PERCENTAGE%%%, temporary numbness to incoming damage."
"DOTA_Tooltip_modifier_kunkka_ghost_ship_damage_delay_Description"	"Du blir edru igjen. Du føler gradvis skaden som ble påført mens du var beruset av admiralens rom."
"[english]DOTA_Tooltip_modifier_kunkka_ghost_ship_damage_delay_Description"	"Sobering up. Gradually feeling the rest of the damage taken while under the effects of The Admiral's Rum."
"DOTA_Tooltip_modifier_kunkka_ghost_ship_loaded_Description"	"Du er lastet på Kunkkas spøkelsesskip!"
"[english]DOTA_Tooltip_modifier_kunkka_ghost_ship_loaded_Description"	"You are loaded on Kunkka's Ghost Ship!"
"DOTA_Tooltip_modifier_kunkka_x_marks_the_spot_Description"	"Du vender tilbake til der krysset er plassert."
"[english]DOTA_Tooltip_modifier_kunkka_x_marks_the_spot_Description"	"You will be returned to the location of the X"
"DOTA_Tooltip_ability_item_aghsfort_creature_blade_mail_Description"	"<h1>Aktiv: Damage Return</h1>I %duration% sekunder økes skade som returneres fra alle kilder med %active_reflection_pct% %%."
"[english]DOTA_Tooltip_ability_item_aghsfort_creature_blade_mail_Description"	"<h1>Active: Damage Return</h1>For %duration% seconds, the damage returned from all sources is increased by %active_reflection_pct%%%."
"DOTA_Tooltip_ability_item_aghsfort_creature_blade_mail_Note0"	"Damage Return regnes ut før reduksjon."
"[english]DOTA_Tooltip_ability_item_aghsfort_creature_blade_mail_Note0"	"Damage Return is calculated before any kind of reduction."
"DOTA_Tooltip_ability_item_aghsfort_creature_blade_mail_Note2"	"Typen skade som returneres er den samme som den som ble mottatt."
"[english]DOTA_Tooltip_ability_item_aghsfort_creature_blade_mail_Note2"	"Returned damage type is the same as it was received."
"DOTA_Tooltip_ability_item_aghsfort_creature_blade_mail_bonus_damage"	"+$damage"
"[english]DOTA_Tooltip_ability_item_aghsfort_creature_blade_mail_bonus_damage"	"+$damage"
"DOTA_Tooltip_ability_item_aghsfort_creature_blade_mail_bonus_armor"	"+$armor"
"[english]DOTA_Tooltip_ability_item_aghsfort_creature_blade_mail_bonus_armor"	"+$armor"
"DOTA_Tooltip_modifier_aghsfort_special_void_spirit_astral_step_breach_burn_Description"	"Tar skade over tid."
"[english]DOTA_Tooltip_modifier_aghsfort_special_void_spirit_astral_step_breach_burn_Description"	"Taking damage over time."
}
}
