"lang"
{
"Language"	"brazilian"
"Tokens"
{
"addon_game_name"	"Quebralama"
"[english]addon_game_name"	"Siltbreaker"
"DOTA_GameMode_15"	"Quebralama"
"[english]DOTA_GameMode_15"	"Siltbreaker"
"DOTA_GameMode_19"	"Quebralama"
"[english]DOTA_GameMode_19"	"Siltbreaker"
"DOTA_Tooltip_Ability_item_health_potion"	"Poção de Vida"
"[english]DOTA_Tooltip_Ability_item_health_potion"	"Health Potion"
"DOTA_Tooltip_Ability_item_mana_potion"	"Poção de Mana"
"[english]DOTA_Tooltip_Ability_item_mana_potion"	"Mana Potion"
"DOTA_Tooltip_ability_item_bag_of_gold"	"Bolsa de Ouro"
"[english]DOTA_Tooltip_ability_item_bag_of_gold"	"Bag of Gold"
"DOTA_Tooltip_Ability_item_life_rune"	"Runa de Vida"
"[english]DOTA_Tooltip_Ability_item_life_rune"	"Life Rune"
"DOTA_Tooltip_ability_item_book_of_strength"	"Livro de Força"
"[english]DOTA_Tooltip_ability_item_book_of_strength"	"Book of Strength"
"DOTA_Tooltip_ability_item_book_of_strength_Description"	"Em inglês: <font color='#F2A93E'>Book of Strength</font>\n \nFornece um bônus permanente de 3 de Força quando consumido."
"[english]DOTA_Tooltip_ability_item_book_of_strength_Description"	"Consume to gain 3 Strength permanently."
"DOTA_Tooltip_ability_item_book_of_agility"	"Livro de Agilidade"
"[english]DOTA_Tooltip_ability_item_book_of_agility"	"Book of Agility"
"DOTA_Tooltip_ability_item_book_of_agility_Description"	"Em inglês: <font color='#F2A93E'>Book of Agility</font>\n \nFornece um bônus permanente de 3 de Agilidade quando consumido."
"[english]DOTA_Tooltip_ability_item_book_of_agility_Description"	"Consume to gain 3 Agility permanently."
"DOTA_Tooltip_ability_item_book_of_intelligence"	"Livro de Inteligência"
"[english]DOTA_Tooltip_ability_item_book_of_intelligence"	"Book of Intelligence"
"DOTA_Tooltip_ability_item_book_of_intelligence_Description"	"Em inglês: <font color='#F2A93E'>Book of Intelligence</font>\n \nFornece um bônus permanente de 3 de Inteligência quando consumido."
"[english]DOTA_Tooltip_ability_item_book_of_intelligence_Description"	"Consume to gain 3 Intelligence permanently."
"DOTA_Tooltip_ability_item_creed_of_omniscience"	"<font color=\"#4ae0bf\">Credo da Onisciência</font>"
"[english]DOTA_Tooltip_ability_item_creed_of_omniscience"	"<font color=\"#4ae0bf\">Creed of Omniscience</font>"
"DOTA_Tooltip_ability_item_creed_of_omniscience_Description"	"Em inglês: <font color='#F2A93E'>Creed of Omniscience</font>\n \nRequer nível: %required_level%\n\nPassivo: Fornece experiência adicional.\n"
"[english]DOTA_Tooltip_ability_item_creed_of_omniscience_Description"	"Required Level: %required_level%\n\nPassive: Grants bonus experience.\n"
"DOTA_Tooltip_ability_item_creed_of_omniscience_bonus_xp"	"%EXP ADICIONAL:"
"[english]DOTA_Tooltip_ability_item_creed_of_omniscience_bonus_xp"	"%BONUS XP:"
"DOTA_Tooltip_ability_item_creed_of_omniscience_Lore"	"A Onisciência me honra!"
"[english]DOTA_Tooltip_ability_item_creed_of_omniscience_Lore"	"The Omniscience honors me!"
"DOTA_Tooltip_ability_item_oblivions_locket"	"<font color=\"#4ae0bf\">Medalhão do Esquecimento</font>"
"[english]DOTA_Tooltip_ability_item_oblivions_locket"	"<font color=\"#4ae0bf\">Oblivion's Locket</font>"
"DOTA_Tooltip_ability_item_oblivions_locket_Description"	"Em inglês: <font color='#F2A93E'>Oblivion's Locket</font>\n \nRequer nível: %required_level%\n\nAtivo: Espectro — CANALIZADO — Torna-se etéreo, imune a dano físico, mas sofre mais %extra_spell_damage_percent%%% de dano mágico por até 1 segundo.\n"
"[english]DOTA_Tooltip_ability_item_oblivions_locket_Description"	"Required Level: %required_level%\n\nActive: Spook - CHANNELLED - Become ethereal, immune to physical but taking %extra_spell_damage_percent%%% extra magic damage for up to 1 second.\n"
"DOTA_Tooltip_ability_item_oblivions_locket_bonus_all_stats"	"ATRIBUTOS ADICIONAIS:"
"[english]DOTA_Tooltip_ability_item_oblivions_locket_bonus_all_stats"	"BONUS ALL STATS:"
"DOTA_Tooltip_ability_item_oblivions_locket_Lore"	"O amuleto de um esqueleto. Usado para evitar passar por maus lençóis."
"[english]DOTA_Tooltip_ability_item_oblivions_locket_Lore"	"A skeleton's charm. Used to prevent having a bad time."
"DOTA_Tooltip_ability_item_pelt_of_the_old_wolf"	"<font color=\"#4ae0bf\">Pele do Velho Lobo</font>"
"[english]DOTA_Tooltip_ability_item_pelt_of_the_old_wolf"	"<font color=\"#4ae0bf\">Pelt of the Old Wolf</font>"
"DOTA_Tooltip_ability_item_pelt_of_the_old_wolf_Description"	"Em inglês: <font color='#F2A93E'>Pelt of the Old Wolf</font>\n \nRequer nível: %required_level%"
"[english]DOTA_Tooltip_ability_item_pelt_of_the_old_wolf_Description"	"Required Level: %required_level%"
"DOTA_Tooltip_ability_item_pelt_of_the_old_wolf_Lore"	"A selva pode ser um lugar traiçoeiro; nunca baixe a guarda."
"[english]DOTA_Tooltip_ability_item_pelt_of_the_old_wolf_Lore"	"The wild can be a treachorous place; don't let your guard down."
"DOTA_Tooltip_ability_item_pelt_of_the_old_wolf_bonus_armor"	"ARMADURA ADICIONAL:"
"[english]DOTA_Tooltip_ability_item_pelt_of_the_old_wolf_bonus_armor"	"BONUS ARMOR:"
"DOTA_Tooltip_ability_item_pelt_of_the_old_wolf_bonus_move_speed"	"VELOCIDADE DE MOVIMENTO ADICIONAL:"
"[english]DOTA_Tooltip_ability_item_pelt_of_the_old_wolf_bonus_move_speed"	"BONUS MOVE SPEED:"
"DOTA_Tooltip_ability_item_pelt_of_the_old_wolf_bonus_evasion"	"%ESQUIVA ADICIONAL:"
"[english]DOTA_Tooltip_ability_item_pelt_of_the_old_wolf_bonus_evasion"	"%BONUS EVASION:"
"DOTA_Tooltip_ability_item_paw_of_lucius"	"<font color=\"#4ae0bf\">Garra de Lucius</font>"
"[english]DOTA_Tooltip_ability_item_paw_of_lucius"	"<font color=\"#4ae0bf\">Paw of Lucius</font>"
"DOTA_Tooltip_ability_item_paw_of_lucius_Description"	"Em inglês: <font color='#F2A93E'>Paw of Lucius</font>\n \nRequer nível: %required_level%\n\nPassivo: Ataques têm %rupture_chance%%% de chance de causar uma Ruptura.\n"
"[english]DOTA_Tooltip_ability_item_paw_of_lucius_Description"	"Required Level: %required_level%\n\nPassive: Attacks have a %rupture_chance%%% chance to inflict Rupture.\n"
"DOTA_Tooltip_ability_item_paw_of_lucius_Lore"	"Essa garra tem um corte profundo."
"[english]DOTA_Tooltip_ability_item_paw_of_lucius_Lore"	"This claw cuts deep."
"DOTA_Tooltip_ability_item_paw_of_lucius_bonus_strength"	"FORÇA ADICIONAL:"
"[english]DOTA_Tooltip_ability_item_paw_of_lucius_bonus_strength"	"BONUS STRENGTH:"
"DOTA_Tooltip_ability_item_paw_of_lucius_bonus_attack_speed"	"VELOCIDADE DE ATAQUE ADICIONAL:"
"[english]DOTA_Tooltip_ability_item_paw_of_lucius_bonus_attack_speed"	"BONUS ATTACK SPEED:"
"DOTA_Tooltip_ability_item_longclaws_amulet"	"<font color=\"#4ae0bf\">Amuleto de Garralonga</font>"
"[english]DOTA_Tooltip_ability_item_longclaws_amulet"	"<font color=\"#4ae0bf\">Longclaw's Amulet</font>"
"DOTA_Tooltip_ability_item_longclaws_amulet_Description"	"Em inglês: <font color='#F2A93E'>Longclaw's Amulet</font>\n \nRequer nível: %required_level%\n"
"[english]DOTA_Tooltip_ability_item_longclaws_amulet_Description"	"Required Level: %required_level%\n"
"DOTA_Tooltip_ability_item_longclaws_amulet_Lore"	"Magia é algo incomum na Mata, os seus segredos são guardados com cuidado."
"[english]DOTA_Tooltip_ability_item_longclaws_amulet_Lore"	"Magic is somewhat uncommon in the Weald, its secrets closely guarded."
"DOTA_Tooltip_ability_item_longclaws_amulet_spell_lifesteal_pct"	"%ROUBO DE VIDA MÁGICO:"
"[english]DOTA_Tooltip_ability_item_longclaws_amulet_spell_lifesteal_pct"	"%SPELL LIFESTEAL:"
"DOTA_Tooltip_ability_item_longclaws_amulet_cooldown_reduction_pct"	"%REDUÇÃO DE INTERVALO:"
"[english]DOTA_Tooltip_ability_item_longclaws_amulet_cooldown_reduction_pct"	"%COOLDOWN REDUCTION:"
"DOTA_Tooltip_ability_item_longclaws_amulet_mana_cost_reduction_pct"	"%REDUÇÃO DE CUSTO DE MANA:"
"[english]DOTA_Tooltip_ability_item_longclaws_amulet_mana_cost_reduction_pct"	"%MANA COST REDUCTION:"
"DOTA_Tooltip_ability_item_bogduggs_cudgel"	"<font color=\"#4ae0bf\">Clava de Bogdugg</font>"
"[english]DOTA_Tooltip_ability_item_bogduggs_cudgel"	"<font color=\"#4ae0bf\">Bogdugg's Cudgel</font>"
"DOTA_Tooltip_ability_item_bogduggs_cudgel_Description"	"Em inglês: <font color='#F2A93E'>Bogdugg's Cudgel</font>\n \nRequer nível: %required_level%\n\nPassivo: Esmagar — APENAS PARA HERÓIS CORPO A CORPO — A velocidade de todos os ataques é cortada pela metade, mas ataques causam dano em um raio de %damage_radius% unidades ao redor do alvo e atordoam por %stun_duration% segundo.\n"
"[english]DOTA_Tooltip_ability_item_bogduggs_cudgel_Description"	"Required Level: %required_level%\n\nPassive: Smash - MELEE ONLY - All attack speed is halved, but attacks deal splash damage in a %damage_radius% area around the target and stun for %stun_duration% second.\n"
"DOTA_Tooltip_ability_item_bogduggs_cudgel_Lore"	"Bogdugg tornou-se o líder da Serra dos Ossos por portar a maior clava."
"[english]DOTA_Tooltip_ability_item_bogduggs_cudgel_Lore"	"Bogdugg came to lord over Bonemeal Ridge by carrying the biggest stick."
"DOTA_Tooltip_ability_item_bogduggs_cudgel_bonus_strength"	"FORÇA ADICIONAL:"
"[english]DOTA_Tooltip_ability_item_bogduggs_cudgel_bonus_strength"	"BONUS STRENGTH:"
"DOTA_Tooltip_ability_item_bogduggs_cudgel_bonus_damage"	"DANO ADICIONAL:"
"[english]DOTA_Tooltip_ability_item_bogduggs_cudgel_bonus_damage"	"BONUS DAMAGE:"
"DOTA_Tooltip_ability_item_bogduggs_baldric"	"<font color=\"#4ae0bf\">Cinturão de Bogdugg</font>"
"[english]DOTA_Tooltip_ability_item_bogduggs_baldric"	"<font color=\"#4ae0bf\">Bogdugg's Baldric</font>"
"DOTA_Tooltip_ability_item_bogduggs_baldric_Description"	"Em inglês: <font color='#F2A93E'>Bogdugg's Baldric</font>\n \nRequer nível: %required_level%\n"
"[english]DOTA_Tooltip_ability_item_bogduggs_baldric_Description"	"Required Level: %required_level%\n"
"DOTA_Tooltip_ability_item_bogduggs_baldric_Lore"	"Correr não é tão divertido quanto bater. Nem um pouco."
"[english]DOTA_Tooltip_ability_item_bogduggs_baldric_Lore"	"Running's not as fun as hitting.  Not one bit."
"DOTA_Tooltip_ability_item_bogduggs_baldric_bonus_armor"	"ARMADURA ADICIONAL:"
"[english]DOTA_Tooltip_ability_item_bogduggs_baldric_bonus_armor"	"BONUS ARMOR:"
"DOTA_Tooltip_ability_item_bogduggs_baldric_disable_resist_pct"	"%REDUÇÃO DA DURAÇÃO DO ATORDOAMENTO:"
"[english]DOTA_Tooltip_ability_item_bogduggs_baldric_disable_resist_pct"	"%STUN DURATION REDUCTION:"
"DOTA_Tooltip_ability_item_bogduggs_baldric_move_speed_penalty"	"REDUÇÃO DE VELOCIDADE DE MOVIMENTO:"
"[english]DOTA_Tooltip_ability_item_bogduggs_baldric_move_speed_penalty"	"MOVE SPEED REDUCTION:"
"DOTA_Tooltip_ability_item_bogduggs_lucky_femur"	"<font color=\"#4ae0bf\">Fêmur da Sorte de Bogdugg</font>"
"[english]DOTA_Tooltip_ability_item_bogduggs_lucky_femur"	"<font color=\"#4ae0bf\">Bogdugg's Lucky Femur</font>"
"DOTA_Tooltip_ability_item_bogduggs_lucky_femur_Description"	"Em inglês: <font color='#F2A93E'>Bogdugg's Lucky Femur</font>\n \nRequer nível: %required_level%\n\nPassivo: Golpe de Habilidade — Após usar uma habilidade, há %refresh_pct%%% de chance desta ser imediatamente recarregada.\n"
"[english]DOTA_Tooltip_ability_item_bogduggs_lucky_femur_Description"	"Required Level: %required_level%\n\nPassive: Skillshot - After an ability is cast, it has a %refresh_pct%%% chance to be immediately refreshed.\n"
"DOTA_Tooltip_ability_item_bogduggs_lucky_femur_Lore"	"E mais outro!"
"[english]DOTA_Tooltip_ability_item_bogduggs_lucky_femur_Lore"	"And another!"
"DOTA_Tooltip_ability_item_bogduggs_lucky_femur_max_mana_penalty"	"REDUÇÃO MÁXIMA DO MANA:"
"[english]DOTA_Tooltip_ability_item_bogduggs_lucky_femur_max_mana_penalty"	"MAX MANA REDUCTION:"
"DOTA_Tooltip_ability_item_bogduggs_lucky_femur_intelligence_penalty"	"REDUÇÃO DE INTELIGÊNCIA:"
"[english]DOTA_Tooltip_ability_item_bogduggs_lucky_femur_intelligence_penalty"	"INTELLIGENCE REDUCTION:"
"DOTA_Tooltip_ability_item_bogduggs_lucky_femur_mana_regen_sec"	"REGENERAÇÃO DE MANA ADICIONAL:"
"[english]DOTA_Tooltip_ability_item_bogduggs_lucky_femur_mana_regen_sec"	"BONUS MANA REGEN:"
"DOTA_Tooltip_ability_item_sign_of_the_arachnid"	"<font color=\"#4ae0bf\">Símbolo do Aracnídeo</font>"
"[english]DOTA_Tooltip_ability_item_sign_of_the_arachnid"	"<font color=\"#4ae0bf\">Sign of the Arachnid</font>"
"DOTA_Tooltip_ability_item_sign_of_the_arachnid_Description"	"Em inglês: <font color='#F2A93E'>Sign of the Arachnid</font>\n \nRequer nível: %required_level%\n\nPassivo: Aura Aracnídea — Aliados recebem velocidades de movimento e ataque adicionais."
"[english]DOTA_Tooltip_ability_item_sign_of_the_arachnid_Description"	"Required Level: %required_level%\n\nPassive: Arachnid Aura - Allies gain bonus movement and attack speed."
"DOTA_Tooltip_ability_item_sign_of_the_arachnid_Lore"	"Uma marca sinistra dada aos seguidores do Caminho de Seda."
"[english]DOTA_Tooltip_ability_item_sign_of_the_arachnid_Lore"	"An ominous mark bestowed upon followers of the Silken Path."
"DOTA_Tooltip_ability_item_sign_of_the_arachnid_bonus_agility"	"AGILIDADE ADICIONAL:"
"[english]DOTA_Tooltip_ability_item_sign_of_the_arachnid_bonus_agility"	"BONUS AGILITY:"
"DOTA_Tooltip_ability_item_sign_of_the_arachnid_bonus_move_speed_pct"	"%VELOCIDADE DE MOVIMENTO ADICIONAL (AURA):"
"[english]DOTA_Tooltip_ability_item_sign_of_the_arachnid_bonus_move_speed_pct"	"%AURA BONUS MOVE SPEED:"
"DOTA_Tooltip_ability_item_sign_of_the_arachnid_attack_speed"	"VELOCIDADE DE ATAQUE ADICIONAL (AURA):"
"[english]DOTA_Tooltip_ability_item_sign_of_the_arachnid_attack_speed"	"AURA BONUS ATTACK SPEED:"
"DOTA_Tooltip_modifier_item_sign_of_the_arachnid_effect"	"Aura Aracnídea"
"[english]DOTA_Tooltip_modifier_item_sign_of_the_arachnid_effect"	"Arachnid Aura"
"DOTA_Tooltip_modifier_item_sign_of_the_arachnid_effect_Description"	"Recebendo velocidades de movimento e ataque adicionais."
"[english]DOTA_Tooltip_modifier_item_sign_of_the_arachnid_effect_Description"	"Gaining bonus movement and attack speed."
"DOTA_Tooltip_ability_item_unhallowed_icon"	"<font color=\"#4ae0bf\">Ícone Profano</font>"
"[english]DOTA_Tooltip_ability_item_unhallowed_icon"	"<font color=\"#4ae0bf\">Unhallowed Icon</font>"
"DOTA_Tooltip_ability_item_unhallowed_icon_Description"	"Em inglês: <font color='#F2A93E'>Unhallowed Icon</font>\n \nRequer nível: %required_level%\n\\Passivo: Aura da Ligação de Sangue — Aliados recebem regeneração de vida adicional. Quando uma unidade afetada pelo Ícone Profano ataca, %lifesteal_pct%%% do dano causado é roubado como vida e distribuído entre os afetados pela aura."
"[english]DOTA_Tooltip_ability_item_unhallowed_icon_Description"	"Required Level: %required_level%\n\nPassive: Bloodbond Aura - Allies gain bonus health regeneration. When any unit affected by Unhallowed Icon attacks, %lifesteal_pct%%% of the damage dealt is stolen as life and distributed among all affected by the aura."
"DOTA_Tooltip_ability_item_unhallowed_icon_Lore"	"Um ícone portado pelos protegidos do submundo."
"[english]DOTA_Tooltip_ability_item_unhallowed_icon_Lore"	"An Icon borne by the protected of the underworld."
"DOTA_Tooltip_ability_item_unhallowed_icon_bonus_strength"	"FORÇA ADICIONAL:"
"[english]DOTA_Tooltip_ability_item_unhallowed_icon_bonus_strength"	"BONUS STRENGTH:"
"DOTA_Tooltip_ability_item_unhallowed_icon_lifesteal_pct"	"%ROUBO DE VIDA COMPARTILHADO (AURA):"
"[english]DOTA_Tooltip_ability_item_unhallowed_icon_lifesteal_pct"	"%AURA LINKED LIFESTEAL:"
"DOTA_Tooltip_ability_item_unhallowed_icon_hp_regen"	"REGENERAÇÃO DE VIDA (AURA):"
"[english]DOTA_Tooltip_ability_item_unhallowed_icon_hp_regen"	"AURA HP REGEN:"
"DOTA_Tooltip_modifier_item_unhallowed_icon_effect"	"Aura da Ligação de Sangue"
"[english]DOTA_Tooltip_modifier_item_unhallowed_icon_effect"	"Bloodbond Aura"
"DOTA_Tooltip_modifier_item_unhallowed_icon_effect_Description"	"Recebendo regeneração de vida adicional. Ataques físicos roubam vida e a distribui entre os afetados pela Aura da Ligação de Sangue."
"[english]DOTA_Tooltip_modifier_item_unhallowed_icon_effect_Description"	"Gaining bonus HP regen. Physical attacks steal life and distribute it among others affected by Bloodbond Aura."
"DOTA_Tooltip_ability_item_preserved_skull"	"<font color=\"#4ae0bf\">Crânio Preservado</font>"
"[english]DOTA_Tooltip_ability_item_preserved_skull"	"<font color=\"#4ae0bf\">Preserved Skull</font>"
"DOTA_Tooltip_ability_item_preserved_skull_Description"	"Em inglês: <font color='#F2A93E'>Preserved Skull</font>\n \nRequer nível: %required_level%\n\nPassivo: Aura da Conjuração — Aliados recebem regeneração de mana adicional e redução no intervalo entre usos."
"[english]DOTA_Tooltip_ability_item_preserved_skull_Description"	"Required Level: %required_level%\n\nPassive: Conjuration Aura - Allies gain bonus mana regen and cooldown reduction."
"DOTA_Tooltip_ability_item_preserved_skull_Lore"	"Aonde você estava com a cabeça?"
"[english]DOTA_Tooltip_ability_item_preserved_skull_Lore"	"Where be your gibes now?"
"DOTA_Tooltip_ability_item_preserved_skull_bonus_intelligence"	"INTELIGÊNCIA ADICIONAL:"
"[english]DOTA_Tooltip_ability_item_preserved_skull_bonus_intelligence"	"BONUS INTELLIGENCE:"
"DOTA_Tooltip_ability_item_preserved_skull_cooldown_reduction_pct"	"%REDUÇÃO DE INTERVALO (AURA):"
"[english]DOTA_Tooltip_ability_item_preserved_skull_cooldown_reduction_pct"	"%AURA COOLDOWN REDUCTION:"
"DOTA_Tooltip_ability_item_preserved_skull_aura_mana_regen"	"REGENERAÇÃO DE MANA (AURA):"
"[english]DOTA_Tooltip_ability_item_preserved_skull_aura_mana_regen"	"AURA MANA REGEN:"
"DOTA_Tooltip_modifier_item_preserved_skull_effect"	"Aura da Conjuração"
"[english]DOTA_Tooltip_modifier_item_preserved_skull_effect"	"Conjuration Aura"
"DOTA_Tooltip_modifier_item_preserved_skull_effect_Description"	"Recebendo regeneração de mana adicional e redução de intervalo entre usos."
"[english]DOTA_Tooltip_modifier_item_preserved_skull_effect_Description"	"Gaining bonus mana regen and cooldown reduction."
"DOTA_Tooltip_ability_item_treads_of_ermacor"	"<font color=\"#4ae0bf\">Coturnos de Ermacor</font>"
"[english]DOTA_Tooltip_ability_item_treads_of_ermacor"	"<font color=\"#4ae0bf\">Treads of Ermacor</font>"
"DOTA_Tooltip_ability_item_treads_of_ermacor_Description"	"Em inglês: <font color='#F2A93E'>Treads of Ermacor</font>\n \nRequer nível: %required_level%\nVelocidades de movimento adicionais de múltiplas botas não se acumulam."
"[english]DOTA_Tooltip_ability_item_treads_of_ermacor_Description"	"Required Level: %required_level%\n\nFlat movement speed bonuses from multiple pairs of boots do not stack."
"DOTA_Tooltip_ability_item_treads_of_ermacor_Lore"	"Com a benção do Desbravador, encontraremos um caminho."
"[english]DOTA_Tooltip_ability_item_treads_of_ermacor_Lore"	"With the Pathfinder's blessing, we shall find a way."
"DOTA_Tooltip_ability_item_treads_of_ermacor_bonus_movement_speed"	"VELOCIDADE DE MOVIMENTO ADICIONAL:"
"[english]DOTA_Tooltip_ability_item_treads_of_ermacor_bonus_movement_speed"	"BONUS MOVEMENT SPEED:"
"DOTA_Tooltip_ability_item_treads_of_ermacor_bonus_attack_speed"	"VELOCIDADE DE ATAQUE ADICIONAL:"
"[english]DOTA_Tooltip_ability_item_treads_of_ermacor_bonus_attack_speed"	"BONUS ATTACK SPEED:"
"DOTA_Tooltip_ability_item_treads_of_ermacor_bonus_all_stats"	"ATRIBUTOS ADICIONAIS:"
"[english]DOTA_Tooltip_ability_item_treads_of_ermacor_bonus_all_stats"	"BONUS ALL STATS:"
"DOTA_Tooltip_ability_item_rhyziks_eye"	"<font color=\"#4ae0bf\">Olho de Rhyzik</font>"
"[english]DOTA_Tooltip_ability_item_rhyziks_eye"	"<font color=\"#4ae0bf\">Rhyzik's Eye</font>"
"DOTA_Tooltip_ability_item_rhyziks_eye_Description"	"Em inglês: <font color='#F2A93E'>Rhyzik's Eye</font>\n \nRequer nível: %required_level%\n"
"[english]DOTA_Tooltip_ability_item_rhyziks_eye_Description"	"Required Level: %required_level%\n"
"DOTA_Tooltip_ability_item_rhyziks_eye_Lore"	"Há poder no olho do Corruptor."
"[english]DOTA_Tooltip_ability_item_rhyziks_eye_Lore"	"There is power in the eye of the Corruptor."
"DOTA_Tooltip_ability_item_rhyziks_eye_bonus_all_stats"	"ATRIBUTOS ADICIONAIS:"
"[english]DOTA_Tooltip_ability_item_rhyziks_eye_bonus_all_stats"	"BONUS ALL STATS:"
"DOTA_Tooltip_ability_item_rhyziks_eye_bonus_damage_pct"	"%DANO ADICIONAL:"
"[english]DOTA_Tooltip_ability_item_rhyziks_eye_bonus_damage_pct"	"%BONUS DAMAGE:"
"DOTA_Tooltip_ability_item_rhyziks_eye_damage_reduction"	"%REDUÇÃO DE DANO SOFRIDO:"
"[english]DOTA_Tooltip_ability_item_rhyziks_eye_damage_reduction"	"%INCOMING DAMAGE REDUCTION:"
"DOTA_Tooltip_ability_item_rhyziks_eye_mana_regen_sec"	"REGENERAÇÃO DE MANA ADICIONAL:"
"[english]DOTA_Tooltip_ability_item_rhyziks_eye_mana_regen_sec"	"BONUS MANA REGEN:"
"DOTA_Tooltip_ability_item_rhyziks_eye_hp_regen_sec"	"REGENERAÇÃO DE VIDA ADICIONAL:"
"[english]DOTA_Tooltip_ability_item_rhyziks_eye_hp_regen_sec"	"BONUS HP REGEN:"
"DOTA_Tooltip_ability_item_guardian_shell"	"<font color=\"#4ae0bf\">Couraça do Guardião</font>"
"[english]DOTA_Tooltip_ability_item_guardian_shell"	"<font color=\"#4ae0bf\">Guardian Shell</font>"
"DOTA_Tooltip_ability_item_guardian_shell_Description"	"Em inglês: <font color='#F2A93E'>Guardian Shell</font>\n \nRequer nível: %required_level%\n\nPassivo: Irrefreável — A velocidade de movimento não pode ser reduzida e o portador não pode ser enraizado."
"[english]DOTA_Tooltip_ability_item_guardian_shell_Description"	"Required Level: %required_level%\n\nPassive: Unwavering - Movement Speed cannot be slowed and wearer cannot be rooted."
"DOTA_Tooltip_ability_item_guardian_shell_Lore"	"Avançar sempre, liberto de preocupações mortais."
"[english]DOTA_Tooltip_ability_item_guardian_shell_Lore"	"Push ever onward, unburdened by mortal cares."
"DOTA_Tooltip_ability_item_guardian_shell_bonus_armor"	"ARMADURA ADICIONAL:"
"[english]DOTA_Tooltip_ability_item_guardian_shell_bonus_armor"	"BONUS ARMOR:"
"DOTA_Tooltip_ability_item_guardian_shell_magic_resistance"	"%RESISTÊNCIA MÁGICA ADICIONAL:"
"[english]DOTA_Tooltip_ability_item_guardian_shell_magic_resistance"	"%BONUS MAGIC RESISTANCE:"
"DOTA_Tooltip_ability_item_watchers_gaze"	"<font color=\"#4ae0bf\">Olhar do Observador</font>"
"[english]DOTA_Tooltip_ability_item_watchers_gaze"	"<font color=\"#4ae0bf\">Watcher's Gaze</font>"
"DOTA_Tooltip_ability_item_watchers_gaze_Description"	"Em inglês: <font color='#F2A93E'>Watcher's Gaze</font>\n \nRequer nível: %required_level%\n\nAtivo: Olhar Petrificante — Inimigos no alcance do seu cone de visão frontal são petrificados e sofrem dano físico adicional.\n"
"[english]DOTA_Tooltip_ability_item_watchers_gaze_Description"	"Required Level: %required_level%\n\nActive: Stone Gaze - Enemies within your frontal cone are turned to stone and take additional physical damage.\n"
"DOTA_Tooltip_ability_item_watchers_gaze_Lore"	"Encare os teus inimigos e veja-os petrificarem diante de ti."
"[english]DOTA_Tooltip_ability_item_watchers_gaze_Lore"	"Look upon thine enemies and see them petrify before you."
"DOTA_Tooltip_ability_item_watchers_gaze_bonus_stats"	"ATRIBUTOS ADICIONAIS:"
"[english]DOTA_Tooltip_ability_item_watchers_gaze_bonus_stats"	"BONUS ALL STATS:"
"DOTA_Tooltip_ability_item_carapace_of_qaldin"	"<font color=\"#4ae0bf\">Carapaça de Qaldin</font>"
"[english]DOTA_Tooltip_ability_item_carapace_of_qaldin"	"<font color=\"#4ae0bf\">Carapace of Qaldin</font>"
"DOTA_Tooltip_ability_item_carapace_of_qaldin_Description"	"Em inglês: <font color='#F2A93E'>Carapace of Qaldin</font>\n \nRequer nível: %required_level%\n\nPassivo: Regeneração Acídica — Recupera vida e mana em dobro, não importa a fonte, e uma porcentagem de todo dano sofrido é causado de volta no atacante.\n"
"[english]DOTA_Tooltip_ability_item_carapace_of_qaldin_Description"	"Required Level: %required_level%\n\nPassive: Acidic Regeneration - All mana and health gained are doubled, and a percentage of all damage taken is reflected back upon the attacker.\n"
"DOTA_Tooltip_ability_item_carapace_of_qaldin_Lore"	"Deixe que o ataquem, pois cada golpe tem um preço em sangue."
"[english]DOTA_Tooltip_ability_item_carapace_of_qaldin_Lore"	"Let them attack you, for each blow comes at a blood price."
"DOTA_Tooltip_ability_item_carapace_of_qaldin_bonus_hp"	"VIDA ADICIONAL:"
"[english]DOTA_Tooltip_ability_item_carapace_of_qaldin_bonus_hp"	"BONUS HP:"
"DOTA_Tooltip_ability_item_carapace_of_qaldin_bonus_mana"	"MANA ADICIONAL:"
"[english]DOTA_Tooltip_ability_item_carapace_of_qaldin_bonus_mana"	"BONUS MANA:"
"DOTA_Tooltip_ability_item_carapace_of_qaldin_bonus_restore_pct"	"%RESTAURAÇÃO ADICIONAL:"
"[english]DOTA_Tooltip_ability_item_carapace_of_qaldin_bonus_restore_pct"	"%BONUS RESTORE:"
"DOTA_Tooltip_ability_item_carapace_of_qaldin_damage_return_pct"	"%DANO REFLETIDO:"
"[english]DOTA_Tooltip_ability_item_carapace_of_qaldin_damage_return_pct"	"%DAMAGE RETURNED:"
"DOTA_Tooltip_ability_item_the_caustic_finale"	"<font color=\"#4ae0bf\">Final Cáustico</font>"
"[english]DOTA_Tooltip_ability_item_the_caustic_finale"	"<font color=\"#4ae0bf\">The Caustic Finale</font>"
"DOTA_Tooltip_ability_item_the_caustic_finale_Description"	"Em inglês: <font color='#F2A93E'>Caustic Finale</font>\n \nRequer nível: %required_level%\n\nPassivo: Finalização Cáustica — Ataques reduzem uma porcentagem da armadura do alvo. Esse efeito pode ser acumulado até %max_stack_count% vezes. Caso o alvo morra enquanto afetado, explodirá causando dano em uma área ao redor.\n"
"[english]DOTA_Tooltip_ability_item_the_caustic_finale_Description"	"Required Level: %required_level%\n\nPassive: Caustic Finale - Attacks reduce a percentage of the target's armor.  This effect stacks up to %max_stack_count% times.  If the target dies under this effect, it explodes, dealing damage in an area of effect.\n"
"DOTA_Tooltip_ability_item_the_caustic_finale_Lore"	"O presente cáustico é sempre pago com antecedência."
"[english]DOTA_Tooltip_ability_item_the_caustic_finale_Lore"	"The caustic gift is always paid forward."
"DOTA_Tooltip_ability_item_the_caustic_finale_bonus_damage"	"DANO ADICIONAL:"
"[english]DOTA_Tooltip_ability_item_the_caustic_finale_bonus_damage"	"BONUS DAMAGE:"
"DOTA_Tooltip_ability_item_the_caustic_finale_bonus_attack_speed"	"VELOCIDADE DE ATAQUE ADICIONAL:"
"[english]DOTA_Tooltip_ability_item_the_caustic_finale_bonus_attack_speed"	"BONUS ATTACK SPEED:"
"DOTA_Tooltip_ability_item_the_caustic_finale_caustic_armor_reduction_pct"	"%REDUÇÃO DE ARMADURA POR ACÚMULO:"
"[english]DOTA_Tooltip_ability_item_the_caustic_finale_caustic_armor_reduction_pct"	"%ARMOR REDUCTION PER STACK:"
"DOTA_Tooltip_ability_item_the_caustic_finale_caustic_radius"	"RAIO DA EXPLOSÃO:"
"[english]DOTA_Tooltip_ability_item_the_caustic_finale_caustic_radius"	"CAUSTIC RADIUS:"
"DOTA_Tooltip_ability_item_the_caustic_finale_caustic_damage"	"DANO DA EXPLOSÃO:"
"[english]DOTA_Tooltip_ability_item_the_caustic_finale_caustic_damage"	"CAUSTIC DAMAGE:"
"DOTA_Tooltip_ability_item_the_caustic_finale_max_stack_count"	"MÁX. DE ACÚMULOS:"
"[english]DOTA_Tooltip_ability_item_the_caustic_finale_max_stack_count"	"MAX STACK COUNT:"
"DOTA_Tooltip_modifier_book_of_strength"	"Livro de Força"
"[english]DOTA_Tooltip_modifier_book_of_strength"	"Book of Strength"
"DOTA_Tooltip_modifier_book_of_strength_Description"	"Força obtida com o consumo de livros."
"[english]DOTA_Tooltip_modifier_book_of_strength_Description"	"Strength gained from consumed Books."
"DOTA_Tooltip_modifier_book_of_agility"	"Livro de Agilidade"
"[english]DOTA_Tooltip_modifier_book_of_agility"	"Book of Agility"
"DOTA_Tooltip_modifier_book_of_agility_Description"	"Agilidade obtida com o consumo de livros."
"[english]DOTA_Tooltip_modifier_book_of_agility_Description"	"Agility gained from consumed Books."
"DOTA_Tooltip_modifier_book_of_intelligence"	"Livro de Inteligência"
"[english]DOTA_Tooltip_modifier_book_of_intelligence"	"Book of Intelligence"
"DOTA_Tooltip_modifier_book_of_intelligence_Description"	"Inteligência obtida com o consumo de livros."
"[english]DOTA_Tooltip_modifier_book_of_intelligence_Description"	"Intelligence gained from consumed Books."
"DOTA_Tooltip_modifier_sand_king_boss_caustic_finale"	"Finalização Cáustica"
"[english]DOTA_Tooltip_modifier_sand_king_boss_caustic_finale"	"Caustic Finale"
"DOTA_Tooltip_modifier_sand_king_boss_caustic_finale_Description"	"Cada ataque reduz a armadura em 10%%."
"[english]DOTA_Tooltip_modifier_sand_king_boss_caustic_finale_Description"	"Each stack reduces armor by 10%%."
"DOTA_Tooltip_ability_item_tombstone"	"Reviver aliado"
"[english]DOTA_Tooltip_ability_item_tombstone"	"Resurrect Teammate"
"DOTA_Chat_Tombstone_Pinged"	"Aliado falecido aqui!"
"[english]DOTA_Chat_Tombstone_Pinged"	"Fallen teammate here."
"Popup_UsingOrbOfPassage"	"Aberto com Orbe da Passagem"
"[english]Popup_UsingOrbOfPassage"	"Opened With Orb of Passage"
"DOTA_Tooltip_ability_item_orb_of_passage"	"Orbe da Passagem"
"[english]DOTA_Tooltip_ability_item_orb_of_passage"	"Orb of Passage"
"Dungeon_FoundChestItem"	"{s:player_name} achou um tesouro com: {s:locstring_value}"
"[english]Dungeon_FoundChestItem"	"{s:player_name} found a treasure containing: {s:locstring_value}"
"Dungeon_FoundChestGold"	"{s:player_name} achou um tesouro com: <font color='#ffd825'>{d:int_value}</font><panel class='CombatEventGoldIcon'/>"
"[english]Dungeon_FoundChestGold"	"{s:player_name} found a treasure containing: <font color='#ffd825'>{d:int_value}</font><panel class='CombatEventGoldIcon'/>"
"Dungeon_FoundChestTrap"	"{s:player_name} achou um tesouro com: <font color='#ffd825'>{s:locstring_value}</font>!"
"[english]Dungeon_FoundChestTrap"	"{s:player_name} found a treasure containing: <font color='#ffd825'>{s:locstring_value}</font>!"
"Dungeon_FoundLifeRune"	"{s:player_name} achou {s:locstring_value}!"
"[english]Dungeon_FoundLifeRune"	"{s:player_name} found a {s:locstring_value}!"
"Dungeon_FoundNewRelic"	"{s:player_name} achou uma novo Artefato: <font color='#4ae0bf'>{s:locstring_value}</font>!"
"[english]Dungeon_FoundNewRelic"	"{s:player_name} found a new Artifact: <font color='#4ae0bf'>{s:locstring_value}</font>!"
"Dungeon_KilledByCreature"	"{s:player_name} morreu pelas mãos de {s:locstring_value}"
"[english]Dungeon_KilledByCreature"	"{s:player_name} was killed by {s:locstring_value}"
"Dungeon_ReachedCheckpoint"	"{s:player_name} alcançou um novo ponto de controle!"
"[english]Dungeon_ReachedCheckpoint"	"{s:player_name} reached a new checkpoint!"
"Dungeon_KeyItem"	"{s:player_name} achou um item da missão: {s:locstring_value}!"
"[english]Dungeon_KeyItem"	"{s:player_name} found a Quest Item: {s:locstring_value}!"
"start"	"Enseada de Yhilla"
"[english]start"	"Yhilla's Cove"
"forest"	"Mata Uivante"
"[english]forest"	"Howling Weald"
"forest_holdout"	"Guarnição da Encruzilhada"
"[english]forest_holdout"	"Crossroads Garrison"
"darkforest_rescue"	"Serra dos Ossos"
"[english]darkforest_rescue"	"Bonemeal Ridge"
"darkforest_pass"	"Estreito de Atolasseda"
"[english]darkforest_pass"	"The Silkmire Pass"
"darkforest_death_maze"	"Provação de Gallaron"
"[english]darkforest_death_maze"	"Trial of Gallaron"
"underground_temple"	"Templo de Ermacor"
"[english]underground_temple"	"Temple of Ermacor"
"desert_start"	"O Caminho para Kalabor"
"[english]desert_start"	"The Road to Kalabor"
"desert_town"	"Oásis de Kalabor"
"[english]desert_town"	"Kalabor Oasis"
"desert_expanse"	"Deserto de Kalabor"
"[english]desert_expanse"	"Kalabor Waste"
"desert_outpost"	"Posto Avançado do Norte"
"[english]desert_outpost"	"Northern Outpost"
"desert_chasm"	"Cânion Estilhaçado"
"[english]desert_chasm"	"Shatterblast Canyon"
"desert_fortress"	"Fortaleza de Rhyzik"
"[english]desert_fortress"	"Rhyzik's Stronghold"
"kill_hellbears"	"Cacem Ursos Infernais Guerreiros"
"[english]kill_hellbears"	"Hunt Berserker Hellbears"
"reach_the_camp"	"Encontrem a Guarnição da Encruzilhada"
"[english]reach_the_camp"	"Find the Crossroads Garrison"
"speak_to_the_chief"	"Encontrem o Comandante da Guarnição"
"[english]speak_to_the_chief"	"Find the Garrison Commander"
"learn_about_holdout"	"Falem com o Comandante após visitar a loja"
"[english]learn_about_holdout"	"Speak to the Commander after visiting the shop"
"defend_the_camp"	"Não deixem o Comandante morrer"
"[english]defend_the_camp"	"Ensure the Commander survives the assault"
"speak_to_chief_holdout_complete"	"Falem com o Comandante"
"[english]speak_to_chief_holdout_complete"	"Speak to the Commander"
"rescue_soldiers"	"Resgatem os soldados perdidos"
"[english]rescue_soldiers"	"Rescue the Missing Soldiers"
"rescue_the_captain"	"Resgatem o Capitão dos Soldados"
"[english]rescue_the_captain"	"Rescue the Soldier Captain"
"navigate_death_maze"	"Encontrem o Orbe da Passagem"
"[english]navigate_death_maze"	"Find the Orb of Passage"
"kill_spider_boss"	"Derrotem a Aranha-rainha"
"[english]kill_spider_boss"	"Defeat the Spider Queen"
"kill_spider_eggs"	"Destruam os sacos de ovos"
"[english]kill_spider_eggs"	"Destroy the Brood Sacs"
"navigate_underground_temple"	"Encontrem a saída para o deserto de Kalabor"
"[english]navigate_underground_temple"	"Find the exit to Kalabor desert"
"find_entrance_to_the_underground"	"Usem Orbes da Passagem para abrir o Portão de Grimwal"
"[english]find_entrance_to_the_underground"	"Use Orbs of Passage to open the Grimwal Gate"
"find_underground_temple"	"Encontrem a entrada do Templo"
"[english]find_underground_temple"	"Find the entrance to the Temple"
"find_hidden_treasures"	"Saqueiem os tesouros do Templo"
"[english]find_hidden_treasures"	"Loot the Temple Treasures"
"learn_about_babyback"	"Falem com o viajante perdido"
"[english]learn_about_babyback"	"Speak to the stranded traveler"
"start_escort"	"Escoltem Brigwyr até a cidade"
"[english]start_escort"	"Escort Brigwyr to town"
"escort_babyback_to_desert_town"	"Protejam Brigwyr dos bandidos"
"[english]escort_babyback_to_desert_town"	"Protect Brigwyr from bandits"
"kill_centaur_warlords"	"Derrotem os Centauros Guerreiros"
"[english]kill_centaur_warlords"	"Defeat the Centaur Warlords"
"kill_giant_burrowers"	"Derrotem os Entocadores do Enxame Arenoso"
"[english]kill_giant_burrowers"	"Defeat the Giant Sandswarm Burrowers"
"reach_desert_outpost"	"Alcancem o Posto Avançado do Norte"
"[english]reach_desert_outpost"	"Reach the Northern Outpost"
"speak_to_the_captain"	"Falem com o Capitão Pé-leve"
"[english]speak_to_the_captain"	"Speak to Captain Lightfoot"
"learn_about_assault"	"Preparem-se para atacar a Fortaleza de Rhyzik"
"[english]learn_about_assault"	"Prepare to attack Rhyzik's Stronghold"
"kill_the_dire_captains"	"Matem os Capitães Buzzick"
"[english]kill_the_dire_captains"	"Kill the Buzzick Captains"
"assault_the_desert_fortress"	"Encontrem o Covil de Rhyzik"
"[english]assault_the_desert_fortress"	"Find Rhyzik's Lair"
"kill_sand_king"	"Derrotem Rhyzik"
"[english]kill_sand_king"	"Defeat Rhyzik"
"consumed_orbs_of_passage"	"Consumiu dois Orbes da Passagem"
"[english]consumed_orbs_of_passage"	"Consumed Two Orbs Of Passage"
"welcome_brigwyr"	"O portão se abre para Brigwyr"
"[english]welcome_brigwyr"	"The Gate Opens for Brigwyr"
"Dungeon_Zone"	"Zona"
"[english]Dungeon_Zone"	"Zone"
"Dungeon_ZoneTime"	"Tempo da zona"
"[english]Dungeon_ZoneTime"	"Zone Time"
"Dungeon_Scoreboard_Kills"	"Vítimas"
"[english]Dungeon_Scoreboard_Kills"	"Kills"
"Dungeon_Scoreboard_Deaths"	"Mortes"
"[english]Dungeon_Scoreboard_Deaths"	"Deaths"
"Dungeon_Scoreboard_GoldBags"	"Bolsas de ouro"
"[english]Dungeon_Scoreboard_GoldBags"	"GoldBags"
"Dungeon_Scoreboard_Potions"	"Poções"
"[english]Dungeon_Scoreboard_Potions"	"Potions"
"Dungeon_Scoreboard_Total"	"Total"
"[english]Dungeon_Scoreboard_Total"	"Total"
"Dungeon_ZoneDesc_start"	"O litoral traiçoeiro da Enseada de Yhilla afundou muitos tesouros, mas ainda há aqueles habilidosos o suficiente para aproveitar o vento."
"[english]Dungeon_ZoneDesc_start"	"The deceptive shoals around Yhilla's cove have sunk many fortunes, but there are still some skilled tillermen who make use of its windward shelter."
"Dungeon_ZoneDesc_forest"	"Composto de parentes dos lobos, o clã dos Garralonga perambulam em toda a extensão da Mata Uivante — um perigo constante para o segmento do comércio costeiro."
"[english]Dungeon_ZoneDesc_forest"	"The wolf-kin of the Longclaw clan roam the breadth of the Howling Weald, a constant danger to the thread of commerce still daring for the coast."
"Dungeon_ZoneDesc_forest_holdout"	"O povo deslocado de Kalabor enfrenta incontáveis ameaças enquanto tentam conquistar as áreas selvagens."
"[english]Dungeon_ZoneDesc_forest_holdout"	"The displaced folk of Kalabor face untold threats as they push to settle the wildlands."
"Dungeon_ZoneDesc_darkforest_death_maze"	"Embora a reputação de Gallaron não o tenha precedido, a sua clara aptidão para as artes arcanas estabeleceram rapidamente a sua legitimidade."
"[english]Dungeon_ZoneDesc_darkforest_death_maze"	"Though Gallaron's reputation had not preceded him, his obvious aptitude in the arcane arts quickly convinced the settlement of his authenticity."
"Dungeon_ZoneDesc_darkforest_rescue"	"Se não fosse pela capacidade limitada no planejamento de guerra, os Ogros dos Ossos teriam expulsado o clã dos Garralonga da Mata há uma geração."
"[english]Dungeon_ZoneDesc_darkforest_rescue"	"Were it not for their limited fondness for battle planning, the Bonemeal Ogres might have driven the Longclaw clan from the Weald a generation ago."
"Dungeon_ZoneDesc_darkforest_pass"	"Não se sabe se a infestação de aracnídeos na antiga estrada dos peregrinos foi resultado do abandono do Templo de Ermacor ou se foi a sua causa."
"[english]Dungeon_ZoneDesc_darkforest_pass"	"It is uncertain whether the arachnid infestation on the old pilgrim's road was a cause of the Temple of Ermacor's abandonment or the result of it."
"Dungeon_ZoneDesc_underground_temple"	"Há muitos anos desde a última oração em seu nome, o templo de Ermacor, o Desbravador, serve como ponte entre duas terras separadas pelos presságios do mundo."
"[english]Dungeon_ZoneDesc_underground_temple"	"Long since the last prayer uttered to his name, the temple of Ermacor the Pathfinder bridges two lands separated by foreboding teeth of the world."
"Dungeon_ZoneDesc_desert_start"	"A tropa de bandidos que ameaça a diminuta população de Kalabor sobrevive basicamente dos frutos da movimentação de outrora."
"[english]Dungeon_ZoneDesc_desert_start"	"The bandit troop that preys upon Kalabor's shrinking population survives mainly off the dwindling haul from better days."
"Dungeon_ZoneDesc_desert_town"	"Onde antes prosperava um oásis acolhedor, agora moradores e viajantes precisam compartilhar um único poço sujo."
"[english]Dungeon_ZoneDesc_desert_town"	"Where once a sheltering oasis flourished, residents and travelers alike must now make do with sharing a single dirty well."
"Dungeon_ZoneDesc_desert_expanse"	"Antes mesmo do surgimento dos senhores de guerra de Rhyzik, apenas os mais experientes ou tolos atravessariam as dunas de Kalabor sozinhos."
"[english]Dungeon_ZoneDesc_desert_expanse"	"Even before the rise of Rhyzik's warlords, only the very experienced or foolish would travel the dunes of Kalabor alone."
"Dungeon_ZoneDesc_desert_outpost"	"O posto avançado do norte é o bastião final contra a invasão das forças sem fim de Rhyzik nas regiões inabitadas de Kalabor e as terras além."
"[english]Dungeon_ZoneDesc_desert_outpost"	"The northern outpost stands as the final bulwark against the flood of Rhyzik's forces into the inhabited regions of Kalabor and the lands beyond."
"Dungeon_ZoneDesc_desert_chasm"	"A quantidade de seguidores de Rhyzik e a disseminação da sua influência fez o Conselho perceber que ele não permaneceu adormecido durante a ausência de Quebralama."
"[english]Dungeon_ZoneDesc_desert_chasm"	"The size of Rhyzik's following and spread of his influence belies the Conclave's assumption that he had become dormant in Siltbreaker's absence."
"Dungeon_ZoneDesc_desert_fortress"	"Rhyzik, o Corruptor, foi criado para desferir o primeiro golpe quando Quebralama expandiu a sua rebelião amaldiçoada para terra firme."
"[english]Dungeon_ZoneDesc_desert_fortress"	"Rhyzik the Corruptor was created to strike the first blow when Siltbreaker expanded his doomed uprising to target dryland enemies."
"siltbreaker_acti_intro_tab_text"	"Enquanto o demônio Quebralama planeja a sua fuga da prisão do Recife Sombrio, os seus inimigos no Conselho de Salmoura reúnem uma tropa de guerreiros para enfrentá-lo. Para os aventureiros que atenderem ao chamado do Conselho, a jornada para o Recife Sombrio se inicia perto das areias de Kalabor, onde a criação perversa de Quebralama — Rhyzik, o Corruptor — une forças para auxiliar os planos do seu mestre..."
"[english]siltbreaker_acti_intro_tab_text"	"As the fiend Siltbreaker plots an escape from Dark Reef prison, his enemies in the Conclave of the Brine assemble a band of warriors to take up arms against him. For the adventurers who answer the Conclave's call, the road to Dark Reef begins near the sands of Kalabor, where Siltbreaker's twisted creation, Rhyzik the Corruptor, gathers strength to aid his master's plans..."
"TPScroll_Quest_Label"	"A tentativa de fuga de Quebralama não passou despercebida <br><br>Rhyzik, o Corruptor, ressurgiu para auxiliar a <br>ressurreição do seu mestre <br><br>Rhyzik nos enganou por muito tempo — destrua-o antes de ir ao Recife Sombrio <br><br>Acabe com as ameaças em nome do Conselho — O seu nome será eternizado"
"[english]TPScroll_Quest_Label"	"Siltbreaker's escape attempt did not go unnoticed <br><br>Rhyzik the Corruptor has resurfaced to aid his <br>master's revival <br><br>Rhyzik has long eluded us — Destroy him before infiltrating Dark Reef <br><br>End these threats to the Conclave — Our ledger will be cleared of your name"
"siltbreaker_acti_outro_01"	"Com Rhyzik, o Corruptor, derrotado e uma porção do poder de Quebralama destruído, o primeiro passo da missão do Conselho foi concluído. Livres dos enxames de Rhyzik, o povo de Kalabor está livre para retornar às suas casas ou estabelecer uma nova moradia na Mata, agora pacificada."
"[english]siltbreaker_acti_outro_01"	"With Rhyzik the Corruptor defeated and a measure of Siltbreaker's might destroyed, the first step of the Conclave's mission is complete. Free of Rhyzik's swarms, the people of Kalabor are free to return home or establish a new homeland amidst the pacified Weald."
"siltbreaker_acti_outro_02"	"Com os defensores do Conselho atravessando o portal do emissário, um destino incerto os aguarda. Eles embarcam agora na verdadeira missão: entrar no Recife Sombrio do jeito que for necessário... e garantir que Quebralama jamais saia."
"[english]siltbreaker_acti_outro_02"	"As the Conclave's defenders step through the wisp emissary’s portal, an uncertain fate lies before them. They journey now to their true purpose: Infiltrate Dark Reef prison by any means necessary... And ensure Siltbreaker never leaves."
"Dialogue_theod_quest_text"	"Graças a Maelrawn... vocês chegaram. Eu fui enviado— uh! P-para guiar. As coisas... ficam ruins."
"[english]Dialogue_theod_quest_text"	"Praise Maelrawn... you made it. I was sent— uh! T-to guide you. Things took... a bad turn."
"Dialogue_theod_quest_text_02"	"Vocês p-precisam ir para o leste. Para Kalabor. Deter Rhyzik. Se o Conselho f-falhar... armistício... com os Mer... acabará."
"[english]Dialogue_theod_quest_text_02"	"You must g-go east. To Kalabor. Stop Rhyzik. If the Conclave f-falls... armistace... with the Mer... won't hold."
"Dialog_ForestChief_LearnAboutHoldout"	"Não sei o que querem, mas terão que esperar. Tem uma matilha de uivantes rondando o perímetro, e a minha última patrulha nunca retornou."
"[english]Dialog_ForestChief_LearnAboutHoldout"	"Whatever you want, it'll have to wait. Got howler packs scouting our perimeter, and my last patrol never came back."
"Dialog_ForestChief_LearnAboutHoldout_02"	"Vocês poderão nos ajudar? Quem quiser sair deste acampamento vai precisar lutar um pouco. Então peguem o que precisarem e falem comigo quando estiverem prontos."
"[english]Dialog_ForestChief_LearnAboutHoldout_02"	"You able to help us? Anyone wants out of this camp needs to fight either way. So gear up and find me when you're ready."
"Dialog_ForestChief_DefendTheCamp"	"Cães por todos os lados! Defendam-me e os despojos da batalha serão seus!"
"[english]Dialog_ForestChief_DefendTheCamp"	"Hounds on all sides! Defend my life and the spoils of battle will be yours!"
"dia_holdout_boss_battlecry"	"Em nome daqueles massacrados nas nossas tocas!"
"[english]dia_holdout_boss_battlecry"	"For those butchered in our dens!"
"Dialog_ForestChief_HoldoutComplete"	"Não gosto de admitir, mas aquele velho uivante me encontrou pelo cheiro."
"[english]Dialog_ForestChief_HoldoutComplete"	"Don't like to admit it, but that old howler found my scent."
"Dialog_ForestChief_HoldoutComplete_02"	"Se estiverem a caminho de Kalabor, há um atalho a sudeste do acampamento. Pelo velho templo."
"[english]Dialog_ForestChief_HoldoutComplete_02"	"If you're bound for Kalabor, there's a shortcut southeast of camp. Through the old temple."
"Dialog_ForestChief_HoldoutComplete_03"	"É um caminho difícil... Não é sempre que abrimos o Portão de Grimwal. Vocês precisam de dois Orbes da Passagem para atravessar."
"[english]Dialog_ForestChief_HoldoutComplete_03"	"It's a hard road... We don't open the Grimwal Gate often. You need two Orbs of Passage to get through."
"Dialog_ForestChief_HoldoutComplete_04"	"Um dos Orbes está escondido em um... abrigo a oeste. O outro está com a patrulha que desapareceu, a norte."
"[english]Dialog_ForestChief_HoldoutComplete_04"	"One Orb is hidden in a... haven to the west. The other one's with the patrol that vanished up north."
"Dialog_ForestChief_passive_01"	"Tivemos encontros com bandos de Garralonga, mas nada como isso. Algo os agitou."
"[english]Dialog_ForestChief_passive_01"	"We had run-ins with Longclaw's packs, but nothing like this. Something got them stirred up."
"Dialog_ForestChief_passive_02"	"Com Garralonga morto, toda a Mata encontra-se vulnerável."
"[english]Dialog_ForestChief_passive_02"	"With Longclaw dead, the whole of the Weald is up for grabs."
"Dialog_ForestChief_passive_03"	"Os meus empregadores dão muito valor a este acampamento."
"[english]Dialog_ForestChief_passive_03"	"My employers have a lot riding on this camp."
"Dialog_ForestChief_passive_04"	"Com o dinheiro gasto naquele labirinto inútil, poderiam ter erguido torres de verdade..."
"[english]Dialog_ForestChief_passive_04"	"With what they spent on that foolish labyrinth, could've built proper towers..."
"Dialog_ForestChief_passive_05"	"Garralonga não era amigável, mas Rhyzik... Bem, há um motivo para esse acampamento estar se preparando para receber refugiados."
"[english]Dialog_ForestChief_passive_05"	"Longclaw was no friend, but Rhyzik... Well, there's a reason this camp's preparing for refugees."
"Dialog_RadiantCaptain_Rescued"	"Superado por ogros... Ugh. Tomem este Orbe da Passagem. Caso estejam mesmo caçando Rhyzik, estaremos logo atrás."
"[english]Dialog_RadiantCaptain_Rescued"	"Outsmarted by ogres... Ugh. Take this Orb of Passage. If you're really hunting Rhyzik, we'll be close behind."
"dia_garrison_creep_01_01"	"A última patrulha não retornou."
"[english]dia_garrison_creep_01_01"	"Last patrol didn't come back."
"dia_garrison_creep_01_02"	"Começo a duvidar se a Mata é mais segura que Kalabor."
"[english]dia_garrison_creep_01_02"	"Starting to wonder if the Weald is any safer than Kalabor."
"dia_garrison_creep_01_03"	"Targan pode ser um mercenário, mas é um belo comandante."
"[english]dia_garrison_creep_01_03"	"Targan might be a hired hand, but he's a fine commander."
"dia_garrison_creep_01_04"	"Os seus empregadores, por outro lado..."
"[english]dia_garrison_creep_01_04"	"Not sure about his employers though..."
"dia_garrison_creep_01_05"	"Devemos ter gente nova aqui muito em breve."
"[english]dia_garrison_creep_01_05"	"Lot of new folks due here any day."
"dia_garrison_creep_01_06"	"Não se vê muitos viajantes vindo do oeste..."
"[english]dia_garrison_creep_01_06"	"Don't see many travelers arrive from the west..."
"dia_garrison_creep_01_06_sven"	"Uma espada como a sua seria de muita utilidade por aqui."
"[english]dia_garrison_creep_01_06_sven"	"We could use a sword like yours around here."
"dia_garrison_creep_01_06_tidehunter"	"Molhado o bastante para você?"
"[english]dia_garrison_creep_01_06_tidehunter"	"Wet enough for you?"
"dia_garrison_creep_01_06_tiny"	"O acampamento vai crescer rapidinho."
"[english]dia_garrison_creep_01_06_tiny"	"Camp's going to grow fast."
"dia_garrison_creep_01_06_legion_commander"	"Temos que proteger o acampamento para eles."
"[english]dia_garrison_creep_01_06_legion_commander"	"We have to make camp safe for them."
"dia_garrison_creep_01_06_templar_assassin"	"Precisaremos inclusive de uma escola."
"[english]dia_garrison_creep_01_06_templar_assassin"	"We'll even need a school."
"dia_garrison_creep_01_06_troll_warlord"	"Não gostou?"
"[english]dia_garrison_creep_01_06_troll_warlord"	"That don't appeal to you?"
"dia_garrison_creep_01_06_witch_doctor"	"Espero que alguns curandeiros cheguem em breve."
"[english]dia_garrison_creep_01_06_witch_doctor"	"I hope some healers arrive soon."
"dia_garrison_creep_01_06_windrunner"	"Você será bem-vinda entre nós."
"[english]dia_garrison_creep_01_06_windrunner"	"You'd be welcome to join us."
"dia_garrison_creep_01_06_drow_ranger"	"Quer recomeçar a vida do zero?"
"[english]dia_garrison_creep_01_06_drow_ranger"	"Looking for a fresh start?"
"dia_garrison_creep_01_06_jakiro"	"Você não vai conseguir virar sem se deparar com alguém."
"[english]dia_garrison_creep_01_06_jakiro"	"Won't be able to turn around without running into someone."
"dia_garrison_creep_01_06_lina"	"Melhor dar um jeito nesse seu temperamento."
"[english]dia_garrison_creep_01_06_lina"	"Probably see a few tempers flare before long."
"dia_garrison_creep_01_06_nevermore"	"De onde você é mesmo?"
"[english]dia_garrison_creep_01_06_nevermore"	"Where did you say you're from?"
"dia_garrison_creep_02_01"	"Vocês vieram pela Mata a sós?"
"[english]dia_garrison_creep_02_01"	"You came through the Weald alone?"
"dia_garrison_creep_02_02"	"Nunca achei que teria gente maluca assim."
"[english]dia_garrison_creep_02_02"	"Didn't think anyone was that crazy."
"dia_garrison_creep_02_03"	"Cheguei aqui sozinho há pouco tempo."
"[english]dia_garrison_creep_02_03"	"Recently arrived here myself."
"dia_garrison_creep_02_04"	"Nunca vi chuva assim lá em casa."
"[english]dia_garrison_creep_02_04"	"Never rains like this back home."
"dia_garrison_creep_02_05"	"Não sinto falta alguma daquela areia toda."
"[english]dia_garrison_creep_02_05"	"I don't miss all that sand one bit."
"dia_garrison_creep_02_06"	"Estão de passagem?"
"[english]dia_garrison_creep_02_06"	"You just passing through?"
"dia_garrison_creep_03_01"	"Muitos rostos novos no acampamento."
"[english]dia_garrison_creep_03_01"	"Lot of new faces in camp."
"dia_garrison_creep_03_02"	"Por quanto tempo será que continuarão vivos?"
"[english]dia_garrison_creep_03_02"	"Wonder how long they'll survive."
"dia_garrison_creep_03_03"	"O seu grupo me traz esperança."
"[english]dia_garrison_creep_03_03"	"Your group looks of the right sort."
"dia_garrison_creep_03_04"	"Todo mundo está correndo para cá para fugir de Kalabor..."
"[english]dia_garrison_creep_03_04"	"Everyone's running here to escape Kalabor..."
"dia_garrison_creep_03_05"	"Já temos problemas demais por aqui."
"[english]dia_garrison_creep_03_05"	"We got our own problems."
"dia_garrison_creep_03_06"	"Pelo menos os refugiados são corajosos."
"[english]dia_garrison_creep_03_06"	"The refugees are tough. I'll give 'em that."
"dia_garrison_creep_04_01"	"Assim não... assim não."
"[english]dia_garrison_creep_04_01"	"Not like this... Not like this."
"dia_garrison_creep_04_02"	"Eu vim para cá para fugir de coisas como essa!"
"[english]dia_garrison_creep_04_02"	"I came here to get away from stuff like this!"
"dia_garrison_creep_04_03"	"Ogros famintos!"
"[english]dia_garrison_creep_04_03"	"Hungry ogres!"
"dia_garrison_creep_04_04"	"Feiticeiros arrogantes!"
"[english]dia_garrison_creep_04_04"	"Arrogant wizards!"
"dia_garrison_creep_04_05"	"Eu devia ter tentado enfrentar Rhyzik..."
"[english]dia_garrison_creep_04_05"	"Should've taken my chances with Rhyzik..."
"dia_garrison_creep_04_06"	"Pelo menos a água é boa..."
"[english]dia_garrison_creep_04_06"	"At least the water's nice..."
"dia_garrison_creep_04_06_troll_warlord"	"Eu não quero problemas..."
"[english]dia_garrison_creep_04_06_troll_warlord"	"I don't want any trouble..."
"dia_garrison_creep_04_06_dazzle"	"Estou de olho em você..."
"[english]dia_garrison_creep_04_06_dazzle"	"Got my eye on you..."
"dia_garrison_creep_04_06_legion_commander"	"Os seus estandartes me trazem alívio!"
"[english]dia_garrison_creep_04_06_legion_commander"	"Your banners are a welcome sight!"
"dia_garrison_creep_04_06_windrunner"	"Me parece que você não precisará de ajuda."
"[english]dia_garrison_creep_04_06_windrunner"	"You look like you can handle yourself out there."
"dia_garrison_creep_04_06_sven"	"Como você consegue golpear com essa coisa?"
"[english]dia_garrison_creep_04_06_sven"	"How do you even swing that thing?"
"dia_garrison_creep_05_01"	"Não sei por que todos estão tensos."
"[english]dia_garrison_creep_05_01"	"Don't know why everyone's on edge."
"dia_garrison_creep_05_02"	"Os uivadores nunca conseguirão atravessar a barricada."
"[english]dia_garrison_creep_05_02"	"Those howlers'll never get through the stockade."
"dia_garrison_creep_05_03"	"Fui eu quem escavou."
"[english]dia_garrison_creep_05_03"	"I dug those posts myself."
"dia_garrison_creep_05_04"	"Os soldados perdidos devem estar bem."
"[english]dia_garrison_creep_05_04"	"I'm sure the missing soldiers are fine."
"dia_garrison_creep_05_05"	"A próxima caravana de Kalabor deve chegar já já."
"[english]dia_garrison_creep_05_05"	"The next caravan from Kalabor should arrive soon."
"dia_garrison_creep_05_06"	"Falta pouco para este acampamento virar uma cidade de verdade."
"[english]dia_garrison_creep_05_06"	"Pretty soon this camp'll be a full-fledged town."
"dia_garrison_creep_05_07"	"Eu contarei tudo aos meus netos!"
"[english]dia_garrison_creep_05_07"	"I'll tell my grandkids about this!"
"Dialog_Ogre_Kill_Boss"	"MATEM ANKABOOT PRIMEIRO!"
"[english]Dialog_Ogre_Kill_Boss"	"KILL ANKABOOT FIRST!"
"Dialog_Ogre_Rescued"	"Queria uma rastejante bebê. Mas a mamãe rastejante ficou furiosa. Você salvou! Valeu! ... Quero mais rastejantes! Hah-hah!!"
"[english]Dialog_Ogre_Rescued"	"Want a baby crawly. But crawly momma got mad. You save! Thanks! ... Want more crawlies! Hah-hah!!"
"dia_special_guest_01"	"Os tolos daqui me chamam de Gallaron, mas alguns me conhecem por outro nome..."
"[english]dia_special_guest_01"	"The fools here think me Gallaron, but some know me by a different name..."
"dia_special_guest_02"	"Planos tão grandiosos para esse labirinto... mas os imbecis ficam teimando por causa de orçamento!"
"[english]dia_special_guest_02"	"Such grand plans for this labyrinth... Yet the imbeciles speak of budgets!"
"dia_special_guest_03"	"A sua causa não me importa, mas tenho uma atração por orbes."
"[english]dia_special_guest_03"	"Their cause is scarce worth my notice. But I do have a fondness for orbs."
"dia_special_guest_04"	"Ousa comprar um tesouro da Quas Wex Exportações?"
"[english]dia_special_guest_04"	"Dare you purchase a treasure from Quas Wex Exports?"
"DOTA_Tooltip_Ability_item_treasure_box"	"Aposta de Gallaron"
"[english]DOTA_Tooltip_Ability_item_treasure_box"	"Gallaron's Gamble"
"dia_temple_adventurer_01"	"Eu acreditava que haveria como pegar o velho atalho para Kalabor em vez de ir pelo estreito da montanha. Como estava errado!"
"[english]dia_temple_adventurer_01"	"Thought I could skip the mountain pass and take the old shortcut to Kalabor. Bad idea!"
"dia_temple_adventurer_02"	"Aranhas e lobos? Tudo bem. Mas não vou cegar a minha lâmina em gárgulas voadoras!"
"[english]dia_temple_adventurer_02"	"Spiders and wolves I can handle. But I'm not going to dull my blade on flying gargoyles!"
"dia_wisp_temple_01"	"Caçadores do afundado — aquele adormecido no cofre. Nós trazemos palavras de advertência."
"[english]dia_wisp_temple_01"	"Seekers of the sunken one—he who sleeps in the vault. We bring words of warning."
"dia_wisp_temple_02"	"O abominável Rhyzik, nadador das areis, é mais que um mero peão de Quebra-lama contra os terra-seca."
"[english]dia_wisp_temple_02"	"The foul Rhyzik, swimmer in the sands, is more than Siltbreaker's pawn against the drylanders."
"dia_wisp_temple_03"	"Rhyzik leva dentro de si um pedaço da essência do seu mestre."
"[english]dia_wisp_temple_03"	"Rhyzik carries inside him a measure of his master's essence."
"dia_wisp_temple_04"	"Se este vil reservatório for destruído, a população do Recife Sombrio será reduzida."
"[english]dia_wisp_temple_04"	"If this vile reservoir can be destroyed, the denizen of Dark Reef will falter."
"dia_wisp_temple_05"	"Muito ao norte, um pequeno posto avançado é a nossa última resistência."
"[english]dia_wisp_temple_05"	"Far to the north, a small outpost of resistance makes a final stand."
"dia_wisp_temple_06"	"Sem a sua ajuda, essas terras ruirão perante os enxames de Rhyzik. E o domínio de Quebralama crescerá."
"[english]dia_wisp_temple_06"	"Without your help, these lands will fall to Rhyzik's swarms. And Siltbreaker's influence will grow."
"dia_wisp_temple_07"	"Detenham o avanço de Rhyzik. Só assim o nosso portal poderá acelerar a sua missão ao Recife Sombrio."
"[english]dia_wisp_temple_07"	"Stop Rhyzik's advance. Only then can our portal hasten your journey to Dark Reef."
"dia_wisp_epi_01"	"Vocês já fizeram bastante, mas ainda há muito trabalho pela frente."
"[english]dia_wisp_epi_01"	"You have done much, but more work remains."
"dia_wisp_epi_02"	"Este portal leva ao Recife Sombrio e à verdadeira tarefa de vocês."
"[english]dia_wisp_epi_02"	"Take this portal to Dark Reef, and the true task at hand."
"Dialog_FriendlyBristlebackSon_PreMission"	"Algum de vocês achou outro caminho para a cidade? Eu não me perdi — eu sei onde fica a cidade. É que... os bandidos me cercaram."
"[english]Dialog_FriendlyBristlebackSon_PreMission"	"Any of you seen another way to town around here? I mean, I'm not lost—I know where town is. Just... the bandits got me cornered."
"Dialog_FriendlyBristlebackSon_PreMission_02"	"Com vocês aqui, quem sabe? Me avisem quando estiverem prontos."
"[english]Dialog_FriendlyBristlebackSon_PreMission_02"	"With you here, maybe it's ok! Just let me know when you're ready."
"Dialog_FriendlyBristlebackSon"	"Kalabor é por aqui. Eles não abrirão as portas para desconhecidos, então não me deixem para trás!"
"[english]Dialog_FriendlyBristlebackSon"	"Kalabor's this way. They won't open the gate for strangers, so don't leave me behind!"
"desert_town_bristleback_grandpa"	"Finalmente reconquistamos o posto avançado do norte próximo à fortaleza de Rhyzik. Mas as dunas nos arredores da cidade ainda estão cheias daquelas... coisas."
"[english]desert_town_bristleback_grandpa"	"We finally recaptured the northern outpost near Rhyzik's stronghold. But the dunes outside of town are still crawling with those... things."
"Dialog_BristleDad"	"Nós perdemos muito retomando o posto avançado. Não posso permitir que ninguém passe com tantos inimigos pela área. Derrotem alguns Centauros Guerreiros e eu permitirei a passagem."
"[english]Dialog_BristleDad"	"We lost too much retaking the outpost. Can't let anyone through while the area's still so overrun. Destroy the Centaur Warlords and I can let you pass."
"Dialog_BristleDad_GoToOutpost"	"É hora da investida final. O Capitão Pé-leve e os seus homens aguardam do outro lado da ponte. Eles marcharão com vocês contra Rhyzik."
"[english]Dialog_BristleDad_GoToOutpost"	"It's time to make the final push. Captain Lightfoot and his men wait across the bridge. They'll march with you against Rhyzik."
"Dialog_RadiantCaptain_LearnAboutAssault"	"Não recuaremos mais do enxame de Rhyzik. Dê-me a palavra e eu anunciarei o ataque."
"[english]Dialog_RadiantCaptain_LearnAboutAssault"	"We'll retreat from Rhyzik's swarm no farther. Give word and I'll sound the attack."
"Dialog_RadiantCaptain_BeginAssault"	"Hoje mostraremos de que são feitos os defensores de Kalabor!"
"[english]Dialog_RadiantCaptain_BeginAssault"	"Today we show them what Kalabor's defenders are made of!"
"desert_town_folk_01_01"	"Para onde foi aquele cara?"
"[english]desert_town_folk_01_01"	"Where the hell is that guy?"
"desert_town_folk_01_02"	"É o turno dele na torre de vigia."
"[english]desert_town_folk_01_02"	"It's his turn in the watchtower."
"desert_town_folk_01_03"	"Eu não vou ficar lá o dia todo."
"[english]desert_town_folk_01_03"	"I'm not going to sit up there all damn day."
"desert_town_folk_01_04"	"Por que eu fui entrar naquela família estúpida?"
"[english]desert_town_folk_01_04"	"Why did I marry into that stupid family!"
"desert_town_folk_01_05"	"Ele deve estar dormindo em algum lugar."
"[english]desert_town_folk_01_05"	"He's probably asleep somewhere."
"desert_town_folk_01_06"	"Quando eu encontrá-lo..."
"[english]desert_town_folk_01_06"	"When I find him..."
"desert_town_folk_01_06_lina"	"Sabe aqueles parentes que dá uma vontade de estrangular?"
"[english]desert_town_folk_01_06_lina"	"Know those family members you could just strangle?"
"desert_town_folk_01_06_drow_ranger"	"Já pensou em deixar tudo isso para trás?"
"[english]desert_town_folk_01_06_drow_ranger"	"Ever wish you could leave it all behind?"
"desert_town_folk_01_06_sven"	"Se não for para se orgulhar, é melhor nem fazer. Certo?"
"[english]desert_town_folk_01_06_sven"	"Take pride in what you do, or don't do it. Right?"
"desert_town_folk_01_06_tiny"	"Lance uma rocha daqui e você acertará aquele dorminhoco idiota."
"[english]desert_town_folk_01_06_tiny"	"Throw a rock around here and you'll hit that idiot napping."
"desert_town_folk_01_06_legion_commander"	"Ele nunca precisou trabalhar um único dia."
"[english]desert_town_folk_01_06_legion_commander"	"He never had to work a day in his life."
"desert_town_folk_01_06_templar_assassin"	"Ou está lendo um maldito livro!"
"[english]desert_town_folk_01_06_templar_assassin"	"Or has his head in a darn book!"
"desert_town_folk_01_06_troll_warlord"	"Que vontade de esmagá-lo!"
"[english]desert_town_folk_01_06_troll_warlord"	"Makes me want to smack him!"
"desert_town_folk_01_06_dazzle"	"Terei que ajudar a lembrá-lo da hora."
"[english]desert_town_folk_01_06_dazzle"	"I'll have to help him remember what time it is."
"desert_town_folk_01_06_witch_doctor"	"Há uma cura para a preguiça?"
"[english]desert_town_folk_01_06_witch_doctor"	"Is there a cure for laziness?"
"desert_town_folk_01_06_windrunner"	"Algumas pessoas não são proativas."
"[english]desert_town_folk_01_06_windrunner"	"Some people just aren't go-getters."
"desert_town_folk_01_06_jakiro"	"Preciso me afastar dele por um tempo."
"[english]desert_town_folk_01_06_jakiro"	"I need to get away from him for awhile."
"desert_town_folk_01_06_nevermore"	"E cá estou eu, abrindo o meu coração para um estranho!"
"[english]desert_town_folk_01_06_nevermore"	"And here I am pouring my soul out to an absolute stranger!"
"desert_town_folk_01_06_tidehunter"	"Eu estou a ponto de explodir!"
"[english]desert_town_folk_01_06_tidehunter"	"I'm about ready to throw a fit!"
"desert_town_folk_02_01"	"Todas as outras famílias já foram embora."
"[english]desert_town_folk_02_01"	"All the other families already left town."
"desert_town_folk_02_02"	"É uma teimosa. Nascida e criada em Kalabor."
"[english]desert_town_folk_02_02"	"Ma's stubborn. Born and raised in Kalabor."
"desert_town_folk_02_03"	"Ela não quer sair daqui."
"[english]desert_town_folk_02_03"	"She ain't leaving."
"desert_town_folk_02_04"	"Ora, eu nasci e cresci aqui, também."
"[english]desert_town_folk_02_04"	"Heck, I was born and raised here, too."
"desert_town_folk_02_05"	"Eu só estou aqui por causa dela!"
"[english]desert_town_folk_02_05"	"Only reason I'm still here is her!"
"desert_town_folk_02_06"	"O que eu não daria para ver o oceano."
"[english]desert_town_folk_02_06"	"What I wouldn't give to see the ocean."
"desert_town_folk_02_06_sven"	"Continuo na mesma, só tenho um..."
"[english]desert_town_folk_02_06_sven"	"All the same, only got one ma'..."
"desert_town_folk_02_06_tiny"	"E ela é doida de pedra!"
"[english]desert_town_folk_02_06_tiny"	"And she's got rocks in her head!"
"desert_town_folk_02_06_legion_commander"	"Eu deveria confrontá-la."
"[english]desert_town_folk_02_06_legion_commander"	"I should stand up to her."
"desert_town_folk_02_06_templar_assassin"	"Me pergunto se um templo aceitaria cuidar dela..."
"[english]desert_town_folk_02_06_templar_assassin"	"I wonder if a temple would take her..."
"desert_town_folk_02_06_troll_warlord"	"Não esperava que alguém como você entendesse."
"[english]desert_town_folk_02_06_troll_warlord"	"Wouldn't expect someone like you to understand."
"desert_town_folk_02_06_abaddon"	"Mas o que é de você sem a família?"
"[english]desert_town_folk_02_06_abaddon"	"But what are you without family?"
"desert_town_folk_02_06_dazzle"	"Por que as pessoas que você ama te fazem tão mal?"
"[english]desert_town_folk_02_06_dazzle"	"Why do the people you love make you feel so bad?"
"desert_town_folk_02_06_witch_doctor"	"É bom desabafar..."
"[english]desert_town_folk_02_06_witch_doctor"	"It's nice to get this out..."
"desert_town_folk_02_06_windrunner"	"Eu acho que ela sempre cuidou de mim..."
"[english]desert_town_folk_02_06_windrunner"	"I guess she always has been there for me..."
"desert_town_folk_02_06_drow_ranger"	"Apenas queremos coisas distintas."
"[english]desert_town_folk_02_06_drow_ranger"	"We just want different things."
"desert_town_folk_02_06_jakiro"	"Queria que o meu irmão ainda estivesse aqui..."
"[english]desert_town_folk_02_06_jakiro"	"Wish my brother were still around..."
"desert_town_folk_02_06_lina"	"Talvez algo possa acender a chama dela..."
"[english]desert_town_folk_02_06_lina"	"Maybe something can light a fire under her..."
"desert_town_folk_02_06_nevermore"	"Ir embora custaria um pedaço da minha alma..."
"[english]desert_town_folk_02_06_nevermore"	"Leaving would cost a piece of my soul..."
"desert_town_folk_03_01"	"Com sede? Um turista desastrado despejou um frasco nojento dentro do poço quando tentava encher um cantil."
"[english]desert_town_folk_03_01"	"Thirsty? A butter-fingered food tourist dropped a nasty vial into the well trying to fill his canteen."
"desert_town_folk_03_02"	"Ele disse que logo voltaria ao normal... mas eu notei que ele não bebeu nada."
"[english]desert_town_folk_03_02"	"He said it'd turn back soon... but I noticed he didn't drink any."
"desert_town_folk_03_03"	"E ele saiu apressado. Mas ele também chegou assim."
"[english]desert_town_folk_03_03"	"And he left in a hurry. Though he kind of came in that way too."
"desert_town_folk_03_04"	"Não é tão ruim, na verdade. Depois de se acostumar com a textura."
"[english]desert_town_folk_03_04"	"It's not too bad, really. Once you get used to the texture."
"desert_town_folk_03_05"	"Aqui."
"[english]desert_town_folk_03_05"	"Help yourself."
"desert_town_folk_03_05_sven"	"Quer se refrescar um pouco?"
"[english]desert_town_folk_03_05_sven"	"Would you care for some refreshment?"
"desert_town_folk_03_05_tidehunter"	"O banho tem sido interessante!"
"[english]desert_town_folk_03_05_tidehunter"	"Bathtime has been interesting!"
"desert_town_folk_03_05_tiny"	"Mas é difícil lavar o sangue das pedras."
"[english]desert_town_folk_03_05_tiny"	"But it's hard to wash blood off the stones."
"desert_town_folk_03_05_legion_commander"	"Não tem medo de sangue, né?"
"[english]desert_town_folk_03_05_legion_commander"	"Not scared of a little blood are you?"
"desert_town_folk_03_05_templar_assassin"	"Vai saber o que tinha naquele frasco..."
"[english]desert_town_folk_03_05_templar_assassin"	"Who knows what that vial was..."
"desert_town_folk_03_05_troll_warlord"	"Não tenha vergonha. Pode entrar."
"[english]desert_town_folk_03_05_troll_warlord"	"Don't be shy. Get on in there."
"desert_town_folk_03_05_abaddon"	"Esse poço é tudo o que sobrou."
"[english]desert_town_folk_03_05_abaddon"	"This well's all the town's got left."
"desert_town_folk_03_05_dazzle"	"Fico imaginando se o processo pode ser revertido..."
"[english]desert_town_folk_03_05_dazzle"	"Wonder if there's a way to revert the process..."
"desert_town_folk_03_05_witch_doctor"	"Encha o seu casco, se quiser."
"[english]desert_town_folk_03_05_witch_doctor"	"Fill your cask, if you like."
"desert_town_folk_03_05_windrunner"	"Queria ter algo melhor para oferecer."
"[english]desert_town_folk_03_05_windrunner"	"Wish we had something better to offer."
"desert_town_folk_03_05_drow_ranger"	"Com essa palidez, talvez você prefira assim."
"[english]desert_town_folk_03_05_drow_ranger"	"With that pallor, might be you prefer it this way."
"desert_town_folk_03_05_jakiro"	"Arde um pouco para engolir, mas depois fica tudo bem."
"[english]desert_town_folk_03_05_jakiro"	"It does burn going down a bit. But sits cool in the gut."
"desert_town_folk_03_05_lina"	"Digamos que a cidade inteira está agitada!"
"[english]desert_town_folk_03_05_lina"	"Could say the whole town's blood's up!"
"desert_town_folk_04_01"	"Essa cidade era um lindo oásis quando eu era pequeno..."
"[english]desert_town_folk_04_01"	"This town was a beautiful oasis when I was a boy..."
"desert_town_folk_04_02"	"Todos acham que os monstros secaram o manancial."
"[english]desert_town_folk_04_02"	"Everyone thinks monsters dried up the wellspring."
"desert_town_folk_04_03"	"Eu não acho que os monstros tenham alguma ligação com isso!"
"[english]desert_town_folk_04_03"	"I don't think monsters had anything to do with it!"
"desert_town_folk_04_04"	"Fazendeiros como eu não podem fazer nada nesse oceano de areia."
"[english]desert_town_folk_04_04"	"No use for old farmers like me now in this ocean of sand."
"desert_town_folk_04_05"	"Talvez se vocês derrotarem Rhyzik, as pessoas verão os verdadeiros problemas daqui."
"[english]desert_town_folk_04_05"	"Maybe if you kill Rhyzik, people'll see the real problems around here."
"desert_town_folk_04_06"	"Tem gente que não para para analisar a situação como um todo..."
"[english]desert_town_folk_04_06"	"Some people can't see the forest for the trees..."
"desert_town_folk_04_06_sven"	"Sempre precisam pôr a culpa em alguém..."
"[english]desert_town_folk_04_06_sven"	"Folks always need someone to blame..."
"desert_town_folk_04_06_tidehunter"	"Quando se vive em um deserto, é preciso preservar os recursos!"
"[english]desert_town_folk_04_06_tidehunter"	"When you live in a desert, gotta preserve your resources!"
"desert_town_folk_04_06_tiny"	"Quando aquele poço secar, eles podem tentar espremer água de pedras!"
"[english]desert_town_folk_04_06_tiny"	"When that well dries up, they can try wringin' water from a stone!"
"desert_town_folk_04_06_legion_commander"	"O que esse lugar precisa é de um verdadeiro líder."
"[english]desert_town_folk_04_06_legion_commander"	"What this place needs is a real leader."
"desert_town_folk_04_06_templar_assassin"	"Pode falar se quiser..."
"[english]desert_town_folk_04_06_templar_assassin"	"Feel free to chime in here..."
"desert_town_folk_04_06_troll_warlord"	"Eles acham que estou reclamando. Sou o único que enxerga!"
"[english]desert_town_folk_04_06_troll_warlord"	"They think I'm complainin'. I'm the only one who sees it!"
"desert_town_folk_04_06_abaddon"	"Estamos todos vivendo em um tempo emprestado!"
"[english]desert_town_folk_04_06_abaddon"	"We're all livin' on borrowed time!"
"desert_town_folk_04_06_dazzle"	"Chegará o tempo em que não terei forças nem para cavar a minha cova..."
"[english]desert_town_folk_04_06_dazzle"	"Time comes, won't even have the strength to dig my hole..."
"desert_town_folk_04_06_witch_doctor"	"Não podemos restaurar magicamente o que perdemos..."
"[english]desert_town_folk_04_06_witch_doctor"	"Can't just magically restore what we've lost..."
"desert_town_folk_04_06_drow_ranger"	"As coisas ficarão bem feias..."
"[english]desert_town_folk_04_06_drow_ranger"	"Things are gonna get real ugly..."
"desert_town_folk_04_06_jakiro"	"Precisamos colocar as cabeças no lugar."
"[english]desert_town_folk_04_06_jakiro"	"Gonna have to put our heads together."
"desert_town_folk_04_06_lina"	"De que adianta matar os monstros se o poço estiver seco?"
"[english]desert_town_folk_04_06_lina"	"What good's slayin' monsters if the well runs dry?"
"desert_town_folk_04_06_nevermore"	"O Oásis de Kalabor era a alma deste deserto."
"[english]desert_town_folk_04_06_nevermore"	"Kalabor Oasis was the soul of this desert."
"desert_town_folk_05_01"	"O que quero dizer é que não tentamos oferecer sacrifícios para Rhyzik..."
"[english]desert_town_folk_05_01"	"All I'm saying is that we haven't tried offering Rhyzik sacrifices..."
"desert_town_folk_05_02"	"As pessoas acham que sou maluco."
"[english]desert_town_folk_05_02"	"People act like I'm crazy."
"desert_town_folk_05_03"	"Não é uma ideia radical!"
"[english]desert_town_folk_05_03"	"It's not a radical idea!"
"desert_town_folk_05_04"	"Fazem isso desde o início dos tempos."
"[english]desert_town_folk_05_04"	"The practice's old as time itself."
"desert_town_folk_05_05"	"Civilizações inteiras foram construídas assim!"
"[english]desert_town_folk_05_05"	"Entire civilizations were built on it!"
"desert_town_folk_05_05_dazzle"	"Esse cara sabe do que estou falando."
"[english]desert_town_folk_05_05_dazzle"	"This guy knows what I'm talking about."
"desert_town_folk_05_05_legion_commander"	"Às vezes é preciso tomar decisões difíceis."
"[english]desert_town_folk_05_05_legion_commander"	"Sometimes you have to make hard choices."
"desert_town_folk_05_05_nevermore"	"Você pode convencê-lo?"
"[english]desert_town_folk_05_05_nevermore"	"Can you talk sense into him?"
"desert_town_folk_06_01"	"Escute esse cara. Sacrifícios para Rhyzik? Que loucura!"
"[english]desert_town_folk_06_01"	"Listen to this guy. Sacrifice to Rhyzik? That's insane!"
"desert_town_folk_06_02"	"Muitos que lutaram para retomar o posto avançado do norte não retornaram."
"[english]desert_town_folk_06_02"	"Lot of folks who fought to retake the northern outpost didn't come back."
"desert_town_folk_06_03"	"Já sacrificamos demais!"
"[english]desert_town_folk_06_03"	"We've sacrificed plenty!"
"desert_town_folk_06_04"	"A próxima caravana de refugiados sai para a Mata amanhã. E as minhas garotas estarão lá!"
"[english]desert_town_folk_06_04"	"Next refugee caravan leaves for the Weald tomorrow. And my girls'll be on it!"
"desert_town_folk_06_05"	"A travessia sobre as montanhas não é fácil..."
"[english]desert_town_folk_06_05"	"The pass over the mountains isn't easy..."
"desert_town_folk_06_06"	"Mas é melhor do que ficar aqui."
"[english]desert_town_folk_06_06"	"But it's better than staying here."
"desert_town_folk_06_07"	"Não vale a pena morrer por este lugar."
"[english]desert_town_folk_06_07"	"This place's not worth dying for."
"desert_town_folk_06_07_dazzle"	"Não fique do lado dele."
"[english]desert_town_folk_06_07_dazzle"	"Don't you go taking his side."
"desert_town_folk_06_07_legion_commander"	"As chances estão contra nós."
"[english]desert_town_folk_06_07_legion_commander"	"The odds are against us."
"desert_town_folk_06_07_nevermore"	"Rhyzik irá arruinar esse lugar."
"[english]desert_town_folk_06_07_nevermore"	"Rhyzik's gonna raze this place to the ground."
"desert_town_folk_07_01"	"Eu só quero passar o tempo com os meus livros!"
"[english]desert_town_folk_07_01"	"I just want to spend time with my books!"
"desert_town_folk_07_02"	"O que eles querem de mim? Não sou um guerreiro!"
"[english]desert_town_folk_07_02"	"What do they want from me? I'm no fighter!"
"desert_town_folk_07_03"	"Cheguei a um ponto onde ou eu caminhava nas dunas..."
"[english]desert_town_folk_07_03"	"Got to a point where it was either walk out into the dunes..."
"desert_town_folk_07_04"	"Ou sentava aqui e chorava."
"[english]desert_town_folk_07_04"	"Or sit back here and have a good cry."
"desert_town_folk_07_05"	"Acho que agora estou melhor."
"[english]desert_town_folk_07_05"	"I think I'm good now."
"desert_town_folk_07_06"	"Família é difícil..."
"[english]desert_town_folk_07_06"	"Family's such a pain..."
"desert_town_folk_07_06_sven"	"Todos acham que sabem como viver a minha vida..."
"[english]desert_town_folk_07_06_sven"	"Everyone thinks they know how to live my life..."
"desert_town_folk_07_06_tidehunter"	"Eu não preciso dessa cidade mesmo."
"[english]desert_town_folk_07_06_tidehunter"	"I don't need this town anyway."
"desert_town_folk_07_06_tiny"	"Provavelmente os meus problemas pareçam pequenos..."
"[english]desert_town_folk_07_06_tiny"	"My problems probably seem small in comparison..."
"desert_town_folk_07_06_legion_commander"	"Você me alegrou um pouco."
"[english]desert_town_folk_07_06_legion_commander"	"You kind of cheered me up."
"desert_town_folk_07_06_troll_warlord"	"Você não acha?"
"[english]desert_town_folk_07_06_troll_warlord"	"You don't think so?"
"desert_town_folk_07_06_dazzle"	"Só preciso de um pouco de tempo..."
"[english]desert_town_folk_07_06_dazzle"	"Just need a little more time..."
"desert_town_folk_07_06_witch_doctor"	"Você é um bom ouvinte..."
"[english]desert_town_folk_07_06_witch_doctor"	"You're a good listener..."
"desert_town_folk_07_06_windrunner"	"Não há para onde correr..."
"[english]desert_town_folk_07_06_windrunner"	"Nowhere to run to..."
"desert_town_folk_07_06_drow_ranger"	"Gosto de ficar sozinho."
"[english]desert_town_folk_07_06_drow_ranger"	"I like to be alone."
"desert_town_folk_07_06_jakiro"	"Queria poder sair voando..."
"[english]desert_town_folk_07_06_jakiro"	"Wish I could fly away..."
"desert_town_folk_07_06_lina"	"Por que está me olhando assim?"
"[english]desert_town_folk_07_06_lina"	"Why're you giving me that look?"
"desert_town_folk_07_06_nevermore"	"Estamos todos condenados mesmo..."
"[english]desert_town_folk_07_06_nevermore"	"We're all doomed anyway."
"desert_town_folk_07_01_templar_assassin"	"Oh! Uh... Olá."
"[english]desert_town_folk_07_01_templar_assassin"	"Oh! Uh... Hi."
"desert_town_folk_07_02_templar_assassin"	"Não vi você por aqui antes."
"[english]desert_town_folk_07_02_templar_assassin"	"Haven't seen you around here before."
"desert_town_folk_07_03_templar_assassin"	"Não tem acontecido muita coisa por aqui ultimamente..."
"[english]desert_town_folk_07_03_templar_assassin"	"This town doesn't have much going on these days..."
"desert_town_folk_07_04_templar_assassin"	"Bem, nada de bom."
"[english]desert_town_folk_07_04_templar_assassin"	"Well, nothing good anyway."
"desert_town_folk_07_05_templar_assassin"	"Passei a maior parte do tempo lendo..."
"[english]desert_town_folk_07_05_templar_assassin"	"Spend most my time reading..."
"desert_town_folk_07_06_templar_assassin"	"Com as rotas comerciais fechadas, livros novos são raridade."
"[english]desert_town_folk_07_06_templar_assassin"	"With trade routes closed, not many new books coming in."
"Dialog_RadiantSoldier_Rescued"	"Por favor! Encontrem o Capitão!"
"[english]Dialog_RadiantSoldier_Rescued"	"Please! Find the Captain!"
"dia_rescued creepsoldier_02"	"Boa sorte. Fui!"
"[english]dia_rescued creepsoldier_02"	"Good luck. I'm out of here!"
"dia_rescued creepsoldier_03"	"Orbe da Passagem? O Capitão deve ter um."
"[english]dia_rescued creepsoldier_03"	"Orb of Passage? Captain might have one."
"dia_rescued creepsoldier_04"	"Hora de voltar para casa e cuidar da fazenda do meu pai."
"[english]dia_rescued creepsoldier_04"	"Time to move back home and take over dad's farm."
"dia_rescued creepsoldier_05"	"Esse lugar é quase pior que Kalabor."
"[english]dia_rescued creepsoldier_05"	"This place is almost worse than Kalabor."
"dia_rescued creepsoldier_06"	"Eu troquei queimaduras do sol e centauros por uma gaiola encharcada e ogros famintos."
"[english]dia_rescued creepsoldier_06"	"I traded sunburn and centaurs for a soggy cage and hungry ogres."
"dia_rescued creepsoldier_07"	"Sabia que alguém viria!"
"[english]dia_rescued creepsoldier_07"	"I knew someone would come!"
"dia_rescued creepsoldier_08"	"Quando eu me armar, esses ogros vão ver só!"
"[english]dia_rescued creepsoldier_08"	"Once I'm patched up, these ogres are done for!"
"dia_rescued creepsoldier_09"	"Pensei que ia terminar em um caldeirão!"
"[english]dia_rescued creepsoldier_09"	"Thought I was gonna die in a stew pot!"
"dia_rescued creepsoldier_10"	"O acampamento está seguro? Eu vi os lobos se agruparem..."
"[english]dia_rescued creepsoldier_10"	"Is the camp safe? I saw the hounds gathering..."
"npc_dota_journal_note_01"	"Dia 6: 1º registro"
"[english]npc_dota_journal_note_01"	"Day 6 : Entry 1"
"npc_dota_journal_note_02"	"Dia 14: 2º registro"
"[english]npc_dota_journal_note_02"	"Day 14 : Entry 2"
"npc_dota_journal_note_03"	"Dia 22: 3º registro"
"[english]npc_dota_journal_note_03"	"Day 22 : Entry 3"
"npc_dota_journal_note_04"	"Dia 29: 4º registro"
"[english]npc_dota_journal_note_04"	"Day 29 : Entry 4"
"npc_dota_journal_note_05"	"Dia 31: 5º registro"
"[english]npc_dota_journal_note_05"	"Day 31 : Entry 5"
"npc_dota_journal_note_06"	"Dia 32: 6º registro"
"[english]npc_dota_journal_note_06"	"Day 32 : Entry 6"
"npc_dota_journal_note_07"	"Dia 35: 7º registro"
"[english]npc_dota_journal_note_07"	"Day 35 : Entry 7"
"npc_dota_journal_note_08"	"Dia 41: 8º registro"
"[english]npc_dota_journal_note_08"	"Day 41 : Entry 8"
"npc_dota_journal_note_09"	"Dia 46: 9º registro"
"[english]npc_dota_journal_note_09"	"Day 46 : Entry 9"
"npc_dota_journal_note_10"	"Dia 57: 10º registro"
"[english]npc_dota_journal_note_10"	"Day 57 : Entry 10"
"npc_dota_journal_note_11"	"Dia 66: 11º registro"
"[english]npc_dota_journal_note_11"	"Day 66 : Entry 11"
"chef_journal_01"	"Logo logo, as Orquídeas Brancas estarão se reunindo novamente. Se eu quiser me juntar à ordem dos aventureiros da culinária em agosto, preciso encontrar algo à altura do paladar deles."
"[english]chef_journal_01"	"Time is running short before the White Orchids gather again.  If I wish to join this august order of culinary adventurers, I need to find something worthy of their palate."
"chef_journal_02"	"No ano passado eu pensei que o meu filé de serpe seria o suficiente para ganhar o meu broche, mas apenas um novo membro é aceito a cada ano e eu subestimei os meus concorrentes... nem nos meus sonhos mais loucos eu imaginei que alguém prepararia uma tábua de queijos de Roshan."
"[english]chef_journal_02"	"Last year I thought my wyvern filets would have been enough to earn my pin, but only one new member is admitted each year and I underestimated my competition... never in my wildest dreams did I expect someone to prepare a wheel of Roshan cheese."
"chef_journal_03"	"Neste ano, porém, eu tenho uma arma secreta... um tronco de temperos da Ilha das Máscaras. Se eu encontrar o prato certo para acompanhar essas especiarias perdidas, a minha vaga está garantida."
"[english]chef_journal_03"	"This year though, I have a secret weapon... a trunk of seasoning from The Isle of Masks.  If I find the right dish to pair these lost spices with, my membership is all but assured."
"chef_journal_04"	"A minha expedição pela Mata Uivante tem sido um fracasso. O conflito entre os Ogros dos Ossos e Lucius Garralonga assustou toda a vida selvagem, com exceção dos ursos infernais... o que talvez seja o suficiente."
"[english]chef_journal_04"	"My expedition to the Howling Weald has so far been a failure.  The conflict between the Bonemeal Ogres and Lucius Longclaw scared away most of the wildlife save for the hellbears... but perhaps that is enough to work with."
"chef_journal_05"	"Parece que os lobos temidos não têm uma carne muito boa para a alta gastronomia, mas os espinhos são perfeitos para serem usados como espetos para a proteína da vez."
"[english]chef_journal_05"	"It seems dire wolves are too gamey to be used for elevated cuisine, but the quills are perfect to be fashioned into skewers for whatever protein will be featured."
"chef_journal_06"	"Ovos de aranhas de Atolasseda têm um azedinho saboroso. Porém, pela quantidade de vômito desde que eu comi alguns, acho que é melhor abandonar a ideia de utilizá-los em uma sobremesa."
"[english]chef_journal_06"	"Silkmire spider eggs are pleasingly tart.  However, based on the amount of vomiting I did after eating some, I think it’s best that I abandon dreams of using these to make a dessert."
"chef_journal_07"	"Com Atolasseda para trás, eu me volto para um templo há muito esquecido. Talvez uma trufa rara me aguarde na tumba de um rei antigo, ou quem sabe o veneno de um dardo antigo possa ser diluído e dê um caldo."
"[english]chef_journal_07"	"With Silkmire behind me I turn to a temple long since forgotten.  Perhaps a rare truffle waits to be found in a dead king's tomb, or maybe the poison from an old dart trap could be diluted and used in broth."
"chef_journal_08"	"O templo não foi tão fértil como eu esperava. Morcegos de pedra, embora bons substitutos para o pilão, não são comestíveis."
"[english]chef_journal_08"	"The temple did not prove as fertile as I had hoped.  Stone bats, while a viable option for a kitschy pestle, are not particularly edible."
"chef_journal_09"	"Por três dias persegui um couro-de-trovão alfa, mas não deu em nada — um grupo de caçadores de Marrowfell pôs os olhos na grande fera... e eu sei os riscos de comprar briga com uma manada de centauros raivosos."
"[english]chef_journal_09"	"For three days I tracked a thunderhide alpha, but it was all for naught - a Marrowfell hunting party all had eyes on the great beast... and I know better than to quibble over poaching rights with a pack of angry centaurs."
"chef_journal_10"	"E novamente eu encontrei o fracasso. Com o tempo se esgotando antes da competição, eu preciso ir ainda mais fundo e encontrar uma nova ideia: é hora do vinho."
"[english]chef_journal_10"	"Again I have been met with failure.  With time running short before the competition, I must dig deep and find a new solution:  Time to break out the wine."
"chef_journal_11"	"Kalabor será perda do pouco tempo que resta. Se não posso colher frutos na terra, preciso me voltar para o mar. Se não consigo encontrar uma única proteína nas águas negras que cercam o Recife Sombrio, posso mesmo me considerar um gastromante?"
"[english]chef_journal_11"	"Kalabor is a waste of what little time remains. If land is bearing no fruit, I must turn to the seas.  If I can't find a worthy protein in the black waters surrounding Dark Reef, can I even call myself a gastromancer?"
"npc_dota_creature_small_hellbear"	"Urso Infernal Florestal"
"[english]npc_dota_creature_small_hellbear"	"Woodland Hellbear"
"npc_dota_creature_hellbear"	"Urso Infernal Guerreiro"
"[english]npc_dota_creature_hellbear"	"Berzerker Hellbear"
"npc_dota_creature_dire_hound_boss"	"Lobo Infernal Alfa"
"[english]npc_dota_creature_dire_hound_boss"	"Alpha Dire Hound"
"npc_dota_creature_dire_hound"	"Lobo Infernal"
"[english]npc_dota_creature_dire_hound"	"Dire Hound"
"npc_dota_creature_ghost"	"Alma Penada"
"[english]npc_dota_creature_ghost"	"Banshee"
"npc_dota_creature_small_ghost"	"Fantasma"
"[english]npc_dota_creature_small_ghost"	"Crone"
"npc_dota_creature_ogre_magi"	"Ogro dos Ossos"
"[english]npc_dota_creature_ogre_magi"	"Bonemeal Ogre"
"npc_dota_creature_ogre_tank"	"Tanque dos Ossos"
"[english]npc_dota_creature_ogre_tank"	"Bonemeal Tank"
"npc_dota_creature_ogre_seer"	"Profeta dos Ossos"
"[english]npc_dota_creature_ogre_seer"	"Bonemeal Seer"
"npc_dota_creature_ogre_tank_boss"	"Bogdugg"
"[english]npc_dota_creature_ogre_tank_boss"	"Bogdugg"
"npc_dota_creature_friendly_ogre_tank"	"Burp"
"[english]npc_dota_creature_friendly_ogre_tank"	"Burp"
"npc_dota_creature_werewolf"	"Troca-peles Garralonga"
"[english]npc_dota_creature_werewolf"	"Longclaw Skinchanger"
"npc_dota_creature_lycan_boss"	"Lucius Garralonga"
"[english]npc_dota_creature_lycan_boss"	"Lucius Longclaw"
"npc_dota_dungeon_start_building"	"Posto da Salmoura"
"[english]npc_dota_dungeon_start_building"	"Brine Post"
"npc_dota_rescue_cage"	"Gaiola Enferrujada"
"[english]npc_dota_rescue_cage"	"Tetanus Cage"
"npc_dota_forest_camp_chief"	"Comandante Targan"
"[english]npc_dota_forest_camp_chief"	"Commander Targan"
"npc_dota_radiant_captain"	"Capitão Pé-leve"
"[english]npc_dota_radiant_captain"	"Captain Lightfoot"
"npc_dota_radiant_soldier"	"Lacaio"
"[english]npc_dota_radiant_soldier"	"Footman"
"npc_dota_holdout_tower"	"Torre de vigia"
"[english]npc_dota_holdout_tower"	"Watchtower"
"npc_treasure_chest"	"Baú de Tesouro"
"[english]npc_treasure_chest"	"Treasure Chest"
"npc_dota_creature_techies_land_mine"	"Mina Terrestre"
"[english]npc_dota_creature_techies_land_mine"	"Land Mine"
"trap_sun_strike"	"Raio Solar"
"[english]trap_sun_strike"	"Sun Strike"
"npc_dota_creature_spider_small"	"Enxame de Atolasseda"
"[english]npc_dota_creature_spider_small"	"Silkmire Swarmer"
"npc_dota_creature_spider_medium"	"Cuspidora de Atolasseda"
"[english]npc_dota_creature_spider_medium"	"Silkmire Spitter"
"npc_dota_creature_kidnap_spider"	"Saqueadora de Atolasseda"
"[english]npc_dota_creature_kidnap_spider"	"Silkmire Marauder"
"npc_dota_spider_sack"	"Saco de Ovos Pulsante"
"[english]npc_dota_spider_sack"	"Pulsing Egg Sack"
"npc_dota_spider_web"	"Aço de Atolasseda"
"[english]npc_dota_spider_web"	"Silkmire Steel"
"npc_dota_creature_spider_boss"	"Ankaboot"
"[english]npc_dota_creature_spider_boss"	"Ankaboot"
"npc_dota_creature_small_lycosidae"	"Cria de Ankaboot"
"[english]npc_dota_creature_small_lycosidae"	"Ankaboot's Brood"
"npc_dota_creature_burrower"	"Entocador do Enxame Arenoso"
"[english]npc_dota_creature_burrower"	"Sandswarm Burrower"
"npc_dota_creature_giant_burrower"	"Entocador Gigante do Enxame Arenoso"
"[english]npc_dota_creature_giant_burrower"	"Giant Sandswarm Burrower"
"npc_dota_creature_exploding_burrower"	"Ruptor do Enxame Arenoso"
"[english]npc_dota_creature_exploding_burrower"	"Sandswarm Burster"
"npc_dota_creature_big_exploding_burrower"	"Ruptor-rei do Enxame Arenoso"
"[english]npc_dota_creature_big_exploding_burrower"	"King Sandswarm Burster"
"npc_dota_creature_healing_burrower"	"Sacrifício do Enxame Arenoso"
"[english]npc_dota_creature_healing_burrower"	"Sandswarm Sacrifice"
"npc_dota_creature_nyx_small"	"Rastejador do Enxame Arenoso"
"[english]npc_dota_creature_nyx_small"	"Sandswarm Skitterling"
"npc_dota_creature_bandit_captain"	"Capitão de Sabaku"
"[english]npc_dota_creature_bandit_captain"	"Sabaku Captain"
"npc_dota_creature_bandit"	"Ladrão de Sabaku"
"[english]npc_dota_creature_bandit"	"Sabaku Thief"
"npc_dota_creature_bandit_archer"	"Arqueiro de Sabaku"
"[english]npc_dota_creature_bandit_archer"	"Sabaku Archer"
"npc_dota_creature_centaur_warlord"	"Centauro Guerreiro"
"[english]npc_dota_creature_centaur_warlord"	"Centaur Warlord"
"npc_dota_creature_centaur_scout"	"Centauro Explorador"
"[english]npc_dota_creature_centaur_scout"	"Centaur Scout"
"npc_dota_creature_centaur_dunerunner"	"Centauro Corredunas"
"[english]npc_dota_creature_centaur_dunerunner"	"Centaur Dune Runner"
"npc_dota_creature_centaur_shaman"	"Centauro Xamã"
"[english]npc_dota_creature_centaur_shaman"	"Centaur Shaman"
"npc_dota_creature_bat"	"Golem Asa-negra"
"[english]npc_dota_creature_bat"	"Darkwing Golem"
"npc_dota_creature_bat_spitter"	"Cuspidor Asa-negra"
"[english]npc_dota_creature_bat_spitter"	"Darkwing Spitter"
"npc_dota_creature_temple_guardian"	"Guardião do Templo"
"[english]npc_dota_creature_temple_guardian"	"Temple Guardian"
"npc_dota_friendly_bristleback"	"Jungtrall"
"[english]npc_dota_friendly_bristleback"	"Jungtrall"
"npc_dota_friendly_bristleback_son"	"Brigwyr"
"[english]npc_dota_friendly_bristleback_son"	"Brigwyr"
"npc_dota_bristleback_grandpa"	"Sathington"
"[english]npc_dota_bristleback_grandpa"	"Sathington"
"npc_dota_creature_sand_king"	"Rhyzik"
"[english]npc_dota_creature_sand_king"	"Rhyzik"
"npc_dota_sand_king_sandstorm"	"Tempestade de Areia de Rhyzik"
"[english]npc_dota_sand_king_sandstorm"	"Rhyzik's Sandstorm"
"npc_dota_creature_catapult"	"Catapulta Quebra-linha"
"[english]npc_dota_creature_catapult"	"Linebreaker Catapult"
"npc_dota_assault_melee_rax"	"Quartéis de Lacaios"
"[english]npc_dota_assault_melee_rax"	"Footman Barracks"
"npc_dota_assault_ranged_rax"	"Quartéis de Magos"
"[english]npc_dota_assault_ranged_rax"	"Mage Barracks"
"npc_dota_assault_bad_melee_creep"	"Soldado Buzzick"
"[english]npc_dota_assault_bad_melee_creep"	"Buzzick Footman"
"npc_dota_assault_bad_ranged_creep"	"Mago Buzzick"
"[english]npc_dota_assault_bad_ranged_creep"	"Buzzick Mage"
"npc_dota_dire_assault_captain"	"Capitão Buzzick"
"[english]npc_dota_dire_assault_captain"	"Buzzick Captain"
"npc_dota_assault_good_melee_creep"	"Soldado de Kalabor"
"[english]npc_dota_assault_good_melee_creep"	"Kalabor Footman"
"npc_dota_assault_good_ranged_creep"	"Mago de Kalabor"
"[english]npc_dota_assault_good_ranged_creep"	"Kalabor Mage"
"npc_dota_burrower_mound"	"Monte Vent'levou"
"[english]npc_dota_burrower_mound"	"Windswept Mound"
"npc_dota_creature_living_treasure"	"Escaravelho Solitário"
"[english]npc_dota_creature_living_treasure"	"Lonely Scarab"
"npc_dota_desert_townfolk_1"	"Wellum Potes"
"[english]npc_dota_desert_townfolk_1"	"Wellum Potes"
"npc_dota_desert_townfolk_2"	"Marica Basil"
"[english]npc_dota_desert_townfolk_2"	"Marica Basil"
"npc_dota_desert_townfolk_3"	"Pip Bon Aire"
"[english]npc_dota_desert_townfolk_3"	"Pip Bon Aire"
"npc_dota_desert_townfolk_4"	"Hathe Moonie"
"[english]npc_dota_desert_townfolk_4"	"Hathe Moonie"
"npc_dota_desert_townfolk_5"	"Ed Moor"
"[english]npc_dota_desert_townfolk_5"	"Ed Moor"
"npc_dota_desert_townfolk_6"	"Kane Istan"
"[english]npc_dota_desert_townfolk_6"	"Kane Istan"
"npc_dota_desert_townfolk_7"	"Donce Cesa"
"[english]npc_dota_desert_townfolk_7"	"Donce Cesa"
"npc_dota_injured_contact"	"Theod"
"[english]npc_dota_injured_contact"	"Theod"
"npc_dota_creature_invoker"	"Mago Sombrio"
"[english]npc_dota_creature_invoker"	"The Dark Magus"
"npc_dota_temple_wisp"	"Aibi"
"[english]npc_dota_temple_wisp"	"Aibi"
"npc_dota_fire_trap_ward_unified"	"Armadilha de Fogo Arcano"
"[english]npc_dota_fire_trap_ward_unified"	"Arcane Fire Trap"
"npc_dota_fire_trap_ward"	"Armadilha de Fogo Arcano"
"[english]npc_dota_fire_trap_ward"	"Arcane Fire Trap"
"npc_dota_stone_trap_ward"	"Armadilha de Flecha"
"[english]npc_dota_stone_trap_ward"	"Arrow Trap"
"npc_dota_poisoncloud_trap_ward"	"Armadilha Venenosa"
"[english]npc_dota_poisoncloud_trap_ward"	"Poison Trap"
"npc_dota_forest_holdout_gate"	"Portão"
"[english]npc_dota_forest_holdout_gate"	"Gate"
"npc_dota_dungeon_checkpoint"	"Ponto de controle"
"[english]npc_dota_dungeon_checkpoint"	"Checkpoint"
"npc_dota_forest_camp_small_tent"	"Barraca"
"[english]npc_dota_forest_camp_small_tent"	"Tent"
"npc_dota_forest_camp_medium_tent"	"Barraca"
"[english]npc_dota_forest_camp_medium_tent"	"Tent"
"npc_dota_forest_camp_fade_top_tent"	"Barraca"
"[english]npc_dota_forest_camp_fade_top_tent"	"Tent"
"npc_dota_forest_holdout_fence"	"Paliçada"
"[english]npc_dota_forest_holdout_fence"	"Stockade"
"npc_dota_forest_assault_fence"	"Paliçada"
"[english]npc_dota_forest_assault_fence"	"Stockade"
"npc_dota_forest_camp_melee_creep_1"	"Soldado"
"[english]npc_dota_forest_camp_melee_creep_1"	"Footman"
"npc_dota_forest_camp_melee_creep_2"	"Soldado"
"[english]npc_dota_forest_camp_melee_creep_2"	"Footman"
"npc_dota_forest_camp_melee_creep_3"	"Soldado"
"[english]npc_dota_forest_camp_melee_creep_3"	"Footman"
"npc_dota_forest_camp_melee_creep_4"	"Soldado"
"[english]npc_dota_forest_camp_melee_creep_4"	"Footman"
"npc_dota_forest_camp_melee_creep_5"	"Soldado"
"[english]npc_dota_forest_camp_melee_creep_5"	"Footman"
"DOTA_Tooltip_ability_holdout_shackleshot"	"Amarras"
"[english]DOTA_Tooltip_ability_holdout_shackleshot"	"Shackleshot"
"DOTA_Tooltip_ability_holdout_shackleshot_Description"	"Em inglês: <font color='#F2A93E'>Shackleshot</font>\n \nPrende o alvo a uma unidade inimiga ou árvore em uma linha diretamente atrás dele. Se não houver uma unidade ou árvore, o tempo de atordoamento é reduzido para 0,75 segundo. <font color='#70EA72'> Se uma segunda unidade é amarrada, a amarra rebaterá e continuará atrás daquela unidade, até que o limite seja alcançado ou que nenhuma unidade ou árvore for encontrada.</font>"
"[english]DOTA_Tooltip_ability_holdout_shackleshot_Description"	"Shackles the target to enemy units or a tree in a line directly behind it.  If no unit or tree is present, the stun duration is reduced to 0.75.  <font color='#70EA72'>If a shackle is made to a second unit, the shackle will bounce and continue behind that unit, until the max count is reached or no unit or tree is found.</font>"
"DOTA_Tooltip_ability_holdout_shackleshot_Lore"	"A variedade de habilidades com o arco da Windranger inclui uma flecha ligada a grossas cordas que amarram qualquer alvo que tente escapar."
"[english]DOTA_Tooltip_ability_holdout_shackleshot_Lore"	"Windranger's variety of bow skills includes an arrow with thick ropes attached to encumber any escaping target."
"DOTA_Tooltip_ability_holdout_shackleshot_shackle_count"	"<font color='#70EA72'>AMARRAS:</font>"
"[english]DOTA_Tooltip_ability_holdout_shackleshot_shackle_count"	"<font color='#70EA72'>SHACKLE COUNT:</font>"
"DOTA_Tooltip_ability_holdout_shackleshot_Note0"	"Esta habilidade pode amarrar dois inimigos juntos, atordoando ambos."
"[english]DOTA_Tooltip_ability_holdout_shackleshot_Note0"	"This spell can shackle two enemies together, stunning them both."
"DOTA_Tooltip_ability_holdout_shackleshot_Note1"	"Pode prender o alvo a uma unidade inimiga ou árvore em um raio de 525/500 unidades atrás dele."
"[english]DOTA_Tooltip_ability_holdout_shackleshot_Note1"	"Can shackle the target to an enemy unit or tree at most 525/500 behind it."
"DOTA_Tooltip_ability_holdout_shackleshot_Note2"	"Esta magia não pode ser anulada."
"[english]DOTA_Tooltip_ability_holdout_shackleshot_Note2"	"Shackleshot cannot be disjointed."
"DOTA_Tooltip_ability_holdout_shackleshot_stun_duration"	"<font color='#70EA72'>DURAÇÃO DAS AMARRAS:</font>"
"[english]DOTA_Tooltip_ability_holdout_shackleshot_stun_duration"	"<font color='#70EA72'>SHACKLE DURATION:</font>"
"DOTA_Tooltip_ability_holdout_windrun"	"Correr nos Ventos"
"[english]DOTA_Tooltip_ability_holdout_windrun"	"Windrun"
"DOTA_Tooltip_ability_holdout_windrun_Description"	"Em inglês: <font color='#F2A93E'>Windrun</font>\n \nAumenta a velocidade de movimento e adiciona esquiva contra todos os ataques físicos, enquanto retarda o movimento de inimigos próximos."
"[english]DOTA_Tooltip_ability_holdout_windrun_Description"	"Increases movement speed and adds evasion from all physical attacks, while slowing movement of nearby enemies."
"DOTA_Tooltip_ability_holdout_windrun_Lore"	"Lyralei encanta rajadas de vento que lutam contra ataques iminentes."
"[english]DOTA_Tooltip_ability_holdout_windrun_Lore"	"True to her namesake, Lyralei enchants gusts of winds to flight incoming attacks."
"DOTA_Tooltip_ability_holdout_windrun_Note0"	"O retardo afetará inimigos sob efeito de imunidade a magias."
"[english]DOTA_Tooltip_ability_holdout_windrun_Note0"	"The slow will affect enemies with magic immunity."
"DOTA_Tooltip_ability_holdout_windrun_Note1"	"Correr com os Ventos não fará com que se esquive de projéteis disparados antes da habilidade ser ativada."
"[english]DOTA_Tooltip_ability_holdout_windrun_Note1"	"Windrun will not evade projectiles that were created before it was activated."
"DOTA_Tooltip_ability_holdout_windrun_enemy_movespeed_bonus_pct"	"%<font color='#70EA72'>RETARDO DO INIMIGO:</font>"
"[english]DOTA_Tooltip_ability_holdout_windrun_enemy_movespeed_bonus_pct"	"%<font color='#70EA72'>ENEMY SLOW:</font>"
"DOTA_Tooltip_ability_holdout_windrun_movespeed_bonus_pct"	"%BÔNUS DE VELOCIDADE DE MOVIMENTO:"
"[english]DOTA_Tooltip_ability_holdout_windrun_movespeed_bonus_pct"	"%MOVE SPEED BONUS:"
"DOTA_Tooltip_ability_holdout_windrun_duration"	"<font color='#70EA72'>DURAÇÃO:</font>"
"[english]DOTA_Tooltip_ability_holdout_windrun_duration"	"<font color='#70EA72'>DURATION:</font>"
"DOTA_Tooltip_ability_holdout_windrun_radius"	"<font color='#70EA72'>RAIO:</font>"
"[english]DOTA_Tooltip_ability_holdout_windrun_radius"	"<font color='#70EA72'>RADIUS:</font>"
"DOTA_Tooltip_ability_holdout_focusfire"	"Zéfiro"
"[english]DOTA_Tooltip_ability_holdout_focusfire"	"Zephyr"
"DOTA_Tooltip_ability_holdout_focusfire_Description"	"Em inglês: <font color='#F2A93E'>Zephyr</font>\n \nA Windranger canaliza o vento, ganhando velocidade de ataque máxima, porém com dano reduzido, incluindo dano de modificadores únicos de ataque e efeitos de itens. Dura 20 segundos. <font color='#70EA72'>Com cada ataque, a Windranger possui a chance de disparar uma flecha adicional em um alvo ao redor da unidade atacada. Dura 20 segundos.</font>"
"[english]DOTA_Tooltip_ability_holdout_focusfire_Description"	"Windranger channels the wind, gaining maximum attack speed, although with reduced damage, including damage from Unique Attack Modifiers and item effects. <font color='#70EA72'>With each attack, Windranger has a chance to fire an additional arrow at a target within a radius of the attacked unit. Lasts 20 seconds.</font>"
"DOTA_Tooltip_ability_holdout_focusfire_Lore"	"A habilidade de Lyralei de bombardear oponentes com uma enxurrada de flechas é incomparável — mesmo em detrimento da precisão."
"[english]DOTA_Tooltip_ability_holdout_focusfire_Lore"	"Lyralei's ability to bombard opponents with a flurry of arrows is unparalleled - even at the expense of accuracy."
"DOTA_Tooltip_ability_holdout_focusfire_Note0"	"Pode ser usada em estruturas e unidades sob efeito de imunidade a magias."
"[english]DOTA_Tooltip_ability_holdout_focusfire_Note0"	"Can target buildings and magic immune units."
"DOTA_Tooltip_ability_holdout_focusfire_focusfire_damage_reduction"	"%REDUÇÃO DE DANO:"
"[english]DOTA_Tooltip_ability_holdout_focusfire_focusfire_damage_reduction"	"%DAMAGE REDUCTION:"
"DOTA_Tooltip_ability_holdout_focusfire_bonus_arrow_chance"	"%<font color='#70EA72'>CHANCE DE FLECHADA ADICIONAL:</font>"
"[english]DOTA_Tooltip_ability_holdout_focusfire_bonus_arrow_chance"	"%<font color='#70EA72'>BONUS ARROW CHANCE:</font>"
"DOTA_Tooltip_ability_holdout_focusfire_bonus_arrow_radius"	"<font color='#70EA72'>RAIO DA FLECHADA ADICIONAL:</font>"
"[english]DOTA_Tooltip_ability_holdout_focusfire_bonus_arrow_radius"	"<font color='#70EA72'>BONUS ARROW RADIUS:</font>"
"DOTA_Tooltip_ability_holdout_focusfire_bonus_arrows"	"<font color='#70EA72'>FLECHADAS ADICIONAIS:</font>"
"[english]DOTA_Tooltip_ability_holdout_focusfire_bonus_arrows"	"<font color='#70EA72'>BONUS ARROWS:</font>"
"DOTA_Tooltip_ability_holdout_glacier_arrows"	"Flechas de Gelo"
"[english]DOTA_Tooltip_ability_holdout_glacier_arrows"	"Frost Arrows"
"DOTA_Tooltip_ability_holdout_glacier_arrows_Description"	"Em inglês: <font color='#F2A93E'>Frost Arrows</font>\n \nAdiciona um efeito congelante aos ataques da Drow, retardando o movimento do inimigo.\n\nFlechas de Gelo é um modificador único de ataque e não acumula com outros modificadores únicos de ataque."
"[english]DOTA_Tooltip_ability_holdout_glacier_arrows_Description"	"Adds a freezing effect to Drow's attacks, slowing enemy movement.\n\nFrost Arrows is a Unique Attack Modifier, and does not stack with other Unique Attack Modifiers."
"DOTA_Tooltip_ability_holdout_glacier_arrows_Lore"	"As flechas encantadas com gelo atravessam o silêncio, congelando os seus inimigos até a medula."
"[english]DOTA_Tooltip_ability_holdout_glacier_arrows_Lore"	"Ice-encased arrows pierce the silence, chilling their victims to the core."
"DOTA_Tooltip_ability_holdout_glacier_arrows_Note0"	"A duração do retardo é reiniciada a cada lançamento sucessivo."
"[english]DOTA_Tooltip_ability_holdout_glacier_arrows_Note0"	"The slow duration is refreshed on successive casts."
"DOTA_Tooltip_ability_holdout_glacier_arrows_frost_arrows_movement_speed"	"%VELOCIDADE DE MOVIMENTO:"
"[english]DOTA_Tooltip_ability_holdout_glacier_arrows_frost_arrows_movement_speed"	"%MOVE SPEED:"
"DOTA_Tooltip_ability_holdout_glacier_arrows_slow_duration"	"DURAÇÃO DO RETARDO:"
"[english]DOTA_Tooltip_ability_holdout_glacier_arrows_slow_duration"	"SLOW DURATION:"
"DOTA_Tooltip_ability_holdout_multishot"	"Disparo Supressor"
"[english]DOTA_Tooltip_ability_holdout_multishot"	"Quelling Shot"
"DOTA_Tooltip_ability_holdout_multishot_Description"	"Em inglês: <font color='#F2A93E'>Quelling Shot</font>\n \n<font color='#70EA72'>As flechas da Drow se dividem na frente dela em forma de cone, causando menos dano mas atingindo múltiplos alvos. Cada flecha pode atingir apenas um alvo. Se as <font color='#F2A93E'>Flechas de Gelo</font> estiverem ativas, as flechas do Disparo Supressor serão convertidas para Flechas de Gelo, aumentando o custo de mana por flecha.</font>\n\nDisparo Supressor é um modificador único de ataque e não acumula com outros modificadores únicos de ataque."
"[english]DOTA_Tooltip_ability_holdout_multishot_Description"	"<font color='#70EA72'>Drow's arrow splits in front of her in a cone shape, dealing less damage but cleaving multiple targets.  If Frost Arrows is activated, Quelling Shot's arrows will be converted to Frost Arrows, increasing the mana cost per arrow.</font>\n\nQuelling Shot is a Unique Attack Modifier, and does not stack with other Unique Attack Modifiers."
"DOTA_Tooltip_ability_holdout_multishot_arrow_range"	"ALCANCE:"
"[english]DOTA_Tooltip_ability_holdout_multishot_arrow_range"	"RANGE:"
"DOTA_Tooltip_ability_holdout_multishot_arrow_count"	"FLECHAS:"
"[english]DOTA_Tooltip_ability_holdout_multishot_arrow_count"	"ARROW COUNT:"
"DOTA_Tooltip_ability_holdout_multishot_damage_reduction_pct"	"%REDUÇÃO DE DANO:"
"[english]DOTA_Tooltip_ability_holdout_multishot_damage_reduction_pct"	"%DAMAGE REDUCTION:"
"DOTA_Tooltip_ability_holdout_marksmanship"	"Pontaria"
"[english]DOTA_Tooltip_ability_holdout_marksmanship"	"Marksmanship"
"DOTA_Tooltip_ability_holdout_marksmanship_Description"	"Em inglês: <font color='#F2A93E'>Marksmanship</font>\n \nAs experiências em batalhas da Drow melhoram a sua precisão e eficiência no combate, fornecendo um bônus passivo à sua Agilidade. <font color='#70EA72'>O bônus é removido caso haja unidades inimigas em uma área de 150 unidades ao redor da Drow.</font>"
"[english]DOTA_Tooltip_ability_holdout_marksmanship_Description"	"Drow's experiences in battle improve her accuracy and effectiveness in combat, providing a passive bonus to Agility. <font color='#70EA72'>Grants no bonus if there are enemy creatures within an area of effect.</font>"
"DOTA_Tooltip_ability_holdout_marksmanship_Lore"	"A Drow Ranger é a quintessência da proeza com um arco."
"[english]DOTA_Tooltip_ability_holdout_marksmanship_Lore"	"The Drow Ranger is the epitome of archery prowess."
"DOTA_Tooltip_ability_holdout_marksmanship_marksmanship_agility_bonus"	"AGILIDADE ADICIONAL:"
"[english]DOTA_Tooltip_ability_holdout_marksmanship_marksmanship_agility_bonus"	"BONUS AGILITY:"
"DOTA_Tooltip_ability_holdout_marksmanship_radius"	"<font color='#70EA72'>RAIO:</font>"
"[english]DOTA_Tooltip_ability_holdout_marksmanship_radius"	"<font color='#70EA72'>RADIUS:</font>"
"DOTA_Tooltip_ability_holdout_storm_bolt"	"Punho da Tempestade"
"[english]DOTA_Tooltip_ability_holdout_storm_bolt"	"Storm Hammer"
"DOTA_Tooltip_ability_holdout_storm_bolt_Description"	"Em inglês: <font color='#F2A93E'>Storm Hammer</font>\n \nSven libera a sua luva mágica que causa dano e atordoa unidades inimigas."
"[english]DOTA_Tooltip_ability_holdout_storm_bolt_Description"	"Sven unleashes his magical gauntlet that deals damage and stuns enemy units."
"DOTA_Tooltip_ability_holdout_storm_bolt_Lore"	"A luva de ferro do Cavaleiro Rebelde, tomada da escola de seu pai, golpeia os seus inimigos bem fundo."
"[english]DOTA_Tooltip_ability_holdout_storm_bolt_Lore"	"The Rogue Knight's iron gauntlet, taken from the school of his father, strikes his foes to their core."
"DOTA_Tooltip_ability_holdout_storm_bolt_Note0"	" "
"[english]DOTA_Tooltip_ability_holdout_storm_bolt_Note0"	"Storm Hammer can only be disjointed by going invisible."
"DOTA_Tooltip_ability_holdout_storm_bolt_bolt_stun_duration"	"DURAÇÃO:"
"[english]DOTA_Tooltip_ability_holdout_storm_bolt_bolt_stun_duration"	"DURATION:"
"DOTA_Tooltip_ability_holdout_storm_bolt_bolt_aoe"	"RAIO:"
"[english]DOTA_Tooltip_ability_holdout_storm_bolt_bolt_aoe"	"RADIUS:"
"DOTA_Tooltip_ability_holdout_great_cleave"	"Grande Transposição"
"[english]DOTA_Tooltip_ability_holdout_great_cleave"	"Great Cleave"
"DOTA_Tooltip_ability_holdout_great_cleave_Description"	"Em inglês: <font color='#F2A93E'>Great Cleave</font>\n \nSven golpeia com muita força, transpondo o seu dano de ataque a unidades inimigas próximas."
"[english]DOTA_Tooltip_ability_holdout_great_cleave_Description"	"Sven strikes with great force, cleaving all nearby enemy units with his attack."
"DOTA_Tooltip_ability_holdout_great_cleave_Lore"	"Os Cavaleiros da Vigília ainda buscam recuperar a perdida Lâmina Exilada de Sven, uma arma capaz de abrir grandes caminhos através de guerreiros mais fracos."
"[english]DOTA_Tooltip_ability_holdout_great_cleave_Lore"	"The Vigil Knights still seek to reclaim the stolen Outcast Blade from Sven, a weapon capable of cutting wide swaths through lesser warriors."
"DOTA_Tooltip_ability_holdout_great_cleave_Note0"	"O dano transposto é reduzido pelo tipo de armadura, mas não pelo valor."
"[english]DOTA_Tooltip_ability_holdout_great_cleave_Note0"	"Cleave damage is reduced by armor type but not by armor value."
"DOTA_Tooltip_ability_holdout_great_cleave_Note1"	"O dano transposto atravessa imunidade a dano mágico."
"[english]DOTA_Tooltip_ability_holdout_great_cleave_Note1"	"Cleave damage goes through magic immunity."
"DOTA_Tooltip_ability_holdout_great_cleave_Note2"	"O dano é transposto em uma área circular à frente do Sven."
"[english]DOTA_Tooltip_ability_holdout_great_cleave_Note2"	"The cleave damages a circular area in front of Sven."
"DOTA_Tooltip_ability_holdout_great_cleave_great_cleave_damage"	"%DANO TRANSPOSTO:"
"[english]DOTA_Tooltip_ability_holdout_great_cleave_great_cleave_damage"	"%CLEAVE DAMAGE:"
"DOTA_Tooltip_ability_holdout_great_cleave_great_cleave_radius"	"RAIO:"
"[english]DOTA_Tooltip_ability_holdout_great_cleave_great_cleave_radius"	"RADIUS:"
"DOTA_Tooltip_ability_holdout_great_cleave_great_cleave_notes"	"Observações:\n\nA transposição causa dano em uma área circular à frente de Sven.\n\nO dano transposto é reduzido pelo tipo de armadura, mas não pelo valor, além de ignorar imunidade a magias."
"[english]DOTA_Tooltip_ability_holdout_great_cleave_great_cleave_notes"	"Notes:\n\nCleave damage is reduced by armor type but not by armor value.\n\nCleave damage goes through magic immunity.\n\nThe cleave damages a circular area in front of Sven."
"DOTA_Tooltip_ability_dungeon_sven_great_cleave"	"Grande Transposição"
"[english]DOTA_Tooltip_ability_dungeon_sven_great_cleave"	"Great Cleave"
"DOTA_Tooltip_ability_dungeon_sven_great_cleave_Description"	"Em inglês: <font color='#F2A93E'>Great Cleave</font>\n \nSven golpeia com muita força, transpondo o seu dano de ataque a unidades inimigas próximas."
"[english]DOTA_Tooltip_ability_dungeon_sven_great_cleave_Description"	"Sven strikes with great force, cleaving all nearby enemy units with his attack."
"DOTA_Tooltip_ability_dungeon_sven_great_cleave_Lore"	"Os Cavaleiros da Vigília ainda buscam recuperar a perdida Lâmina Exilada de Sven, uma arma capaz de abrir grandes caminhos através de guerreiros mais fracos."
"[english]DOTA_Tooltip_ability_dungeon_sven_great_cleave_Lore"	"The Vigil Knights still seek to reclaim the stolen Outcast Blade from Sven, a weapon capable of cutting wide swaths through lesser warriors."
"DOTA_Tooltip_ability_dungeon_sven_great_cleave_Note0"	"O dano transposto é reduzido pelo tipo de armadura, mas não pelo valor."
"[english]DOTA_Tooltip_ability_dungeon_sven_great_cleave_Note0"	"Cleave damage is reduced by armor type but not by armor value."
"DOTA_Tooltip_ability_dungeon_sven_great_cleave_Note1"	"O dano transposto afeta unidades imunes a magias."
"[english]DOTA_Tooltip_ability_dungeon_sven_great_cleave_Note1"	"Cleave damage goes through spell immunity."
"DOTA_Tooltip_ability_dungeon_sven_great_cleave_Note2"	"O dano é transposto em uma área circular à frente do Sven."
"[english]DOTA_Tooltip_ability_dungeon_sven_great_cleave_Note2"	"The cleave damages a circular area in front of Sven."
"DOTA_Tooltip_ability_dungeon_sven_great_cleave_great_cleave_damage"	"%DANO TRANSPOSTO:"
"[english]DOTA_Tooltip_ability_dungeon_sven_great_cleave_great_cleave_damage"	"%CLEAVE DAMAGE:"
"DOTA_Tooltip_ability_holdout_warcry"	"Grito de Guerra"
"[english]DOTA_Tooltip_ability_holdout_warcry"	"Warcry"
"DOTA_Tooltip_ability_holdout_warcry_Description"	"Em inglês: <font color='#F2A93E'>Warcry</font>\n \nO Grito de Guerra do Sven incentiva os seus aliados a batalhar, aumentando as suas velocidades de movimento e armaduras."
"[english]DOTA_Tooltip_ability_holdout_warcry_Description"	"Sven's Warcry heartens his allies for battle, increasing their movement speed and armor."
"DOTA_Tooltip_ability_holdout_warcry_Lore"	"Invocar algumas das linhas do Códice da Vigília fortifica a obediência de Sven ao seu código rebelde. Tão poético!"
"[english]DOTA_Tooltip_ability_holdout_warcry_Lore"	"Calling a few lines from the Vigil Codex fortifies Sven's obedience to his rogue code. So poetic!"
"DOTA_Tooltip_ability_holdout_warcry_Note0"	"Acumula-se completamente com outras habilidades que fornecem armadura e velocidade."
"[english]DOTA_Tooltip_ability_holdout_warcry_Note0"	"Fully stacks with other armor and speed granting abilities."
"DOTA_Tooltip_ability_holdout_warcry_warcry_radius"	"RAIO:"
"[english]DOTA_Tooltip_ability_holdout_warcry_warcry_radius"	"RADIUS:"
"DOTA_Tooltip_ability_holdout_warcry_warcry_armor"	"ARMADURA ADICIONAL:"
"[english]DOTA_Tooltip_ability_holdout_warcry_warcry_armor"	"BONUS ARMOR:"
"DOTA_Tooltip_ability_holdout_warcry_warcry_movespeed"	"%<font color='#70EA72'>VELOCIDADE ADICIONAL:</font>"
"[english]DOTA_Tooltip_ability_holdout_warcry_warcry_movespeed"	"%<font color='#70EA72'>BONUS SPEED:</font>"
"DOTA_Tooltip_ability_holdout_warcry_warcry_duration"	"<font color='#70EA72'>DURAÇÃO:</font>"
"[english]DOTA_Tooltip_ability_holdout_warcry_warcry_duration"	"<font color='#70EA72'>DURATION:</font>"
"DOTA_Tooltip_ability_holdout_warcry_warcry_notes"	"Observações:\n\nAcumula com outras auras de bônus de armadura de itens.\n\nAcumula com outras habilidades e itens que fornecem bônus de velocidade de movimento."
"[english]DOTA_Tooltip_ability_holdout_warcry_warcry_notes"	"Notes:\n\nFully stacks with other bonus armor auras from items.\n\nFully stacks with other abilities and items that give a bonus to movement speed."
"DOTA_Tooltip_ability_holdout_gods_strength"	"Força Divina"
"[english]DOTA_Tooltip_ability_holdout_gods_strength"	"God's Strength"
"DOTA_Tooltip_ability_holdout_gods_strength_Description"	"Em inglês: <font color='#F2A93E'>God's Strength</font>\n \n<font color='#70EA72'>Sven ganha um bônus de Força e de dano. Ao matar uma unidade inimiga enquanto estiver sob os efeitos da Força Divina, o intervalo entre uso de todas as habilidades de Sven é reduzido. Este efeito pode ocorrer um número ilimitado de vezes.</font>"
"[english]DOTA_Tooltip_ability_holdout_gods_strength_Description"	"<font color='#70EA72'>Sven gains bonus strength and damage.  Upon killing an enemy unit while under the effects of God's Strength, all of Sven's ability cooldowns are reduced.  This effect can occur an unlimited amount of times.</font>"
"DOTA_Tooltip_ability_holdout_gods_strength_Lore"	"Com a força que estilhaçou o Elmo Sagrado, o Cavaleiro Rebelde se mantém insuperável no combate corpo a corpo."
"[english]DOTA_Tooltip_ability_holdout_gods_strength_Lore"	"With the strength that shattered the Sacred Helm, the Rogue Knight stands unopposed in melee combat."
"DOTA_Tooltip_ability_holdout_gods_strength_bonus_strength"	"FORÇA ADICIONAL:"
"[english]DOTA_Tooltip_ability_holdout_gods_strength_bonus_strength"	"BONUS STRENGTH:"
"DOTA_Tooltip_ability_holdout_gods_strength_cooldown_reduction_per_kill"	"REDUÇÃO DE INTERVALO POR VÍTIMA:"
"[english]DOTA_Tooltip_ability_holdout_gods_strength_cooldown_reduction_per_kill"	"COOLDOWN REDUCTION PER KILL:"
"DOTA_Tooltip_ability_holdout_gods_strength_gods_strength_damage"	"%DANO ADICIONAL:"
"[english]DOTA_Tooltip_ability_holdout_gods_strength_gods_strength_damage"	"%BONUS DAMAGE:"
"DOTA_Tooltip_ability_holdout_gladiators_unite"	"Gladiadores, Unidos!"
"[english]DOTA_Tooltip_ability_holdout_gladiators_unite"	"Gladiators, Unite!"
"DOTA_Tooltip_ability_holdout_gladiators_unite_Description"	"Em inglês: <font color='#F2A93E'>Gladiators, Unite!</font>\n \n<font color='#70EA72'>A Legion Commander convida os seus aliados para lutar juntos em uma arena. Cada herói aliado adicional que se junta à luta recebe um bônus de dano, armadura e roubo de vida para cada combatente na arena.</font>"
"[english]DOTA_Tooltip_ability_holdout_gladiators_unite_Description"	"<font color='#70EA72'>Legion Commander calls her allied heroes together to fight in an arena.  Each additional friendly hero that joins the fight in the arena grants additional bonus damage, armor, and lifesteal to each arena combatant.</font>"
"DOTA_Tooltip_ability_holdout_gladiators_unite_bonus_armor_per_hero"	"ARMADURA ADICIONAL POR HERÓI:"
"[english]DOTA_Tooltip_ability_holdout_gladiators_unite_bonus_armor_per_hero"	"BONUS ARMOR PER HERO:"
"DOTA_Tooltip_ability_holdout_gladiators_unite_bonus_damage_per_hero"	"DANO ADICIONAL POR HERÓI:"
"[english]DOTA_Tooltip_ability_holdout_gladiators_unite_bonus_damage_per_hero"	"BONUS DAMAGE PER HERO:"
"DOTA_Tooltip_ability_holdout_gladiators_unite_lifesteal_per_hero"	"%ROUBO DE VIDA POR HERÓI:"
"[english]DOTA_Tooltip_ability_holdout_gladiators_unite_lifesteal_per_hero"	"%LIFESTEAL PER HERO:"
"DOTA_Tooltip_ability_holdout_gladiators_unite_duration"	"DURAÇÃO:"
"[english]DOTA_Tooltip_ability_holdout_gladiators_unite_duration"	"DURATION:"
"DOTA_Tooltip_ability_holdout_gladiators_unite_radius"	"RAIO:"
"[english]DOTA_Tooltip_ability_holdout_gladiators_unite_radius"	"RADIUS:"
"DOTA_Tooltip_modifier_holdout_gladiators_unite"	"Gladiadores, Unidos!"
"[english]DOTA_Tooltip_modifier_holdout_gladiators_unite"	"Gladiators, Unite!"
"DOTA_Tooltip_modifier_holdout_gladiators_unite_Description"	"Ganhando %dMODIFIER_PROPERTY_PHYSICAL_ARMOR_BONUS% de armadura, %dMODIFIER_PROPERTY_PREATTACK_BONUS_DAMAGE% de dano e %dMODIFIER_PROPERTY_TOOLTIP%%% de roubo de vida em ataques físicos."
"[english]DOTA_Tooltip_modifier_holdout_gladiators_unite_Description"	"Gaining %dMODIFIER_PROPERTY_PHYSICAL_ARMOR_BONUS% bonus armor, %dMODIFIER_PROPERTY_PREATTACK_BONUS_DAMAGE% bonus damage, and %dMODIFIER_PROPERTY_TOOLTIP%%% lifesteal on physical attacks."
"DOTA_Tooltip_ability_holdout_dragon_slave"	"Dragão Escravo"
"[english]DOTA_Tooltip_ability_holdout_dragon_slave"	"Dragon Slave"
"DOTA_Tooltip_ability_holdout_dragon_slave_Description"	"Em inglês: <font color='#F2A93E'>Dragon Slave</font>\n \nLina canaliza o hálito de um dragão, liberando uma onda de fogo que incinera todos os inimigos no seu caminho."
"[english]DOTA_Tooltip_ability_holdout_dragon_slave_Description"	"Lina channels the breath of a dragon, sending out a wave of fire that scorches every enemy in its path."
"DOTA_Tooltip_ability_holdout_dragon_slave_Lore"	"No chamuscado terreno de Misrule, Lina aprendeu a manipular o sopro escaldante do dragão do deserto como forma de entretenimento."
"[english]DOTA_Tooltip_ability_holdout_dragon_slave_Lore"	"In the scorched barren of Misrule, Lina learned to manipulate the fiery breath of the Desert Wyrm as a form of entertainment."
"DOTA_Tooltip_ability_holdout_dragon_slave_Note0"	"Dragão Escravo pode atingir unidades que estão a até 1.225 unidades de distância."
"[english]DOTA_Tooltip_ability_holdout_dragon_slave_Note0"	"Dragon Slave can hit units up to 1225 units away."
"DOTA_Tooltip_ability_holdout_light_strike_array"	"Impacto de Luz Solar"
"[english]DOTA_Tooltip_ability_holdout_light_strike_array"	"Light Strike Array"
"DOTA_Tooltip_ability_holdout_light_strike_array_Description"	"Em inglês: <font color='#F2A93E'>Light Strike Array</font>\n \nInvoca uma coluna de fogo que causa dano e atordoa inimigos."
"[english]DOTA_Tooltip_ability_holdout_light_strike_array_Description"	"Summons a column of flames that damages and stuns enemies."
"DOTA_Tooltip_ability_holdout_light_strike_array_Lore"	"A essência de Lina a permite focar as energias do sol, fazendo com que o ar entre em combustão à sua vontade."
"[english]DOTA_Tooltip_ability_holdout_light_strike_array_Lore"	"Lina's essence allows her to focus the sun's energies, causing air to combust at will."
"DOTA_Tooltip_ability_holdout_light_strike_array_Note0"	"Impacto de Luz Solar destruirá árvores na sua área de efeito."
"[english]DOTA_Tooltip_ability_holdout_light_strike_array_Note0"	"Light Strike Array will destroy trees in its area of effect."
"DOTA_Tooltip_ability_holdout_light_strike_array_light_strike_array_aoe"	"RAIO:"
"[english]DOTA_Tooltip_ability_holdout_light_strike_array_light_strike_array_aoe"	"RADIUS:"
"DOTA_Tooltip_ability_holdout_light_strike_array_light_strike_array_stun_duration"	"DURAÇÃO DO ATORDOAMENTO:"
"[english]DOTA_Tooltip_ability_holdout_light_strike_array_light_strike_array_stun_duration"	"STUN DURATION:"
"DOTA_Tooltip_ability_holdout_light_strike_array_light_strike_array_delay_time"	"ATRASO DE LANÇAMENTO:"
"[english]DOTA_Tooltip_ability_holdout_light_strike_array_light_strike_array_delay_time"	"CAST DELAY:"
"DOTA_Tooltip_ability_holdout_fiery_soul"	"Alma Flamejante"
"[english]DOTA_Tooltip_ability_holdout_fiery_soul"	"Blazing Soul"
"DOTA_Tooltip_ability_holdout_fiery_soul_Description"	"Em inglês: <font color='#F2A93E'>Blazing Soul</font>\n \nFornece bônus de velocidades de ataque e movimento e <font color='#70EA72'>tempo de lançamento reduzido</font> cada vez que Lina lança uma habilidade. Acumula consigo mesma."
"[english]DOTA_Tooltip_ability_holdout_fiery_soul_Description"	"Grants bonus attack speed, movement speed, and <font color='#70EA72'>decreased cast time</font> each time Lina casts a spell. Stacks with itself."
"DOTA_Tooltip_ability_holdout_fiery_soul_Lore"	"Chamas dançantes incorporam-se à natureza brincalhona de Lina, trazendo à tona a sua verdadeira aparência flamejante."
"[english]DOTA_Tooltip_ability_holdout_fiery_soul_Lore"	"Dancing flames embody Lina's playful nature, bringing out her true blazing self."
"DOTA_Tooltip_ability_holdout_fiery_soul_Note0"	"A duração é reiniciada sempre que uma nova habilidade é lançada."
"[english]DOTA_Tooltip_ability_holdout_fiery_soul_Note0"	"Duration refreshes each time a new spell is cast."
"DOTA_Tooltip_ability_holdout_fiery_soul_Note1"	"Usar itens não ativará esta habilidade."
"[english]DOTA_Tooltip_ability_holdout_fiery_soul_Note1"	"Using items does not trigger Fiery Soul."
"DOTA_Tooltip_ability_holdout_fiery_soul_fiery_soul_attack_speed_bonus"	"VELOCIDADE DE ATAQUE ADICIONAL:"
"[english]DOTA_Tooltip_ability_holdout_fiery_soul_fiery_soul_attack_speed_bonus"	"ATTACK SPEED BONUS:"
"DOTA_Tooltip_ability_holdout_fiery_soul_fiery_soul_move_speed_bonus"	"%BÔNUS DE VELOCIDADE DE MOVIMENTO:"
"[english]DOTA_Tooltip_ability_holdout_fiery_soul_fiery_soul_move_speed_bonus"	"%MOVE SPEED BONUS:"
"DOTA_Tooltip_ability_holdout_fiery_soul_fiery_soul_max_stacks"	"<font color='#70EA72'>MÁXIMO DE ACÚMULOS:</font>"
"[english]DOTA_Tooltip_ability_holdout_fiery_soul_fiery_soul_max_stacks"	"<font color='#70EA72'>MAX STACKS:</font>"
"DOTA_Tooltip_ability_holdout_fiery_soul_duration"	"<font color='#70EA72'>DURAÇÃO:</font>"
"[english]DOTA_Tooltip_ability_holdout_fiery_soul_duration"	"<font color='#70EA72'>DURATION:</font>"
"DOTA_Tooltip_ability_holdout_fiery_soul_fiery_soul_cast_point_bonus"	"<font color='#70EA72'>REDUÇÃO DO PONTO DE LANÇAMENTO DE MAGIAS:</font>"
"[english]DOTA_Tooltip_ability_holdout_fiery_soul_fiery_soul_cast_point_bonus"	"<font color='#70EA72'>CAST POINT BONUS:</font>"
"DOTA_Tooltip_modifier_holdout_fiery_soul"	"Alma Flamejante"
"[english]DOTA_Tooltip_modifier_holdout_fiery_soul"	"Blazing Soul"
"DOTA_Tooltip_modifier_holdout_fiery_soul_Description"	"Mais %dMODIFIER_PROPERTY_ATTACKSPEED_BONUS_CONSTANT% de velocidade de ataque e de movimento %dMODIFIER_PROPERTY_MOVESPEED_BONUS_PERCENTAGE%%% maior, e ponto de lançamento de magias reduzido por %fMODIFIER_PROPERTY_TOOLTIP%."
"[english]DOTA_Tooltip_modifier_holdout_fiery_soul_Description"	"Attack Speed increased by %dMODIFIER_PROPERTY_ATTACKSPEED_BONUS_CONSTANT%, movement Speed by %dMODIFIER_PROPERTY_MOVESPEED_BONUS_PERCENTAGE%%%, and cast point decreased by %fMODIFIER_PROPERTY_TOOLTIP%."
"DOTA_Tooltip_ability_templar_assassin_refraction_holdout"	"Deflexão"
"[english]DOTA_Tooltip_ability_templar_assassin_refraction_holdout"	"Deflection"
"DOTA_Tooltip_ability_templar_assassin_refraction_holdout_Lore"	"Manipulando o seu véu psiônico, Lanaya modifica as leis da natureza à sua vontade."
"[english]DOTA_Tooltip_ability_templar_assassin_refraction_holdout_Lore"	"Manipulating her psionic veil, Lanaya bends nature's law to her will."
"DOTA_Tooltip_ability_templar_assassin_refraction_holdout_Description"	"Em inglês: <font color='#F2A93E'>Deflection</font>\n \nA Templar Assassin cria um escudo defensivo ao redor de si própria que absorve dano e fornece um bônus ao seu dano."
"[english]DOTA_Tooltip_ability_templar_assassin_refraction_holdout_Description"	"Templar Assassin creates a defensive shield around herself that absorbs damage and provides a bonus to her damage."
"DOTA_Tooltip_ability_templar_assassin_refraction_holdout_Note0"	"Tipos de dano como remoção de vida ignoram a Refração (não reduzirá a quantidade de cargas)."
"[english]DOTA_Tooltip_ability_templar_assassin_refraction_holdout_Note0"	"Damage as HP Removal bypasses Deflection."
"DOTA_Tooltip_ability_templar_assassin_refraction_holdout_damage_absorb"	"%ABSORÇÃO DE DANO:"
"[english]DOTA_Tooltip_ability_templar_assassin_refraction_holdout_damage_absorb"	"%DAMAGE ABSORB:"
"DOTA_Tooltip_ability_templar_assassin_refraction_holdout_bonus_damage"	"%DANO ADICIONAL:"
"[english]DOTA_Tooltip_ability_templar_assassin_refraction_holdout_bonus_damage"	"%BONUS DAMAGE:"
"DOTA_Tooltip_ability_templar_assassin_refraction_holdout_duration"	"DURAÇÃO:"
"[english]DOTA_Tooltip_ability_templar_assassin_refraction_holdout_duration"	"DURATION:"
"DOTA_Tooltip_ability_templar_assassin_psionic_trap_holdout"	"Armadilha Psiônica"
"[english]DOTA_Tooltip_ability_templar_assassin_psionic_trap_holdout"	"Psionic Trap"
"DOTA_Tooltip_ability_templar_assassin_psionic_trap_holdout_Lore"	"Invocando o alcance do Templo Oculto, nada escapa aos olhos da Templar."
"[english]DOTA_Tooltip_ability_templar_assassin_psionic_trap_holdout_Lore"	"Calling upon the reach of the Hidden Temple, none escape the eye of the Templar."
"DOTA_Tooltip_ability_templar_assassin_psionic_trap_holdout_Description"	"Em inglês: <font color='#F2A93E'>Psionic Trap</font>\n \nA Templar Assassin posiciona armadilhas místicas invisíveis que monitoram o movimento dos inimigos. Quando ativadas ao seu comando, elas exercem uma influência de 30%% de retardo na área. O retardo da Armadilha aumenta em 5%% por segundo até um máximo de 50%%."
"[english]DOTA_Tooltip_ability_templar_assassin_psionic_trap_holdout_Description"	"Templar Assassin places mystical traps that invisibly monitor enemy movement. When sprung, at her command, they exert a slowing influence of 30%% in the area. Traps charge up to slow more by 5%% for each second up to 50%%."
"DOTA_Tooltip_ability_templar_assassin_psionic_trap_holdout_Note0"	"As armadilhas duram por tempo indeterminado."
"[english]DOTA_Tooltip_ability_templar_assassin_psionic_trap_holdout_Note0"	"Traps last indefinitely."
"DOTA_Tooltip_ability_templar_assassin_psionic_trap_holdout_Note1"	"As armadilhas possuem invisibilidade após 2 segundos, imunidade a magias e 100 de vida."
"[english]DOTA_Tooltip_ability_templar_assassin_psionic_trap_holdout_Note1"	"They have invisibility that fades in over 2 seconds, magic immunity, and 100 HP."
"DOTA_Tooltip_ability_templar_assassin_psionic_trap_holdout_Note2"	"As armadilhas têm alcance de visão de 400 unidades e não impedem que criaturas neutras renasçam."
"[english]DOTA_Tooltip_ability_templar_assassin_psionic_trap_holdout_Note2"	"Traps have 400/400 vision range and don't prevent neutral camps from spawning."
"DOTA_Tooltip_ability_templar_assassin_psionic_trap_holdout_max_traps"	"MÁXIMO DE ARMADILHAS:"
"[english]DOTA_Tooltip_ability_templar_assassin_psionic_trap_holdout_max_traps"	"MAX TRAPS:"
"DOTA_Tooltip_ability_holdout_paralyzing_cask"	"Casco Paralisante"
"[english]DOTA_Tooltip_ability_holdout_paralyzing_cask"	"Paralyzing Cask"
"DOTA_Tooltip_ability_holdout_paralyzing_cask_Description"	"Em inglês: <font color='#F2A93E'>Paralyzing Cask</font>\n \nLança um casco de pó paralisante que rebate entre unidades inimigas, atordoando e causando dano aos atingidos."
"[english]DOTA_Tooltip_ability_holdout_paralyzing_cask_Description"	"Launches a cask of paralyzing powder that ricochets between enemy units, stunning and damaging those it hits."
"DOTA_Tooltip_ability_holdout_paralyzing_cask_Lore"	"O Witch Doctor recicla os ossos de aliados e inimigos mortos, usando o pó como parte do seu arsenal de feitiços e alquimias."
"[english]DOTA_Tooltip_ability_holdout_paralyzing_cask_Lore"	"The Witch Doctor recycles the bones of fallen friends and foes, using the powder as part of his arsenal of charms and alchemy."
"DOTA_Tooltip_ability_holdout_paralyzing_cask_Note0"	"Os alvos podem ser atingidos múltiplas vezes, desde que outra unidade seja atingida entre as rebatidas."
"[english]DOTA_Tooltip_ability_holdout_paralyzing_cask_Note0"	"Targets can be hit multiple times, as long as another unit is struck in between the bounces."
"DOTA_Tooltip_ability_holdout_paralyzing_cask_bounces_tooltip"	"REBATIDAS:"
"[english]DOTA_Tooltip_ability_holdout_paralyzing_cask_bounces_tooltip"	"BOUNCES:"
"DOTA_Tooltip_ability_holdout_paralyzing_cask_hero_duration"	"DURAÇÃO DO ATORDOAMENTO EM HERÓIS:"
"[english]DOTA_Tooltip_ability_holdout_paralyzing_cask_hero_duration"	"HERO STUN DURATION:"
"DOTA_Tooltip_ability_holdout_paralyzing_cask_creep_duration"	"DURAÇÃO DO ATORDOAMENTO EM CRIATURAS:"
"[english]DOTA_Tooltip_ability_holdout_paralyzing_cask_creep_duration"	"CREEP STUN DURATION:"
"DOTA_Tooltip_ability_holdout_paralyzing_cask_hero_damage"	"DANO EM HERÓIS:"
"[english]DOTA_Tooltip_ability_holdout_paralyzing_cask_hero_damage"	"HERO DAMAGE:"
"DOTA_Tooltip_ability_holdout_voodoo_restoration"	"Vudu Restaurador"
"[english]DOTA_Tooltip_ability_holdout_voodoo_restoration"	"Voodoo Restoration"
"DOTA_Tooltip_ability_holdout_voodoo_restoration_Description"	"Em inglês: <font color='#F2A93E'>Voodoo Restoration</font>\n \nO Witch Doctor foca a sua magia para curar unidades aliadas próximas."
"[english]DOTA_Tooltip_ability_holdout_voodoo_restoration_Description"	"Witch Doctor focuses his magic to heal nearby allied units."
"DOTA_Tooltip_ability_holdout_voodoo_restoration_Lore"	"O abracadabra de Zharvakko não se limita apenas a enfeitiçar os seus adversários e é bem adepto a curar doenças."
"[english]DOTA_Tooltip_ability_holdout_voodoo_restoration_Lore"	"Zharvakko's hocus pocus is not limited only to hexxing his opponents and is quite adept at curing ailments."
"DOTA_Tooltip_ability_holdout_voodoo_restoration_Note0"	"A cura é aplicada em intervalos de 0,33 segundo."
"[english]DOTA_Tooltip_ability_holdout_voodoo_restoration_Note0"	"Healing is done in 0.33 second intervals."
"DOTA_Tooltip_ability_holdout_voodoo_restoration_Note1"	"Pode curar unidades imunes a magias."
"[english]DOTA_Tooltip_ability_holdout_voodoo_restoration_Note1"	"Can heal magic immune units."
"DOTA_Tooltip_ability_holdout_voodoo_restoration_mana_per_second"	"MANA POR SEGUNDO:"
"[english]DOTA_Tooltip_ability_holdout_voodoo_restoration_mana_per_second"	"MANA PER SEC:"
"DOTA_Tooltip_ability_holdout_voodoo_restoration_heal"	"CURA:"
"[english]DOTA_Tooltip_ability_holdout_voodoo_restoration_heal"	"HEAL:"
"DOTA_Tooltip_ability_holdout_voodoo_restoration_radius"	"RAIO:"
"[english]DOTA_Tooltip_ability_holdout_voodoo_restoration_radius"	"RADIUS:"
"DOTA_Tooltip_ability_holdout_death_ward"	"Sentinela da Morte"
"[english]DOTA_Tooltip_ability_holdout_death_ward"	"Death Ward"
"DOTA_Tooltip_ability_holdout_death_ward_Description"	"Em inglês: <font color='#F2A93E'>Death Ward</font>\n \nCANALIZADA — Invoca uma sentinela fatal para atacar heróis inimigos. A Sentinela da Morte tem um alcance de ataque de 700 unidades e ataca a cada 0,25 segundo. <font color='#70EA72'>Dura 10 segundos.</font>\n\nAprimorável pelo Cetro de Aghanim."
"[english]DOTA_Tooltip_ability_holdout_death_ward_Description"	"CHANNELED - Summons a deadly ward to attack enemy heroes.  The Death Ward has attack range of 700, and attacks every .25 seconds. <font color='#70EA72'>Lasts 10 seconds.</font> .\n\nUpgradable by Aghanim's Scepter."
"DOTA_Tooltip_ability_holdout_death_ward_Lore"	"O Witch Doctor executa uma dança ritualística, que assombra os sonhos dos que vivem para recontá-la."
"[english]DOTA_Tooltip_ability_holdout_death_ward_Lore"	"Witch Doctor performs a ritualistic dance, one that haunts the dreams of those who live to recount it."
"DOTA_Tooltip_ability_holdout_death_ward_Note0"	"A Sentinela da Morte é invulnerável e só é destruída se o Witch Doctor for interrompido ou a duração expirar."
"[english]DOTA_Tooltip_ability_holdout_death_ward_Note0"	"The Death Ward is invulnerable, and is only destroyed if Witch Doctor is interrupted or its duration expires."
"DOTA_Tooltip_ability_holdout_death_ward_Note1"	"A Sentinela da Morte pode ser controlada para atacar um alvo específico."
"[english]DOTA_Tooltip_ability_holdout_death_ward_Note1"	"The Death Ward can be controlled, and made to attack a specific target."
"DOTA_Tooltip_ability_holdout_death_ward_damage"	"DANO:"
"[english]DOTA_Tooltip_ability_holdout_death_ward_damage"	"DAMAGE:"
"DOTA_Tooltip_ability_holdout_death_ward_bounces"	"<font color='#70EA72'>REBATIDAS:</font>"
"[english]DOTA_Tooltip_ability_holdout_death_ward_bounces"	"<font color='#70EA72'>BOUNCES:</font>"
"DOTA_Tooltip_ability_holdout_death_ward_damage_scepter"	"DANO (CETRO):"
"[english]DOTA_Tooltip_ability_holdout_death_ward_damage_scepter"	"SCEPTER DAMAGE:"
"DOTA_Tooltip_ability_holdout_death_ward_scepter_bounces"	"<font color='#70EA72'>REBATIDAS (CETRO):</font>"
"[english]DOTA_Tooltip_ability_holdout_death_ward_scepter_bounces"	"<font color='#70EA72'>SCEPTER BOUNCES:</font>"
"DOTA_Tooltip_ability_phantom_assassin_stifling_dagger_nb2017"	"Adaga Sufocante"
"[english]DOTA_Tooltip_ability_phantom_assassin_stifling_dagger_nb2017"	"Stifling Dagger"
"DOTA_Tooltip_ability_phantom_assassin_stifling_dagger_nb2017_Description"	"Em inglês: <font color='#F2A93E'>Stifling Dagger</font>\n \n<font color='#70EA72'>Lança várias adagas na área ao redor do ponto alvo, que atingem a primeira unidade no seu caminho.</font> As adagas retardam o movimento e causam %base_damage%+%attack_factor_tooltip%%% do dano de ataque da Phantom Assassin como ataque físico, além de aplicar os efeitos de ataque dos seus itens e habilidades."
"[english]DOTA_Tooltip_ability_phantom_assassin_stifling_dagger_nb2017_Description"	"<font color='#70EA72'>Throws a flurry of daggers at the area around the target point, each one hitting the first unit in its path.</font>  The daggers slow enemy movement speed, and deal %base_damage%+%attack_factor_tooltip%%% of Phantom Assassin's attack damage as physical damage and applying attack effects from items and abilities."
"DOTA_Tooltip_ability_phantom_assassin_stifling_dagger_nb2017_Note0"	"Se um efeito de ataque é baseado em chances, a chance de ser aplicado será a mesma chance de ocorrer."
"[english]DOTA_Tooltip_ability_phantom_assassin_stifling_dagger_nb2017_Note0"	"If an attack effect is chance-based, the chance of its application will be the same as its chance to occur."
"DOTA_Tooltip_ability_phantom_assassin_stifling_dagger_nb2017_Lore"	"A primeira habilidade aprendida pelas Irmãs do Véu frequentemente sinaliza um golpe vindo em sua direção."
"[english]DOTA_Tooltip_ability_phantom_assassin_stifling_dagger_nb2017_Lore"	"The first skill learned by the Sisters of the Veil often signals an incoming hit."
"DOTA_Tooltip_ability_phantom_assassin_stifling_dagger_nb2017_move_slow"	"%RETARDO DE MOVIMENTO:"
"[english]DOTA_Tooltip_ability_phantom_assassin_stifling_dagger_nb2017_move_slow"	"%MOVE SLOW:"
"DOTA_Tooltip_ability_phantom_assassin_stifling_dagger_nb2017_duration"	"DURAÇÃO DO RETARDO:"
"[english]DOTA_Tooltip_ability_phantom_assassin_stifling_dagger_nb2017_duration"	"SLOW DURATION:"
"DOTA_Tooltip_ability_phantom_assassin_stifling_dagger_nb2017_base_damage"	"DANO BASE:"
"[english]DOTA_Tooltip_ability_phantom_assassin_stifling_dagger_nb2017_base_damage"	"BASE DAMAGE:"
"DOTA_Tooltip_ability_phantom_assassin_stifling_dagger_nb2017_attack_factor_tooltip"	"%DANO DE ATAQUE:"
"[english]DOTA_Tooltip_ability_phantom_assassin_stifling_dagger_nb2017_attack_factor_tooltip"	"%ATTACK DAMAGE:"
"DOTA_Tooltip_ability_phantom_assassin_stifling_dagger_nb2017_dagger_count"	"QUANTIDADE DE ADAGAS:"
"[english]DOTA_Tooltip_ability_phantom_assassin_stifling_dagger_nb2017_dagger_count"	"DAGGER COUNT:"
"DOTA_Tooltip_ability_phantom_assassin_stifling_dagger_nb2017_dagger_range"	"ALCANCE DA ADAGA:"
"[english]DOTA_Tooltip_ability_phantom_assassin_stifling_dagger_nb2017_dagger_range"	"DAGGER RANGE:"
"DOTA_Tooltip_ability_tiny_trample"	"Atropelar"
"[english]DOTA_Tooltip_ability_tiny_trample"	"Trample"
"DOTA_Tooltip_ability_tiny_trample_Description"	"Em inglês: <font color='#F2A93E'>Trample</font>\n \nTiny corre para frente, atropelando unidades inimigas com todo o seu peso. Ele recebe velocidade de movimento adicional e ignora colisão com unidades, atordoando e causando uma parte do seu dano de ataque aos inimigos atropelados."
"[english]DOTA_Tooltip_ability_tiny_trample_Description"	"Tiny rushes forward, trampling enemy units with his craggy mass.  He gains bonus movement speed and phased collison, while each enemy he tramples is stunned and dealt a portion of his attack damage."
"DOTA_Tooltip_ability_tiny_trample_attack_factor_tooltip"	"%DANO DE ATAQUE:"
"[english]DOTA_Tooltip_ability_tiny_trample_attack_factor_tooltip"	"%ATTACK DAMAGE:"
"DOTA_Tooltip_ability_tiny_trample_bonus_movespeed_pct"	"%VELOCIDADE DE MOVIMENTO ADICIONAL:"
"[english]DOTA_Tooltip_ability_tiny_trample_bonus_movespeed_pct"	"%BONUS MOVEMENT SPEED:"
"DOTA_Tooltip_ability_tiny_trample_duration"	"DURAÇÃO DE ATROPELAR:"
"[english]DOTA_Tooltip_ability_tiny_trample_duration"	"TRAMPLE DURATION:"
"DOTA_Tooltip_ability_tiny_trample_stun_duration"	"DURAÇÃO DO ATORDOAMENTO:"
"[english]DOTA_Tooltip_ability_tiny_trample_stun_duration"	"STUN DURATION:"
"DOTA_Tooltip_modifier_tiny_trample"	"Atropelar"
"[english]DOTA_Tooltip_modifier_tiny_trample"	"Trample"
"DOTA_Tooltip_ability_dungeon_tidehunter_gush"	"Jato d'Água"
"[english]DOTA_Tooltip_ability_dungeon_tidehunter_gush"	"Gush"
"DOTA_Tooltip_ability_dungeon_tidehunter_gush_Description"	"Em inglês: <font color='#F2A93E'>Gush</font>\n \nInvoca um jato d'água que causa dano a uma unidade inimiga, reduzindo a sua velocidade de movimento e armadura. O efeito dura 4 segundos.\n\nAprimorável pelo Cetro de Aghanim."
"[english]DOTA_Tooltip_ability_dungeon_tidehunter_gush_Description"	"Summons a gush of water to damage an enemy unit, reducing their movement speed and armor.  Lasts 4 seconds.\n\nUpgradable by Aghanim's Scepter."
"DOTA_Tooltip_ability_dungeon_tidehunter_gush_Lore"	"Durante o seu campeonato das Ilhas Submersas, Leviathan ganhou maestria sobre o mar aberto."
"[english]DOTA_Tooltip_ability_dungeon_tidehunter_gush_Lore"	"During his championship of the Sunken Isles, Leviathan gained mastery over the open sea."
"DOTA_Tooltip_ability_dungeon_tidehunter_gush_movement_speed"	"%RETARDO:"
"[english]DOTA_Tooltip_ability_dungeon_tidehunter_gush_movement_speed"	"%SLOW:"
"DOTA_Tooltip_ability_dungeon_tidehunter_gush_negative_armor"	"REDUÇÃO DE ARMADURA:"
"[english]DOTA_Tooltip_ability_dungeon_tidehunter_gush_negative_armor"	"ARMOR REDUCTION:"
"DOTA_Tooltip_ability_dungeon_tidehunter_gush_cast_range_scepter"	"ALCANCE (CETRO):"
"[english]DOTA_Tooltip_ability_dungeon_tidehunter_gush_cast_range_scepter"	"SCEPTER RANGE:"
"DOTA_Tooltip_ability_dungeon_tidehunter_gush_aoe_scepter"	"RAIO (CETRO):"
"[english]DOTA_Tooltip_ability_dungeon_tidehunter_gush_aoe_scepter"	"SCEPTER RADIUS:"
"DOTA_Tooltip_ability_dungeon_tidehunter_gush_cooldown_scepter"	"INTERVALO ENTRE USOS (CETRO):"
"[english]DOTA_Tooltip_ability_dungeon_tidehunter_gush_cooldown_scepter"	"SCEPTER COOLDOWN:"
"DOTA_Tooltip_ability_dungeon_tidehunter_gush_aghanim_description"	"<font color='#F2A93E'>Jato d'Água</font> passa a ser uma onda lançada na direção de um ponto-alvo, afetando todas as unidades inimigas no caminho. Reduz o intervalo entre usos."
"[english]DOTA_Tooltip_ability_dungeon_tidehunter_gush_aghanim_description"	"Gush becomes a ground targeted wave ability that affects enemy units in a line.  Decreases cooldown."
"DOTA_Tooltip_ability_dungeon_tidehunter_ravage"	"Devastar"
"[english]DOTA_Tooltip_ability_dungeon_tidehunter_ravage"	"Ravage"
"DOTA_Tooltip_ability_dungeon_tidehunter_ravage_Description"	"Em inglês: <font color='#F2A93E'>Ravage</font>\n \nBate no chão fazendo com que tentáculos emerjam em todas as direções, atordoando e causando dano a todas as unidades inimigas próximas."
"[english]DOTA_Tooltip_ability_dungeon_tidehunter_ravage_Description"	"Slams the ground, causing tentacles to erupt in all directions, damaging and stunning all nearby enemy units."
"DOTA_Tooltip_ability_dungeon_tidehunter_ravage_Lore"	"Invocar o deus abissal Maelrawn resultou em armadas inteiras perdidas ao mar."
"[english]DOTA_Tooltip_ability_dungeon_tidehunter_ravage_Lore"	"Calling to the abyssal god Maelrawn has resulted in entire armadas being lost at sea."
"DOTA_Tooltip_ability_dungeon_tidehunter_ravage_Note0"	"Devastar pode atingir unidades invisíveis."
"[english]DOTA_Tooltip_ability_dungeon_tidehunter_ravage_Note0"	"Ravage will hit invisible units."
"DOTA_Tooltip_ability_dungeon_tidehunter_ravage_Note1"	"As ondas de Devastar movem-se para fora a uma velocidade de 775 unidades."
"[english]DOTA_Tooltip_ability_dungeon_tidehunter_ravage_Note1"	"Ravage waves move outwards at a speed of 775."
"DOTA_Tooltip_ability_dungeon_tidehunter_ravage_radius"	"RAIO:"
"[english]DOTA_Tooltip_ability_dungeon_tidehunter_ravage_radius"	"RADIUS:"
"DOTA_Tooltip_ability_dungeon_tidehunter_ravage_duration"	"DURAÇÃO:"
"[english]DOTA_Tooltip_ability_dungeon_tidehunter_ravage_duration"	"DURATION:"
"DOTA_Tooltip_ability_dungeon_nevermore_shadowraze1"	"Ruína das Sombras"
"[english]DOTA_Tooltip_ability_dungeon_nevermore_shadowraze1"	"Shadowraze"
"DOTA_Tooltip_ability_dungeon_nevermore_shadowraze1_Description"	"Em inglês: <font color='#F2A93E'>Shadowraze</font>\n \nO Shadow Fiend arrasa a área na sua frente, causando dano a todas as unidades inimigas na área."
"[english]DOTA_Tooltip_ability_dungeon_nevermore_shadowraze1_Description"	"Shadow Fiend razes the area in front of him, dealing damage to enemy units in an area."
"DOTA_Tooltip_ability_dungeon_nevermore_shadowraze1_Lore"	"A marca registrada de Nevermore para colher almas."
"[english]DOTA_Tooltip_ability_dungeon_nevermore_shadowraze1_Lore"	"Nevermore's trademark for harvesting souls."
"DOTA_Tooltip_ability_dungeon_nevermore_shadowraze1_shadowraze_range"	"ALCANCE:"
"[english]DOTA_Tooltip_ability_dungeon_nevermore_shadowraze1_shadowraze_range"	"RANGE:"
"DOTA_Tooltip_ability_dungeon_nevermore_shadowraze2"	"Ruína das Sombras"
"[english]DOTA_Tooltip_ability_dungeon_nevermore_shadowraze2"	"Shadowraze"
"DOTA_Tooltip_ability_dungeon_nevermore_shadowraze2_Description"	"Em inglês: <font color='#F2A93E'>Shadowraze</font>\n \nO Shadow Fiend arrasa a área na sua frente, causando dano a todas as unidades inimigas na área."
"[english]DOTA_Tooltip_ability_dungeon_nevermore_shadowraze2_Description"	"Shadow Fiend razes the area in front of him, dealing damage to enemy units in an area."
"DOTA_Tooltip_ability_dungeon_nevermore_shadowraze2_Lore"	"A marca registrada de Nevermore para colher almas."
"[english]DOTA_Tooltip_ability_dungeon_nevermore_shadowraze2_Lore"	"Nevermore's trademark for harvesting souls."
"DOTA_Tooltip_ability_dungeon_nevermore_shadowraze2_shadowraze_range"	"ALCANCE:"
"[english]DOTA_Tooltip_ability_dungeon_nevermore_shadowraze2_shadowraze_range"	"RANGE:"
"DOTA_Tooltip_ability_dungeon_nevermore_shadowraze3"	"Ruína das Sombras"
"[english]DOTA_Tooltip_ability_dungeon_nevermore_shadowraze3"	"Shadowraze"
"DOTA_Tooltip_ability_dungeon_nevermore_shadowraze3_Description"	"Em inglês: <font color='#F2A93E'>Shadowraze</font>\n \nO Shadow Fiend arrasa a área na sua frente, causando dano a todas as unidades inimigas na área."
"[english]DOTA_Tooltip_ability_dungeon_nevermore_shadowraze3_Description"	"Shadow Fiend razes the area in front of him, dealing damage to enemy units in an area."
"DOTA_Tooltip_ability_dungeon_nevermore_shadowraze3_Lore"	"A marca registrada de Nevermore para colher almas."
"[english]DOTA_Tooltip_ability_dungeon_nevermore_shadowraze3_Lore"	"Nevermore's trademark for harvesting souls."
"DOTA_Tooltip_ability_dungeon_nevermore_shadowraze3_shadowraze_range"	"ALCANCE:"
"[english]DOTA_Tooltip_ability_dungeon_nevermore_shadowraze3_shadowraze_range"	"RANGE:"
"DOTA_Tooltip_ability_nevermore_necromastery"	"Necromaestria"
"[english]DOTA_Tooltip_ability_nevermore_necromastery"	"Necromastery"
"DOTA_Tooltip_ability_nevermore_necromastery_Description"	"Em inglês: <font color='#F2A93E'>Necromastery</font>\n \nO Shadow Fiend rouba a alma das unidades que mata, podendo causar dano adicional. Se a unidade morta for um herói, ele recebe 12 almas. Ao morrer, ele liberta metade delas do seu cativeiro.\n\nAprimorável pelo Cetro de Aghanim."
"[english]DOTA_Tooltip_ability_nevermore_necromastery_Description"	"Shadow Fiend steals the soul from units he kills, gaining bonus damage. If the killed unit is a hero, he gains 12 souls.  On death, he releases half of them from bondage.\n\nUpgradable by Aghanim's Scepter."
"DOTA_Tooltip_ability_nevermore_necromastery_Lore"	"Almas colhidas voam para dentro e fora do Abismo, permitindo ao Shadow Fiend aumentar o tamanho da sua coleção."
"[english]DOTA_Tooltip_ability_nevermore_necromastery_Lore"	"Harvested souls swirl in and out of the Abysm, empowering the Shadow Fiend to increase the size of his collection."
"DOTA_Tooltip_ability_nevermore_necromastery_Note0"	"Negações e criaturas neutras também fornecem dano extra através da Necromaestria."
"[english]DOTA_Tooltip_ability_nevermore_necromastery_Note0"	"Denies and neutral creeps also provide bonus damage through Necromastery."
"DOTA_Tooltip_ability_nevermore_necromastery_necromastery_max_souls"	"MÁXIMO DE ALMAS:"
"[english]DOTA_Tooltip_ability_nevermore_necromastery_necromastery_max_souls"	"MAX SOULS:"
"DOTA_Tooltip_ability_nevermore_necromastery_necromastery_damage_per_soul"	"DANO POR ALMA:"
"[english]DOTA_Tooltip_ability_nevermore_necromastery_necromastery_damage_per_soul"	"DAMAGE PER SOUL:"
"DOTA_Tooltip_ability_nevermore_necromastery_necromastery_max_souls_scepter"	"MÁXIMO DE ALMAS (CETRO):"
"[english]DOTA_Tooltip_ability_nevermore_necromastery_necromastery_max_souls_scepter"	"SCEPTER MAX SOULS:"
"DOTA_Tooltip_ability_nevermore_necromastery_aghanim_description"	"Aumenta o máximo de almas."
"[english]DOTA_Tooltip_ability_nevermore_necromastery_aghanim_description"	"Increases max souls."
"DOTA_Tooltip_ability_nevermore_dark_lord"	"Presença do Lorde das Trevas"
"[english]DOTA_Tooltip_ability_nevermore_dark_lord"	"Presence of the Dark Lord"
"DOTA_Tooltip_ability_nevermore_dark_lord_Description"	"Em inglês: <font color='#F2A93E'>Presence of the Dark Lord</font>\n \nA presença do Shadow Fiend reduz a armadura de inimigos próximos."
"[english]DOTA_Tooltip_ability_nevermore_dark_lord_Description"	"Shadow Fiend's presence reduces the armor of nearby enemies."
"DOTA_Tooltip_ability_nevermore_dark_lord_Lore"	"Até mesmo estar perto de Nevermore consome a alma de alguém."
"[english]DOTA_Tooltip_ability_nevermore_dark_lord_Lore"	"Even being near Nevermore eats away at one's soul."
"DOTA_Tooltip_ability_nevermore_dark_lord_Note0"	"Acumula-se completamente com outras habilidades e auras redutoras de armadura."
"[english]DOTA_Tooltip_ability_nevermore_dark_lord_Note0"	"Stacks fully with other armor reduction abilities and aura."
"DOTA_Tooltip_ability_nevermore_dark_lord_presence_armor_reduction"	"REDUÇÃO:"
"[english]DOTA_Tooltip_ability_nevermore_dark_lord_presence_armor_reduction"	"REDUCTION:"
"DOTA_Tooltip_ability_nevermore_dark_lord_presence_radius"	"RAIO:"
"[english]DOTA_Tooltip_ability_nevermore_dark_lord_presence_radius"	"RADIUS:"
"DOTA_Tooltip_ability_nevermore_requiem"	"Réquiem das Almas"
"[english]DOTA_Tooltip_ability_nevermore_requiem"	"Requiem of Souls"
"DOTA_Tooltip_ability_nevermore_requiem_Description"	"Em inglês: <font color='#F2A93E'>Requiem of Souls</font>\n \nReúne as suas almas capturadas para libertá-las como linhas de energia demoníaca. Unidades próximas no momento da libertação podem sofrer dano de várias linhas de energia. Também reduzirá as velocidades de movimento e ataque de unidades que sofrerem dano proveniente da habilidade. Linhas de energia são criadas por cada 2 almas capturadas por <font color='#F2A93E'>Necromaestria</font>. Réquiem das Almas é automaticamente lançada ao morrer, independente do tempo de intervalo entre usos.\n\nAprimorável pelo Cetro de Aghanim."
"[english]DOTA_Tooltip_ability_nevermore_requiem_Description"	"Shadow Fiend gathers his captured souls to release them as lines of demonic energy. Units near Shadow Fiend when the souls are released can be damaged by several lines of energy. Any unit damaged by Requiem of Souls will have its movement speed and attack damage reduced. Lines of energy are created for every 2 souls captured through Necromastery. Requiem of Souls is automatically cast whenever Shadow Fiend dies, regardless of its cooldown.\n\nUpgradable by Aghanim's Scepter."
"DOTA_Tooltip_ability_nevermore_requiem_aghanim_description"	"Aumenta a quantidade máxima de almas da Necromaestria e faz com que Réquiem das Almas retorne ao usuário. A onda que volta causa menos dano, mas cura com base no total de dano causado."
"[english]DOTA_Tooltip_ability_nevermore_requiem_aghanim_description"	"Increases Necromastery Max Souls and causes Requiem of Souls to return back to Shadow Fiend. The wave back to Shadow Fiend deals less damage, but heals Shadow Fiend for all the damage it dealt."
"DOTA_Tooltip_ability_nevermore_requiem_cast_time_tooltip"	"ATRASO DE LANÇAMENTO:"
"[english]DOTA_Tooltip_ability_nevermore_requiem_cast_time_tooltip"	"CAST DELAY:"
"DOTA_Tooltip_ability_nevermore_requiem_requiem_reduction_ms"	"%RETARDO DE MOVIMENTO:"
"[english]DOTA_Tooltip_ability_nevermore_requiem_requiem_reduction_ms"	"%MOVEMENT REDUCTION:"
"DOTA_Tooltip_ability_nevermore_requiem_requiem_reduction_tooltip"	"%REDUÇÃO DE DANO:"
"[english]DOTA_Tooltip_ability_nevermore_requiem_requiem_reduction_tooltip"	"%DAMAGE REDUCTION:"
"DOTA_Tooltip_ability_nevermore_requiem_requiem_slow_duration"	"DURAÇÃO DO RETARDO:"
"[english]DOTA_Tooltip_ability_nevermore_requiem_requiem_slow_duration"	"REDUCTION DURATION:"
"DOTA_Tooltip_ability_nevermore_requiem_requiem_damage_pct_scepter"	"%DANO DE RETORNO (CETRO):"
"[english]DOTA_Tooltip_ability_nevermore_requiem_requiem_damage_pct_scepter"	"%SCEPTER DAMAGE ON RETURN:"
"DOTA_Tooltip_ability_nevermore_requiem_requiem_heal_pct_scepter"	"%CURA AO RETORNAR (CETRO):"
"[english]DOTA_Tooltip_ability_nevermore_requiem_requiem_heal_pct_scepter"	"%SCEPTER HEAL ON RETURN:"
"DOTA_Tooltip_ability_nevermore_requiem_Lore"	"As almas capturadas daqueles já assassinados são libertas para devastar seus antigos aliados."
"[english]DOTA_Tooltip_ability_nevermore_requiem_Lore"	"The captured souls of those past slain are released to ravage their former allies."
"DOTA_Tooltip_ability_nevermore_requiem_Note0"	"Uma linha é gerada a partir do Shadow Fiend para cada 2 almas armazenadas até um máximo de 18 linhas (23 com o Cetro de Aghanim)."
"[english]DOTA_Tooltip_ability_nevermore_requiem_Note0"	"One line is generated from Shadow Fiend for every 2 souls in his possession, for a maximum of 18 lines (23 lines with Scepter)."
"DOTA_Tooltip_ability_nevermore_requiem_Note1"	"As reduções de velocidade de movimento e dano de ataque de Réquiem das Almas afetam unidades imunes a magias."
"[english]DOTA_Tooltip_ability_nevermore_requiem_Note1"	"The movement and attack damage reductions from Requiem of Souls go through spell immunity."
"DOTA_Siltbreaker_Quests"	"MISSÕES"
"[english]DOTA_Siltbreaker_Quests"	"QUESTS"
"DOTA_Siltbreaker_NoResurrections"	"Sem ressurreições restantes"
"[english]DOTA_Siltbreaker_NoResurrections"	"No Resurrections Remaining"
"DOTA_Siltbreaker_Resurrect"	"Ressuscitar"
"[english]DOTA_Siltbreaker_Resurrect"	"Resurrect"
"DOTA_Siltbreaker_RespawnNearest"	"Você renascerá caso a sua equipe alcance o próximo ponto de controle"
"[english]DOTA_Siltbreaker_RespawnNearest"	"You will respawn if your team gets to the next checkpoint"
"DOTA_Siltbreaker_BuybacksLeft"	"Renascimentos restantes:"
"[english]DOTA_Siltbreaker_BuybacksLeft"	"Buybacks Left:"
"DOTA_Siltbreaker_BuybackCost"	"Custo de renascimento:"
"[english]DOTA_Siltbreaker_BuybackCost"	"Buyback Cost:"
"DOTA_Siltbreaker_WhirlpoolSigilHelp"	"Pressione o Signo do Turbilhão no pergaminho para ser teletransportado ao seu destino"
"[english]DOTA_Siltbreaker_WhirlpoolSigilHelp"	"Press the Whirlpool Sigil on the scroll to teleport to your destination"
"DOTA_Siltbreaker_ContinueSpeechText"	"Pronto"
"[english]DOTA_Siltbreaker_ContinueSpeechText"	"Ready"
"DOTA_Siltbreaker_PreviousZone"	"Zona anterior"
"[english]DOTA_Siltbreaker_PreviousZone"	"Previous Zone"
"DOTA_Siltbreaker_NextZone"	"Próxima zona"
"[english]DOTA_Siltbreaker_NextZone"	"Next Zone"
"DOTA_Siltbreaker_Disconnect"	"Sair"
"[english]DOTA_Siltbreaker_Disconnect"	"Leave"
"DOTA_Siltbreaker_Continue"	"Continuar"
"[english]DOTA_Siltbreaker_Continue"	"Continue"
"DOTA_Siltbreaker_Failure"	"Vocês fracassaram"
"[english]DOTA_Siltbreaker_Failure"	"You have Failed"
"DOTA_Siltbreaker_Success"	"Vocês derrotaram Rhyzik!<br> Ato I concluído"
"[english]DOTA_Siltbreaker_Success"	"You Have Defeated Rhyzik!<br> Act I Complete"
"DOTA_Siltbreaker_Success_actii"	"Vocês derrotaram Quebralama!"
"[english]DOTA_Siltbreaker_Success_actii"	"You Have Defeated Siltbreaker!"
"DOTA_Siltbreaker_RelicsButton"	"Artefatos"
"[english]DOTA_Siltbreaker_RelicsButton"	"Artifacts"
"DOTA_Siltbreaker_PersonalBestTime"	"Recorde pessoal: {s:best_time}"
"[english]DOTA_Siltbreaker_PersonalBestTime"	"Personal Best: {s:best_time}"
"DOTA_Siltbreaker_hud_respawn_remcount"	"Renascimentos restantes"
"[english]DOTA_Siltbreaker_hud_respawn_remcount"	"Respawns Remaining"
}
}
