"lang"
{
"Language"	"turkish"
"Tokens"
{
"addon_game_name"	"Siltbreaker"
"[english]addon_game_name"	"Siltbreaker"
"DOTA_GameMode_15"	"Siltbreaker"
"[english]DOTA_GameMode_15"	"Siltbreaker"
"DOTA_GameMode_19"	"Siltbreaker"
"[english]DOTA_GameMode_19"	"Siltbreaker"
"DOTA_Tooltip_Ability_item_health_potion"	"Sağlık İksiri"
"[english]DOTA_Tooltip_Ability_item_health_potion"	"Health Potion"
"DOTA_Tooltip_Ability_item_mana_potion"	"Mana İksiri"
"[english]DOTA_Tooltip_Ability_item_mana_potion"	"Mana Potion"
"DOTA_Tooltip_ability_item_bag_of_gold"	"Altın Kesesi"
"[english]DOTA_Tooltip_ability_item_bag_of_gold"	"Bag of Gold"
"DOTA_Tooltip_Ability_item_life_rune"	"Hayat Rünü"
"[english]DOTA_Tooltip_Ability_item_life_rune"	"Life Rune"
"DOTA_Tooltip_ability_item_book_of_strength"	"Kuvvet Kitabı"
"[english]DOTA_Tooltip_ability_item_book_of_strength"	"Book of Strength"
"DOTA_Tooltip_ability_item_book_of_strength_Description"	"Kalıcı olarak 3 Kuvvet puanı kazanmak için tüketin."
"[english]DOTA_Tooltip_ability_item_book_of_strength_Description"	"Consume to gain 3 Strength permanently."
"DOTA_Tooltip_ability_item_book_of_agility"	"Çeviklik Kitabı"
"[english]DOTA_Tooltip_ability_item_book_of_agility"	"Book of Agility"
"DOTA_Tooltip_ability_item_book_of_agility_Description"	"Kalıcı olarak 3 Çeviklik puanı kazanmak için tüketin."
"[english]DOTA_Tooltip_ability_item_book_of_agility_Description"	"Consume to gain 3 Agility permanently."
"DOTA_Tooltip_ability_item_book_of_intelligence"	"Zekâ Kitabı"
"[english]DOTA_Tooltip_ability_item_book_of_intelligence"	"Book of Intelligence"
"DOTA_Tooltip_ability_item_book_of_intelligence_Description"	"Kalıcı olarak 3 Zeka puanı kazanmak için tüketin."
"[english]DOTA_Tooltip_ability_item_book_of_intelligence_Description"	"Consume to gain 3 Intelligence permanently."
"DOTA_Tooltip_ability_item_creed_of_omniscience"	"<font color=\"#4ae0bf\">Creed of Omniscience</font>"
"[english]DOTA_Tooltip_ability_item_creed_of_omniscience"	"<font color=\"#4ae0bf\">Creed of Omniscience</font>"
"DOTA_Tooltip_ability_item_creed_of_omniscience_Description"	"Gerekli Seviye: %required_level%\n\nPasif: Fazladan tecrübe sağlar.\n"
"[english]DOTA_Tooltip_ability_item_creed_of_omniscience_Description"	"Required Level: %required_level%\n\nPassive: Grants bonus experience.\n"
"DOTA_Tooltip_ability_item_creed_of_omniscience_bonus_xp"	"%FAZLADAN TP:"
"[english]DOTA_Tooltip_ability_item_creed_of_omniscience_bonus_xp"	"%BONUS XP:"
"DOTA_Tooltip_ability_item_creed_of_omniscience_Lore"	"Her şeyi bilmek beni onurlandırıyor!"
"[english]DOTA_Tooltip_ability_item_creed_of_omniscience_Lore"	"The Omniscience honors me!"
"DOTA_Tooltip_ability_item_oblivions_locket"	"<font color=\"#4ae0bf\">Oblivion's Locket</font>"
"[english]DOTA_Tooltip_ability_item_oblivions_locket"	"<font color=\"#4ae0bf\">Oblivion's Locket</font>"
"DOTA_Tooltip_ability_item_oblivions_locket_Description"	"Gerekli seviye: %required_level%\n\nEtkin: Hortlak- Süreli - Bir saniyeye kadar ruhani forma geçer, fiziksel saldırılara karşı bağışıklı olur ancak fazladan %%%extra_spell_damage_percent% büyü hasarı alırsın.\n"
"[english]DOTA_Tooltip_ability_item_oblivions_locket_Description"	"Required Level: %required_level%\n\nActive: Spook - CHANNELLED - Become ethereal, immune to physical but taking %extra_spell_damage_percent%%% extra magic damage for up to 1 second.\n"
"DOTA_Tooltip_ability_item_oblivions_locket_bonus_all_stats"	"FAZLADAN TÜM ÖZELLİKLER:"
"[english]DOTA_Tooltip_ability_item_oblivions_locket_bonus_all_stats"	"BONUS ALL STATS:"
"DOTA_Tooltip_ability_item_oblivions_locket_Lore"	"Bir iskeletin nazarlığı. Sıkıntıları önlemek için kullanılır."
"[english]DOTA_Tooltip_ability_item_oblivions_locket_Lore"	"A skeleton's charm. Used to prevent having a bad time."
"DOTA_Tooltip_ability_item_pelt_of_the_old_wolf"	"<font color=\"#4ae0bf\">Pelt of the Old Wolf</font>"
"[english]DOTA_Tooltip_ability_item_pelt_of_the_old_wolf"	"<font color=\"#4ae0bf\">Pelt of the Old Wolf</font>"
"DOTA_Tooltip_ability_item_pelt_of_the_old_wolf_Description"	"Gerekli Seviye: %required_level%"
"[english]DOTA_Tooltip_ability_item_pelt_of_the_old_wolf_Description"	"Required Level: %required_level%"
"DOTA_Tooltip_ability_item_pelt_of_the_old_wolf_Lore"	"Yaban diyarlar tekinsizdir; sürekli tetikte olmalısın."
"[english]DOTA_Tooltip_ability_item_pelt_of_the_old_wolf_Lore"	"The wild can be a treachorous place; don't let your guard down."
"DOTA_Tooltip_ability_item_pelt_of_the_old_wolf_bonus_armor"	"FAZLADAN ZIRH:"
"[english]DOTA_Tooltip_ability_item_pelt_of_the_old_wolf_bonus_armor"	"BONUS ARMOR:"
"DOTA_Tooltip_ability_item_pelt_of_the_old_wolf_bonus_move_speed"	"FAZLADAN HAREKET HIZI:"
"[english]DOTA_Tooltip_ability_item_pelt_of_the_old_wolf_bonus_move_speed"	"BONUS MOVE SPEED:"
"DOTA_Tooltip_ability_item_pelt_of_the_old_wolf_bonus_evasion"	"%FAZLADAN SAVUŞTURMA:"
"[english]DOTA_Tooltip_ability_item_pelt_of_the_old_wolf_bonus_evasion"	"%BONUS EVASION:"
"DOTA_Tooltip_ability_item_paw_of_lucius"	"<font color=\"#4ae0bf\">Paw of Lucius</font>"
"[english]DOTA_Tooltip_ability_item_paw_of_lucius"	"<font color=\"#4ae0bf\">Paw of Lucius</font>"
"DOTA_Tooltip_ability_item_paw_of_lucius_Description"	"Gerekli Seviye: %required_level%\n\nPasif: Saldırıların %%%rupture_chance% ihtimalle Rupture verme şansı vardır.\n"
"[english]DOTA_Tooltip_ability_item_paw_of_lucius_Description"	"Required Level: %required_level%\n\nPassive: Attacks have a %rupture_chance%%% chance to inflict Rupture.\n"
"DOTA_Tooltip_ability_item_paw_of_lucius_Lore"	"Bu pençe derin keser."
"[english]DOTA_Tooltip_ability_item_paw_of_lucius_Lore"	"This claw cuts deep."
"DOTA_Tooltip_ability_item_paw_of_lucius_bonus_strength"	"FAZLADAN KUVVET:"
"[english]DOTA_Tooltip_ability_item_paw_of_lucius_bonus_strength"	"BONUS STRENGTH:"
"DOTA_Tooltip_ability_item_paw_of_lucius_bonus_attack_speed"	"FAZLADAN SALDIRI HIZI:"
"[english]DOTA_Tooltip_ability_item_paw_of_lucius_bonus_attack_speed"	"BONUS ATTACK SPEED:"
"DOTA_Tooltip_ability_item_longclaws_amulet"	"<font color=\"#4ae0bf\">Longclaw's Amulet</font>"
"[english]DOTA_Tooltip_ability_item_longclaws_amulet"	"<font color=\"#4ae0bf\">Longclaw's Amulet</font>"
"DOTA_Tooltip_ability_item_longclaws_amulet_Description"	"Gerekli Seviye: %required_level%\n"
"[english]DOTA_Tooltip_ability_item_longclaws_amulet_Description"	"Required Level: %required_level%\n"
"DOTA_Tooltip_ability_item_longclaws_amulet_Lore"	"Büyü Kırlarda pek rastlanılmayan bir şeydir, sırları ise iyi korunur."
"[english]DOTA_Tooltip_ability_item_longclaws_amulet_Lore"	"Magic is somewhat uncommon in the Weald, its secrets closely guarded."
"DOTA_Tooltip_ability_item_longclaws_amulet_spell_lifesteal_pct"	"%BÜYÜ CAN ÇALMA:"
"[english]DOTA_Tooltip_ability_item_longclaws_amulet_spell_lifesteal_pct"	"%SPELL LIFESTEAL:"
"DOTA_Tooltip_ability_item_longclaws_amulet_cooldown_reduction_pct"	"%DOLUM SÜRESİ AZALTMA:"
"[english]DOTA_Tooltip_ability_item_longclaws_amulet_cooldown_reduction_pct"	"%COOLDOWN REDUCTION:"
"DOTA_Tooltip_ability_item_longclaws_amulet_mana_cost_reduction_pct"	"%MANA BEDELİ AZALTMASI:"
"[english]DOTA_Tooltip_ability_item_longclaws_amulet_mana_cost_reduction_pct"	"%MANA COST REDUCTION:"
"DOTA_Tooltip_ability_item_bogduggs_cudgel"	"<font color=\"#4ae0bf\">Bogdugg's Cudgel</font>"
"[english]DOTA_Tooltip_ability_item_bogduggs_cudgel"	"<font color=\"#4ae0bf\">Bogdugg's Cudgel</font>"
"DOTA_Tooltip_ability_item_bogduggs_cudgel_Description"	"Gerekli Seviye: %required_level%\n\nPasif: Darbe - SADECE YAKIN DÖVÜŞ - Tüm saldırı hızı yarıya düşer, fakat saldırılar etrafındaki bölgeye %damage_radius% sıçrama hasarı verir ve hedef %stun_duration% saniye sersemletir.\n"
"[english]DOTA_Tooltip_ability_item_bogduggs_cudgel_Description"	"Required Level: %required_level%\n\nPassive: Smash - MELEE ONLY - All attack speed is halved, but attacks deal splash damage in a %damage_radius% area around the target and stun for %stun_duration% second.\n"
"DOTA_Tooltip_ability_item_bogduggs_cudgel_Lore"	"Bogdugg, Bonemeal Tepesi'nin efendisi olmayı, en büyük sopayı taşımasına borçlu."
"[english]DOTA_Tooltip_ability_item_bogduggs_cudgel_Lore"	"Bogdugg came to lord over Bonemeal Ridge by carrying the biggest stick."
"DOTA_Tooltip_ability_item_bogduggs_cudgel_bonus_strength"	"FAZLADAN KUVVET:"
"[english]DOTA_Tooltip_ability_item_bogduggs_cudgel_bonus_strength"	"BONUS STRENGTH:"
"DOTA_Tooltip_ability_item_bogduggs_cudgel_bonus_damage"	"FAZLADAN HASAR:"
"[english]DOTA_Tooltip_ability_item_bogduggs_cudgel_bonus_damage"	"BONUS DAMAGE:"
"DOTA_Tooltip_ability_item_bogduggs_baldric"	"<font color=\"#4ae0bf\">Bogdugg's Baldric</font>"
"[english]DOTA_Tooltip_ability_item_bogduggs_baldric"	"<font color=\"#4ae0bf\">Bogdugg's Baldric</font>"
"DOTA_Tooltip_ability_item_bogduggs_baldric_Description"	"Gerekli Seviye: %required_level%\n"
"[english]DOTA_Tooltip_ability_item_bogduggs_baldric_Description"	"Required Level: %required_level%\n"
"DOTA_Tooltip_ability_item_bogduggs_baldric_Lore"	"Koşmak, vurmaktan daha eğlenceli değil… Birazcık bile."
"[english]DOTA_Tooltip_ability_item_bogduggs_baldric_Lore"	"Running's not as fun as hitting.  Not one bit."
"DOTA_Tooltip_ability_item_bogduggs_baldric_bonus_armor"	"FAZLADAN ZIRH:"
"[english]DOTA_Tooltip_ability_item_bogduggs_baldric_bonus_armor"	"BONUS ARMOR:"
"DOTA_Tooltip_ability_item_bogduggs_baldric_disable_resist_pct"	"%SERSEMLETME SÜRESİ AZALTMA:"
"[english]DOTA_Tooltip_ability_item_bogduggs_baldric_disable_resist_pct"	"%STUN DURATION REDUCTION:"
"DOTA_Tooltip_ability_item_bogduggs_baldric_move_speed_penalty"	"HAREKET HIZI AZALTMASI:"
"[english]DOTA_Tooltip_ability_item_bogduggs_baldric_move_speed_penalty"	"MOVE SPEED REDUCTION:"
"DOTA_Tooltip_ability_item_bogduggs_lucky_femur"	"<font color=\"#4ae0bf\">Bogdugg's Lucky Femur</font>"
"[english]DOTA_Tooltip_ability_item_bogduggs_lucky_femur"	"<font color=\"#4ae0bf\">Bogdugg's Lucky Femur</font>"
"DOTA_Tooltip_ability_item_bogduggs_lucky_femur_Description"	"Gerekli Seviye: %required_level%\n\nPasif: Yetenek Vuruşu - Bir yetenek kullanıldığında, o yeteneğin hemen yenilenmesi için %%%refresh_pct% şans verir.\n"
"[english]DOTA_Tooltip_ability_item_bogduggs_lucky_femur_Description"	"Required Level: %required_level%\n\nPassive: Skillshot - After an ability is cast, it has a %refresh_pct%%% chance to be immediately refreshed.\n"
"DOTA_Tooltip_ability_item_bogduggs_lucky_femur_Lore"	"Ve bir tane daha!"
"[english]DOTA_Tooltip_ability_item_bogduggs_lucky_femur_Lore"	"And another!"
"DOTA_Tooltip_ability_item_bogduggs_lucky_femur_max_mana_penalty"	"MAKSİMUM MANA AZALTMASI:"
"[english]DOTA_Tooltip_ability_item_bogduggs_lucky_femur_max_mana_penalty"	"MAX MANA REDUCTION:"
"DOTA_Tooltip_ability_item_bogduggs_lucky_femur_intelligence_penalty"	"ZEKA AZALTMASI:"
"[english]DOTA_Tooltip_ability_item_bogduggs_lucky_femur_intelligence_penalty"	"INTELLIGENCE REDUCTION:"
"DOTA_Tooltip_ability_item_bogduggs_lucky_femur_mana_regen_sec"	"FAZLADAN MANA YENİLEMESİ:"
"[english]DOTA_Tooltip_ability_item_bogduggs_lucky_femur_mana_regen_sec"	"BONUS MANA REGEN:"
"DOTA_Tooltip_ability_item_sign_of_the_arachnid"	"<font color=\"#4ae0bf\">Sign of the Arachnid</font>"
"[english]DOTA_Tooltip_ability_item_sign_of_the_arachnid"	"<font color=\"#4ae0bf\">Sign of the Arachnid</font>"
"DOTA_Tooltip_ability_item_sign_of_the_arachnid_Description"	"Gerekli Seviye: %required_level%\n\nPasif: Arachnid Aura - Dostlar fazladan hareket ve saldırı hızı kazanır."
"[english]DOTA_Tooltip_ability_item_sign_of_the_arachnid_Description"	"Required Level: %required_level%\n\nPassive: Arachnid Aura - Allies gain bonus movement and attack speed."
"DOTA_Tooltip_ability_item_sign_of_the_arachnid_Lore"	"Silken Yolunun yoldaşları üzerine kötücül bir işaret."
"[english]DOTA_Tooltip_ability_item_sign_of_the_arachnid_Lore"	"An ominous mark bestowed upon followers of the Silken Path."
"DOTA_Tooltip_ability_item_sign_of_the_arachnid_bonus_agility"	"FAZLADAN ÇEVİKLİK:"
"[english]DOTA_Tooltip_ability_item_sign_of_the_arachnid_bonus_agility"	"BONUS AGILITY:"
"DOTA_Tooltip_ability_item_sign_of_the_arachnid_bonus_move_speed_pct"	"%AURA FAZLADAN HAREKET HIZI:"
"[english]DOTA_Tooltip_ability_item_sign_of_the_arachnid_bonus_move_speed_pct"	"%AURA BONUS MOVE SPEED:"
"DOTA_Tooltip_ability_item_sign_of_the_arachnid_attack_speed"	"AURA FAZLADAN SALDIRI HIZI:"
"[english]DOTA_Tooltip_ability_item_sign_of_the_arachnid_attack_speed"	"AURA BONUS ATTACK SPEED:"
"DOTA_Tooltip_modifier_item_sign_of_the_arachnid_effect"	"Arachnid Aura"
"[english]DOTA_Tooltip_modifier_item_sign_of_the_arachnid_effect"	"Arachnid Aura"
"DOTA_Tooltip_modifier_item_sign_of_the_arachnid_effect_Description"	"Fazladan hareket ve saldırı hızı kazanılıyor."
"[english]DOTA_Tooltip_modifier_item_sign_of_the_arachnid_effect_Description"	"Gaining bonus movement and attack speed."
"DOTA_Tooltip_ability_item_unhallowed_icon"	"<font color=\"#4ae0bf\">Unhallowed Icon</font>"
"[english]DOTA_Tooltip_ability_item_unhallowed_icon"	"<font color=\"#4ae0bf\">Unhallowed Icon</font>"
"DOTA_Tooltip_ability_item_unhallowed_icon_Description"	"Gerekli Seviye: %required_level%\n\nPasif: Bloodbond Aura - Dost birimler fazladan sağlık yenilemesi kazanır. Unhallowed Icon'larından etkilenmiş herhangi bir birim etki altına girdiğinde verilen hasarın %%%lifesteal_pct% değeri çalınan can olarak sayılır ve auradan etkilenen bütün birimlere dağıtılır."
"[english]DOTA_Tooltip_ability_item_unhallowed_icon_Description"	"Required Level: %required_level%\n\nPassive: Bloodbond Aura - Allies gain bonus health regeneration. When any unit affected by Unhallowed Icon attacks, %lifesteal_pct%%% of the damage dealt is stolen as life and distributed among all affected by the aura."
"DOTA_Tooltip_ability_item_unhallowed_icon_Lore"	"Yeraltı tarafından korunanın taşıdığı bir simge."
"[english]DOTA_Tooltip_ability_item_unhallowed_icon_Lore"	"An Icon borne by the protected of the underworld."
"DOTA_Tooltip_ability_item_unhallowed_icon_bonus_strength"	"FAZLADAN KUVVET:"
"[english]DOTA_Tooltip_ability_item_unhallowed_icon_bonus_strength"	"BONUS STRENGTH:"
"DOTA_Tooltip_ability_item_unhallowed_icon_lifesteal_pct"	"%AURA BAĞLI CAN ÇALMA:"
"[english]DOTA_Tooltip_ability_item_unhallowed_icon_lifesteal_pct"	"%AURA LINKED LIFESTEAL:"
"DOTA_Tooltip_ability_item_unhallowed_icon_hp_regen"	"AURA SP YENİLEMESİ:"
"[english]DOTA_Tooltip_ability_item_unhallowed_icon_hp_regen"	"AURA HP REGEN:"
"DOTA_Tooltip_modifier_item_unhallowed_icon_effect"	"Bloodbond Aura"
"[english]DOTA_Tooltip_modifier_item_unhallowed_icon_effect"	"Bloodbond Aura"
"DOTA_Tooltip_modifier_item_unhallowed_icon_effect_Description"	"Fazladan SP yenilemesi kazanılır. Fiziksel saldırılar can çalar ve Bloodbond Aura'dan etkilenen herkese dağıtır."
"[english]DOTA_Tooltip_modifier_item_unhallowed_icon_effect_Description"	"Gaining bonus HP regen. Physical attacks steal life and distribute it among others affected by Bloodbond Aura."
"DOTA_Tooltip_ability_item_preserved_skull"	"<font color=\"#4ae0bf\">Kuru Kafa</font>"
"[english]DOTA_Tooltip_ability_item_preserved_skull"	"<font color=\"#4ae0bf\">Preserved Skull</font>"
"DOTA_Tooltip_ability_item_preserved_skull_Description"	"Gerekli Seviye: %required_level%\n\nPasif: Conjuration Aura - Dostlar fazladan mana yenilemesi ve dolum süresi azaltması kazanır."
"[english]DOTA_Tooltip_ability_item_preserved_skull_Description"	"Required Level: %required_level%\n\nPassive: Conjuration Aura - Allies gain bonus mana regen and cooldown reduction."
"DOTA_Tooltip_ability_item_preserved_skull_Lore"	"Şimdi de dalga geçsene?"
"[english]DOTA_Tooltip_ability_item_preserved_skull_Lore"	"Where be your gibes now?"
"DOTA_Tooltip_ability_item_preserved_skull_bonus_intelligence"	"FAZLADAN ZEKA:"
"[english]DOTA_Tooltip_ability_item_preserved_skull_bonus_intelligence"	"BONUS INTELLIGENCE:"
"DOTA_Tooltip_ability_item_preserved_skull_cooldown_reduction_pct"	"%AURA DOLUM SÜRESİ AZALTMA:"
"[english]DOTA_Tooltip_ability_item_preserved_skull_cooldown_reduction_pct"	"%AURA COOLDOWN REDUCTION:"
"DOTA_Tooltip_ability_item_preserved_skull_aura_mana_regen"	"AURA MANA YENİLEMESİ:"
"[english]DOTA_Tooltip_ability_item_preserved_skull_aura_mana_regen"	"AURA MANA REGEN:"
"DOTA_Tooltip_modifier_item_preserved_skull_effect"	"Ruh Çağırma Aurası"
"[english]DOTA_Tooltip_modifier_item_preserved_skull_effect"	"Conjuration Aura"
"DOTA_Tooltip_modifier_item_preserved_skull_effect_Description"	"Fazladan mana yenilemesi ve dolum süresi azaltması kazanılıyor."
"[english]DOTA_Tooltip_modifier_item_preserved_skull_effect_Description"	"Gaining bonus mana regen and cooldown reduction."
"DOTA_Tooltip_ability_item_treads_of_ermacor"	"<font color=\"#4ae0bf\">Treads of Ermacor</font>"
"[english]DOTA_Tooltip_ability_item_treads_of_ermacor"	"<font color=\"#4ae0bf\">Treads of Ermacor</font>"
"DOTA_Tooltip_ability_item_treads_of_ermacor_Description"	"Gerekli Seviye: %required_level%\nBirden fazla bottan gelen hareket hızı bonusları birleştirilemez."
"[english]DOTA_Tooltip_ability_item_treads_of_ermacor_Description"	"Required Level: %required_level%\n\nFlat movement speed bonuses from multiple pairs of boots do not stack."
"DOTA_Tooltip_ability_item_treads_of_ermacor_Lore"	"Yol Gösterenin iyi niyetiyle biz bir yol bulacağız."
"[english]DOTA_Tooltip_ability_item_treads_of_ermacor_Lore"	"With the Pathfinder's blessing, we shall find a way."
"DOTA_Tooltip_ability_item_treads_of_ermacor_bonus_movement_speed"	"FAZLADAN HAREKET HIZI:"
"[english]DOTA_Tooltip_ability_item_treads_of_ermacor_bonus_movement_speed"	"BONUS MOVEMENT SPEED:"
"DOTA_Tooltip_ability_item_treads_of_ermacor_bonus_attack_speed"	"FAZLADAN SALDIRI HIZI:"
"[english]DOTA_Tooltip_ability_item_treads_of_ermacor_bonus_attack_speed"	"BONUS ATTACK SPEED:"
"DOTA_Tooltip_ability_item_treads_of_ermacor_bonus_all_stats"	"FAZLADAN TÜM ÖZELLİKLER:"
"[english]DOTA_Tooltip_ability_item_treads_of_ermacor_bonus_all_stats"	"BONUS ALL STATS:"
"DOTA_Tooltip_ability_item_rhyziks_eye"	"<font color=\"#4ae0bf\">Rhyzik's Eye</font>"
"[english]DOTA_Tooltip_ability_item_rhyziks_eye"	"<font color=\"#4ae0bf\">Rhyzik's Eye</font>"
"DOTA_Tooltip_ability_item_rhyziks_eye_Description"	"Gerekli Seviye: %required_level%\n"
"[english]DOTA_Tooltip_ability_item_rhyziks_eye_Description"	"Required Level: %required_level%\n"
"DOTA_Tooltip_ability_item_rhyziks_eye_Lore"	"Yozlaştırıcının gözündeki kuvvet burada."
"[english]DOTA_Tooltip_ability_item_rhyziks_eye_Lore"	"There is power in the eye of the Corruptor."
"DOTA_Tooltip_ability_item_rhyziks_eye_bonus_all_stats"	"FAZLADAN TÜM ÖZELLİKLER:"
"[english]DOTA_Tooltip_ability_item_rhyziks_eye_bonus_all_stats"	"BONUS ALL STATS:"
"DOTA_Tooltip_ability_item_rhyziks_eye_bonus_damage_pct"	"%FAZLADAN HASAR:"
"[english]DOTA_Tooltip_ability_item_rhyziks_eye_bonus_damage_pct"	"%BONUS DAMAGE:"
"DOTA_Tooltip_ability_item_rhyziks_eye_damage_reduction"	"%GELEN HASAR AZALTMASI:"
"[english]DOTA_Tooltip_ability_item_rhyziks_eye_damage_reduction"	"%INCOMING DAMAGE REDUCTION:"
"DOTA_Tooltip_ability_item_rhyziks_eye_mana_regen_sec"	"FAZLADAN MANA YENİLEMESİ:"
"[english]DOTA_Tooltip_ability_item_rhyziks_eye_mana_regen_sec"	"BONUS MANA REGEN:"
"DOTA_Tooltip_ability_item_rhyziks_eye_hp_regen_sec"	"FAZLADAN SP YENİLEMESİ:"
"[english]DOTA_Tooltip_ability_item_rhyziks_eye_hp_regen_sec"	"BONUS HP REGEN:"
"DOTA_Tooltip_ability_item_guardian_shell"	"<font color=\"#4ae0bf\">Guardian Shell</font>"
"[english]DOTA_Tooltip_ability_item_guardian_shell"	"<font color=\"#4ae0bf\">Guardian Shell</font>"
"DOTA_Tooltip_ability_item_guardian_shell_Description"	"Gerekli Seviye: %required_level%\n\nPasif: Sarsılmaz - Kuşananın hareket hızı yavaşlatılamaz ve yere bağlanamaz."
"[english]DOTA_Tooltip_ability_item_guardian_shell_Description"	"Required Level: %required_level%\n\nPassive: Unwavering - Movement Speed cannot be slowed and wearer cannot be rooted."
"DOTA_Tooltip_ability_item_guardian_shell_Lore"	"Her zaman ileri, ölümlü yüklerini sırtlamadan."
"[english]DOTA_Tooltip_ability_item_guardian_shell_Lore"	"Push ever onward, unburdened by mortal cares."
"DOTA_Tooltip_ability_item_guardian_shell_bonus_armor"	"FAZLADAN ZIRH:"
"[english]DOTA_Tooltip_ability_item_guardian_shell_bonus_armor"	"BONUS ARMOR:"
"DOTA_Tooltip_ability_item_guardian_shell_magic_resistance"	"%FAZLADAN BÜYÜ DİRENCİ:"
"[english]DOTA_Tooltip_ability_item_guardian_shell_magic_resistance"	"%BONUS MAGIC RESISTANCE:"
"DOTA_Tooltip_ability_item_watchers_gaze"	"<font color=\"#4ae0bf\">Watcher's Gaze</font>"
"[english]DOTA_Tooltip_ability_item_watchers_gaze"	"<font color=\"#4ae0bf\">Watcher's Gaze</font>"
"DOTA_Tooltip_ability_item_watchers_gaze_Description"	"Gerekli Seviye: %required_level%\n\nEtkin: Taş Bakış - Karakterin yüzüne bakan düşmanlar taşa dönüşür ve fazladan fiziksel hasar alırlar."
"[english]DOTA_Tooltip_ability_item_watchers_gaze_Description"	"Required Level: %required_level%\n\nActive: Stone Gaze - Enemies within your frontal cone are turned to stone and take additional physical damage.\n"
"DOTA_Tooltip_ability_item_watchers_gaze_Lore"	"Düşmanlarınıza bakın ve karşınızda taş kesilmelerine şahit olun."
"[english]DOTA_Tooltip_ability_item_watchers_gaze_Lore"	"Look upon thine enemies and see them petrify before you."
"DOTA_Tooltip_ability_item_watchers_gaze_bonus_stats"	"FAZLADAN TÜM ÖZELLİKLER:"
"[english]DOTA_Tooltip_ability_item_watchers_gaze_bonus_stats"	"BONUS ALL STATS:"
"DOTA_Tooltip_ability_item_carapace_of_qaldin"	"<font color=\"#4ae0bf\">Carapace of Qaldin</font>"
"[english]DOTA_Tooltip_ability_item_carapace_of_qaldin"	"<font color=\"#4ae0bf\">Carapace of Qaldin</font>"
"DOTA_Tooltip_ability_item_carapace_of_qaldin_Description"	"Gerekli Seviye: %required_level%\n\nPPasif: Asitli Yenileme - Bütün mana ve sağlık kazanımı iki katına çıkar ve alınan hasarın belli bir yüzdesi saldırana yansıtılır.\n"
"[english]DOTA_Tooltip_ability_item_carapace_of_qaldin_Description"	"Required Level: %required_level%\n\nPassive: Acidic Regeneration - All mana and health gained are doubled, and a percentage of all damage taken is reflected back upon the attacker.\n"
"DOTA_Tooltip_ability_item_carapace_of_qaldin_Lore"	"Saldırmalarına izin ver, vurdukları her saldırının bir kan karşılığı var."
"[english]DOTA_Tooltip_ability_item_carapace_of_qaldin_Lore"	"Let them attack you, for each blow comes at a blood price."
"DOTA_Tooltip_ability_item_carapace_of_qaldin_bonus_hp"	"FAZLADAN SP:"
"[english]DOTA_Tooltip_ability_item_carapace_of_qaldin_bonus_hp"	"BONUS HP:"
"DOTA_Tooltip_ability_item_carapace_of_qaldin_bonus_mana"	"FAZLADAN MANA:"
"[english]DOTA_Tooltip_ability_item_carapace_of_qaldin_bonus_mana"	"BONUS MANA:"
"DOTA_Tooltip_ability_item_carapace_of_qaldin_bonus_restore_pct"	"%FAZLADAN YENİLEME:"
"[english]DOTA_Tooltip_ability_item_carapace_of_qaldin_bonus_restore_pct"	"%BONUS RESTORE:"
"DOTA_Tooltip_ability_item_carapace_of_qaldin_damage_return_pct"	"%YANSITILAN HASAR:"
"[english]DOTA_Tooltip_ability_item_carapace_of_qaldin_damage_return_pct"	"%DAMAGE RETURNED:"
"DOTA_Tooltip_ability_item_the_caustic_finale"	"<font color=\"#4ae0bf\">The Caustic Finale</font>"
"[english]DOTA_Tooltip_ability_item_the_caustic_finale"	"<font color=\"#4ae0bf\">The Caustic Finale</font>"
"DOTA_Tooltip_ability_item_the_caustic_finale_Description"	"Gerekli Seviye: %required_level%\n\nPasif: Yakıcı Son - Saldırılar hedefin zırhının belli bir yüzdesini düşürür. Bu etki istiflenir. Eğer hedef bu etki altındayken ölürse, hedef patlar ve çevresindeki bölgeye hasar verir.\n"
"[english]DOTA_Tooltip_ability_item_the_caustic_finale_Description"	"Required Level: %required_level%\n\nPassive: Caustic Finale - Attacks reduce a percentage of the target's armor.  This effect stacks up to %max_stack_count% times.  If the target dies under this effect, it explodes, dealing damage in an area of effect.\n"
"DOTA_Tooltip_ability_item_the_caustic_finale_Lore"	"Patlayıcı hediye her zaman önden ödenir."
"[english]DOTA_Tooltip_ability_item_the_caustic_finale_Lore"	"The caustic gift is always paid forward."
"DOTA_Tooltip_ability_item_the_caustic_finale_bonus_damage"	"FAZLADAN HASAR:"
"[english]DOTA_Tooltip_ability_item_the_caustic_finale_bonus_damage"	"BONUS DAMAGE:"
"DOTA_Tooltip_ability_item_the_caustic_finale_bonus_attack_speed"	"FAZLADAN SALDIRI HIZI:"
"[english]DOTA_Tooltip_ability_item_the_caustic_finale_bonus_attack_speed"	"BONUS ATTACK SPEED:"
"DOTA_Tooltip_ability_item_the_caustic_finale_caustic_armor_reduction_pct"	"%İSTİF BAŞINA ZIRH AZALTMA:"
"[english]DOTA_Tooltip_ability_item_the_caustic_finale_caustic_armor_reduction_pct"	"%ARMOR REDUCTION PER STACK:"
"DOTA_Tooltip_ability_item_the_caustic_finale_caustic_radius"	"PATLAMA YARIÇAPI:"
"[english]DOTA_Tooltip_ability_item_the_caustic_finale_caustic_radius"	"CAUSTIC RADIUS:"
"DOTA_Tooltip_ability_item_the_caustic_finale_caustic_damage"	"PATLAMA HASARI:"
"[english]DOTA_Tooltip_ability_item_the_caustic_finale_caustic_damage"	"CAUSTIC DAMAGE:"
"DOTA_Tooltip_ability_item_the_caustic_finale_max_stack_count"	"MAKS İSTİF SAYISI:"
"[english]DOTA_Tooltip_ability_item_the_caustic_finale_max_stack_count"	"MAX STACK COUNT:"
"DOTA_Tooltip_modifier_book_of_strength"	"Kuvvet Kitabı"
"[english]DOTA_Tooltip_modifier_book_of_strength"	"Book of Strength"
"DOTA_Tooltip_modifier_book_of_strength_Description"	"Okunan Kitaplardan Kuvvet kazanıldı."
"[english]DOTA_Tooltip_modifier_book_of_strength_Description"	"Strength gained from consumed Books."
"DOTA_Tooltip_modifier_book_of_agility"	"Çeviklik Kitabı"
"[english]DOTA_Tooltip_modifier_book_of_agility"	"Book of Agility"
"DOTA_Tooltip_modifier_book_of_agility_Description"	"Okunan Kitaplardan Çeviklik kazanıldı."
"[english]DOTA_Tooltip_modifier_book_of_agility_Description"	"Agility gained from consumed Books."
"DOTA_Tooltip_modifier_book_of_intelligence"	"Zekâ Kitabı"
"[english]DOTA_Tooltip_modifier_book_of_intelligence"	"Book of Intelligence"
"DOTA_Tooltip_modifier_book_of_intelligence_Description"	"Okunan Kitaplardan Zekâ kazanıldı."
"[english]DOTA_Tooltip_modifier_book_of_intelligence_Description"	"Intelligence gained from consumed Books."
"DOTA_Tooltip_modifier_sand_king_boss_caustic_finale"	"Caustic Finale"
"[english]DOTA_Tooltip_modifier_sand_king_boss_caustic_finale"	"Caustic Finale"
"DOTA_Tooltip_modifier_sand_king_boss_caustic_finale_Description"	"Her bir istif zırhı %10 azaltır."
"[english]DOTA_Tooltip_modifier_sand_king_boss_caustic_finale_Description"	"Each stack reduces armor by 10%%."
"DOTA_Tooltip_ability_item_tombstone"	"Takım Arkadaşını Dirilt"
"[english]DOTA_Tooltip_ability_item_tombstone"	"Resurrect Teammate"
"DOTA_Chat_Tombstone_Pinged"	"Burada ölü bir takım arkadaşı var."
"[english]DOTA_Chat_Tombstone_Pinged"	"Fallen teammate here."
"Popup_UsingOrbOfPassage"	"Orb of Passage İle Açıldı"
"[english]Popup_UsingOrbOfPassage"	"Opened With Orb of Passage"
"DOTA_Tooltip_ability_item_orb_of_passage"	"Orb of Passage"
"[english]DOTA_Tooltip_ability_item_orb_of_passage"	"Orb of Passage"
"Dungeon_FoundChestItem"	"{s:player_name} şu eşyayı içeren bir hazine buldu: {s:locstring_value}"
"[english]Dungeon_FoundChestItem"	"{s:player_name} found a treasure containing: {s:locstring_value}"
"Dungeon_FoundChestGold"	"{s:player_name} şu eşyayı içeren bir hazine buldu: <font color='#ffd825'>{d:int_value}</font><panel class='CombatEventGoldIcon'/>"
"[english]Dungeon_FoundChestGold"	"{s:player_name} found a treasure containing: <font color='#ffd825'>{d:int_value}</font><panel class='CombatEventGoldIcon'/>"
"Dungeon_FoundChestTrap"	"{s:player_name} şu eşyayı içeren bir hazine buldu: <font color='#ffd825'>{s:locstring_value}</font>!"
"[english]Dungeon_FoundChestTrap"	"{s:player_name} found a treasure containing: <font color='#ffd825'>{s:locstring_value}</font>!"
"Dungeon_FoundLifeRune"	"{s:player_name} bir {s:locstring_value} buldu!"
"[english]Dungeon_FoundLifeRune"	"{s:player_name} found a {s:locstring_value}!"
"Dungeon_FoundNewRelic"	"{s:player_name} yeni bir Eser buldu: <font color='#4ae0bf'>{s:locstring_value}</font>!"
"[english]Dungeon_FoundNewRelic"	"{s:player_name} found a new Artifact: <font color='#4ae0bf'>{s:locstring_value}</font>!"
"Dungeon_KilledByCreature"	"{s:player_name}, {s:locstring_value} tarafından öldürüldü"
"[english]Dungeon_KilledByCreature"	"{s:player_name} was killed by {s:locstring_value}"
"Dungeon_ReachedCheckpoint"	"{s:player_name} yeni bir kontrol noktasına ulaştı!"
"[english]Dungeon_ReachedCheckpoint"	"{s:player_name} reached a new checkpoint!"
"Dungeon_KeyItem"	"{s:player_name} bir Görev Eşyası buldu: {s:locstring_value}!"
"[english]Dungeon_KeyItem"	"{s:player_name} found a Key Item: {s:locstring_value}!"
"start"	"Yhilla'nın Sığınağı"
"[english]start"	"Yhilla's Cove"
"forest"	"Uluyan Kır"
"[english]forest"	"Howling Weald"
"forest_holdout"	"Kavşak Garnizonu"
"[english]forest_holdout"	"Crossroads Garrison"
"darkforest_rescue"	"Bonemeal Tepesi"
"[english]darkforest_rescue"	"Bonemeal Ridge"
"darkforest_pass"	"Silkmire Geçidi"
"[english]darkforest_pass"	"The Silkmire Pass"
"darkforest_death_maze"	"Gallaron'un Yargılamaları"
"[english]darkforest_death_maze"	"Trial of Gallaron"
"underground_temple"	"Ermacor'un Tapınağı"
"[english]underground_temple"	"Temple of Ermacor"
"desert_start"	"Kalabor Yolu"
"[english]desert_start"	"The Road to Kalabor"
"desert_town"	"Kalabor Vahası"
"[english]desert_town"	"Kalabor Oasis"
"desert_expanse"	"Kalabor Issızı"
"[english]desert_expanse"	"Kalabor Waste"
"desert_outpost"	"Kuzey Karakolu"
"[english]desert_outpost"	"Northern Outpost"
"desert_chasm"	"Shatterblast Kanyonu"
"[english]desert_chasm"	"Shatterblast Canyon"
"desert_fortress"	"Rhyzik'in Kalesi"
"[english]desert_fortress"	"Rhyzik's Stronghold"
"kill_hellbears"	"Vahşi Hellbears Avla"
"[english]kill_hellbears"	"Hunt Berserker Hellbears"
"reach_the_camp"	"Kavşak Garnizonu'nu Bul"
"[english]reach_the_camp"	"Find the Crossroads Garrison"
"speak_to_the_chief"	"Garnizon Komutanı'nı Bul"
"[english]speak_to_the_chief"	"Find the Garrison Commander"
"learn_about_holdout"	"Dükkânı ziyaret ettikten sonra Komutan ile konuş"
"[english]learn_about_holdout"	"Speak to the Commander after visiting the shop"
"defend_the_camp"	"Saldırı sonunda Komutanın hayatta kalmasını sağla"
"[english]defend_the_camp"	"Ensure the Commander survives the assault"
"speak_to_chief_holdout_complete"	"Komutan İle Konuş"
"[english]speak_to_chief_holdout_complete"	"Speak to the Commander"
"rescue_soldiers"	"Kayıp Askerleri Kurtar"
"[english]rescue_soldiers"	"Rescue the Missing Soldiers"
"rescue_the_captain"	"Asker Kaptan'ı Kurtar"
"[english]rescue_the_captain"	"Rescue the Soldier Captain"
"navigate_death_maze"	"Orb of Passage'ı Bul"
"[english]navigate_death_maze"	"Find the Orb of Passage"
"kill_spider_boss"	"Örümcekler Kraliçesini mağlup et"
"[english]kill_spider_boss"	"Defeat the Spider Queen"
"kill_spider_eggs"	"Kuluçka Keselerini yok et"
"[english]kill_spider_eggs"	"Destroy the Brood Sacs"
"navigate_underground_temple"	"Kalabor çölünün çıkışını bul"
"[english]navigate_underground_temple"	"Find the exit to Kalabor desert"
"find_entrance_to_the_underground"	"Grimwal Kapısını açmak için Geçiş Kürelerini kullan"
"[english]find_entrance_to_the_underground"	"Use Orbs of Passage to open the Grimwal Gate"
"find_underground_temple"	"Tapınak girişini bul"
"[english]find_underground_temple"	"Find the entrance to the Temple"
"find_hidden_treasures"	"Tapınak Hazinelerini ele geçir"
"[english]find_hidden_treasures"	"Loot the Temple Treasures"
"learn_about_babyback"	"Mahsur kalmış yolcuyla konuş"
"[english]learn_about_babyback"	"Speak to the stranded traveler"
"start_escort"	"Brigwyr'e kasabaya kadar eşlik et"
"[english]start_escort"	"Escort Brigwyr to town"
"escort_babyback_to_desert_town"	"Brigwyr'i haydutlardan koru"
"[english]escort_babyback_to_desert_town"	"Protect Brigwyr from bandits"
"kill_centaur_warlords"	"Sentor Derebeylerini mağlup et"
"[english]kill_centaur_warlords"	"Defeat the Centaur Warlords"
"kill_giant_burrowers"	"Dev Kumsürüsü Kurtlarını mağlup et"
"[english]kill_giant_burrowers"	"Defeat the Giant Sandswarm Burrowers"
"reach_desert_outpost"	"Kuzey Karakoluna ulaş"
"[english]reach_desert_outpost"	"Reach the Northern Outpost"
"speak_to_the_captain"	"Kaptan Lightfoot ile konuş"
"[english]speak_to_the_captain"	"Speak to Captain Lightfoot"
"learn_about_assault"	"Rhyzik'in Kalesine saldırmaya hazırlan"
"[english]learn_about_assault"	"Prepare to attack Rhyzik's Stronghold"
"kill_the_dire_captains"	"Buzzick Kaptanlarını öldür"
"[english]kill_the_dire_captains"	"Kill the Buzzick Captains"
"assault_the_desert_fortress"	"Rhyzik'in İnini Bul"
"[english]assault_the_desert_fortress"	"Find Rhyzik's Lair"
"kill_sand_king"	"Rhyzik'i Öldürün"
"[english]kill_sand_king"	"Defeat Rhyzik"
"consumed_orbs_of_passage"	"İki Geçiş Küresi harcandı"
"[english]consumed_orbs_of_passage"	"Consumed Two Orbs Of Passage"
"welcome_brigwyr"	"Kapı Brigwyr İçin Açılıyor"
"[english]welcome_brigwyr"	"The Gate Opens for Brigwyr"
"Dungeon_Zone"	"Bölge"
"[english]Dungeon_Zone"	"Zone"
"Dungeon_ZoneTime"	"Bölge Süresi"
"[english]Dungeon_ZoneTime"	"Zone Time"
"Dungeon_Scoreboard_Kills"	"Leş"
"[english]Dungeon_Scoreboard_Kills"	"Kills"
"Dungeon_Scoreboard_Deaths"	"Ölüm"
"[english]Dungeon_Scoreboard_Deaths"	"Deaths"
"Dungeon_Scoreboard_GoldBags"	"Altın Kesesi"
"[english]Dungeon_Scoreboard_GoldBags"	"GoldBags"
"Dungeon_Scoreboard_Potions"	"İksir"
"[english]Dungeon_Scoreboard_Potions"	"Potions"
"Dungeon_Scoreboard_Total"	"Toplam"
"[english]Dungeon_Scoreboard_Total"	"Total"
"Dungeon_ZoneDesc_forest_holdout"	"Kalabor'un yerinden edilmiş halkı, vahşi topraklara yerleşmek için çabalarken sayısız tehlikelerle karşılaştı."
"[english]Dungeon_ZoneDesc_forest_holdout"	"The displaced folk of Kalabor face untold threats as they push to settle the wildlands."
"Dungeon_ZoneDesc_desert_fortress"	"Yozlaştırıcı Rhyzik, Siltbreaker'ın kuru topraklardaki düşmanları üzerine lanetlenmiş başkaldırışının başladığı zaman ilk saldırıyı yapması için yaratıldı."
"[english]Dungeon_ZoneDesc_desert_fortress"	"Rhyzik the Corruptor was created to strike the first blow when Siltbreaker expanded his doomed uprising to target dryland enemies."
"siltbreaker_acti_intro_tab_text"	"Korkunç canavar Siltbreaker Karanlık Resif hapishanesinden kaçış planları yaparken, Brine Meclisindeki düşmanları ona karşı silahlanacak bir savaşçılar grubu bir araya getiriyor. Meclisin çağrısına cevap veren maceracılar için Karanlık Resif'in yolu Kalabor'un kumları yakınlarında başlıyor. Siltbreaker'ın çarpık tasarımı Yozlaştırıcı Rhyzik ustasının planlarına yardım etmek için gücünü topluyor..."
"[english]siltbreaker_acti_intro_tab_text"	"As the fiend Siltbreaker plots an escape from Dark Reef prison, his enemies in the Conclave of the Brine assemble a band of warriors to take up arms against him. For the adventurers who answer the Conclave's call, the road to Dark Reef begins near the sands of Kalabor, where Siltbreaker's twisted creation, Rhyzik the Corruptor, gathers strength to aid his master's plans..."
"TPScroll_Quest_Label"	"Siltbreaker'ın kaçış girişiminin farkındayız <br><br>Yozlaştırıcı Rhyzik, ustasının geri dönüşüne yardım için <br>yeniden gün yüzüne çıktı <br><br>Rhyzik uzun zamandır bizden saklanıyordu — Karanlık Resif'e sızmadan önce onu yok edin <br><br>Meclise karşı olan bu tehditleri halledin — İsminiz kara kaplı defterden silinsin"
"[english]TPScroll_Quest_Label"	"Siltbreaker's escape attempt did not go unnoticed <br><br>Rhyzik the Corruptor has resurfaced to aid his <br>master's revival <br><br>Rhyzik has long eluded us — Destroy him before infiltrating Dark Reef <br><br>End these threats to the Conclave — Our ledger will be cleared of your name"
"siltbreaker_acti_outro_01"	"Yozlaştırıcı Rhyzik'ın yenilmesi ve Siltbreaker'ın gücünün bir bölümünün yok edilmesi, Meclisin görevini tamamlamak için ilk adım. Rhyzik'ın akınlarından kurtulan Kalabor halkı evlerine dönmekte veya durulmuş Kırlarda yeni bir memleket kurabilmekte artık özgürler."
"[english]siltbreaker_acti_outro_01"	"With Rhyzik the Corruptor defeated and a measure of Siltbreaker's might destroyed, the first step of the Conclave's mission is complete. Free of Rhyzik's swarms, the people of Kalabor are free to return home or establish a new homeland amidst the pacified Weald."
"Dialogue_theod_quest_text"	"Maelrawn'a şükürler olsun... hayattasın. Sana yol göstermek— ah! i-için gönderilmiştim. Sonra işler... kötüye gitti."
"[english]Dialogue_theod_quest_text"	"Praise Maelrawn... you made it. I was sent— uh! T-to guide you. Things took... a bad turn."
"Dialog_ForestChief_DefendTheCamp"	"Kurtlar dört bir yanımızda! Beni korursan savaş ganimetleri senindir!"
"[english]Dialog_ForestChief_DefendTheCamp"	"Hounds on all sides! Defend my life and the spoils of battle will be yours!"
"dia_holdout_boss_battlecry"	"Sığınaklarda katledilen dostlarımız için!"
"[english]dia_holdout_boss_battlecry"	"For those butchered in our dens!"
"Dialog_ForestChief_HoldoutComplete"	"İtiraf etmek istemesem de sanırım o yaşlı kurt benim kokumu buldu."
"[english]Dialog_ForestChief_HoldoutComplete"	"Don't like to admit it, but that old howler found my scent."
"Dialog_ForestChief_passive_02"	"Longclaw ölünce, bütün kırın geleceği tehlikeye düştü."
"[english]Dialog_ForestChief_passive_02"	"With Longclaw dead, the whole of the Weald is up for grabs."
"Dialog_ForestChief_passive_03"	"İşverenlerimin bu kamp hakkında pek çok planı var."
"[english]Dialog_ForestChief_passive_03"	"My employers have a lot riding on this camp."
"dia_garrison_creep_01_01"	"Son devriye geri gelmedi."
"[english]dia_garrison_creep_01_01"	"Last patrol didn't come back."
"dia_garrison_creep_01_02"	"Kırların Kalabor'dan daha güvenli olup olmadığını gerçekten sorgulamaya başladım."
"[english]dia_garrison_creep_01_02"	"Starting to wonder if the Weald is any safer than Kalabor."
"dia_garrison_creep_01_03"	"Targan bir paralı asker olabilir ama o gerçekten iyi bir komutan."
"[english]dia_garrison_creep_01_03"	"Targan might be a hired hand, but he's a fine commander."
"dia_garrison_creep_01_04"	"İşverenleri hakkında emin değilim ama..."
"[english]dia_garrison_creep_01_04"	"Not sure about his employers though..."
"dia_garrison_creep_01_05"	"Pek çok tanınmadık yüz herhangi bir gün buraya gelebilir."
"[english]dia_garrison_creep_01_05"	"Lot of new folks due here any day."
"dia_garrison_creep_01_06"	"Batıdan bu kadar çok gezginin geldiğini görmemiştim..."
"[english]dia_garrison_creep_01_06"	"Don't see many travelers arrive from the west..."
"dia_garrison_creep_01_06_sven"	"Buralarda senin kılıcın gibi kılıçları kullanabiliriz."
"[english]dia_garrison_creep_01_06_sven"	"We could use a sword like yours around here."
"dia_garrison_creep_01_06_tidehunter"	"Senin için yeterince ıslak mı?"
"[english]dia_garrison_creep_01_06_tidehunter"	"Wet enough for you?"
"dia_garrison_creep_01_06_tiny"	"Kamp oldukça hızlı bir şekilde büyüyecek anlaşılan."
"[english]dia_garrison_creep_01_06_tiny"	"Camp's going to grow fast."
"dia_garrison_creep_01_06_legion_commander"	"Kampı onlar için güvenli hale getirmeliyiz."
"[english]dia_garrison_creep_01_06_legion_commander"	"We have to make camp safe for them."
"dia_garrison_creep_01_06_templar_assassin"	"Belkide bir okula bile ihtiyacımız olabilir."
"[english]dia_garrison_creep_01_06_templar_assassin"	"We'll even need a school."
"dia_garrison_creep_01_06_troll_warlord"	"Bu sana uymadı mı?"
"[english]dia_garrison_creep_01_06_troll_warlord"	"That don't appeal to you?"
"dia_garrison_creep_01_06_witch_doctor"	"Umarım yakında şifacılar gelir."
"[english]dia_garrison_creep_01_06_witch_doctor"	"I hope some healers arrive soon."
"dia_garrison_creep_01_06_windrunner"	"Bize katılmak istersen kapımız açık."
"[english]dia_garrison_creep_01_06_windrunner"	"You'd be welcome to join us."
"dia_garrison_creep_01_06_drow_ranger"	"Temiz bir başlangıç mı arıyorsun?"
"[english]dia_garrison_creep_01_06_drow_ranger"	"Looking for a fresh start?"
"dia_garrison_creep_01_06_jakiro"	"Başka birisiyle karşılaşmadan sırtını bile dönemiyorsun anlaşılan."
"[english]dia_garrison_creep_01_06_jakiro"	"Won't be able to turn around without running into someone."
"dia_garrison_creep_01_06_lina"	"Muhtemelen çok geçmeden pek çok kişinin sinirden alev aldığını göreceksin."
"[english]dia_garrison_creep_01_06_lina"	"Probably see a few tempers flare before long."
"dia_garrison_creep_01_06_nevermore"	"Nereden geldim demiştin?"
"[english]dia_garrison_creep_01_06_nevermore"	"Where did you say you're from?"
"dia_garrison_creep_02_01"	"Kırlardan tek başınıza mı geçtiniz?"
"[english]dia_garrison_creep_02_01"	"You came through the Weald alone?"
"dia_garrison_creep_02_02"	"Kimsenin o kadar çılgın olduğunu düşünmezdim."
"[english]dia_garrison_creep_02_02"	"Didn't think anyone was that crazy."
"dia_garrison_creep_02_03"	"Kısa zaman önce kendi başıma geldim buraya."
"[english]dia_garrison_creep_02_03"	"Recently arrived here myself."
"dia_garrison_creep_02_04"	"Memlekette hiç böyle yağmur yağmaz."
"[english]dia_garrison_creep_02_04"	"Never rains like this back home."
"dia_garrison_creep_02_05"	"Onca kumu hiç mi hiç özlemiyorum."
"[english]dia_garrison_creep_02_05"	"I don't miss all that sand one bit."
"dia_garrison_creep_02_06"	"Buradan sadece geçip gidecek misiniz?"
"[english]dia_garrison_creep_02_06"	"You just passing through?"
"dia_garrison_creep_03_01"	"Kampa pek çok yeni yüz gelmiş."
"[english]dia_garrison_creep_03_01"	"Lot of new faces in camp."
"dia_garrison_creep_03_02"	"Merak ediyorum acaba ne kadar hayatta kalabilecekler."
"[english]dia_garrison_creep_03_02"	"Wonder how long they'll survive."
"dia_garrison_creep_03_03"	"Grubunuz oldukça iyi görünüyor."
"[english]dia_garrison_creep_03_03"	"Your group looks of the right sort."
"dia_garrison_creep_03_04"	"Herkes buraya Kalabor'dan kaçmak için koşarak geliyor..."
"[english]dia_garrison_creep_03_04"	"Everyone's running here to escape Kalabor..."
"dia_garrison_creep_03_05"	"Bizim kendi problemlerimiz var."
"[english]dia_garrison_creep_03_05"	"We got our own problems."
"dia_garrison_creep_03_06"	"Mültecilerin durumu kötü. Yiğidi öldür hakkını yeme."
"[english]dia_garrison_creep_03_06"	"The refugees are tough. I'll give 'em that."
"dia_garrison_creep_04_01"	"Bu şekilde değil... Bu şekilde değil."
"[english]dia_garrison_creep_04_01"	"Not like this... Not like this."
"dia_garrison_creep_04_02"	"Buraya bunun gibi olaylardan kaçmak için geldim!"
"[english]dia_garrison_creep_04_02"	"I came here to get away from stuff like this!"
"dia_garrison_creep_04_03"	"Aç canavarlar!"
"[english]dia_garrison_creep_04_03"	"Hungry ogres!"
"dia_garrison_creep_04_04"	"Bencil büyücüler!"
"[english]dia_garrison_creep_04_04"	"Arrogant wizards!"
"dia_garrison_creep_04_05"	"Rhyzik ile kendi şansımı denemeliydim..."
"[english]dia_garrison_creep_04_05"	"Should've taken my chances with Rhyzik..."
"dia_garrison_creep_04_06"	"En azından su güzel..."
"[english]dia_garrison_creep_04_06"	"At least the water's nice..."
"dia_garrison_creep_04_06_troll_warlord"	"Herhangi bir sorun istemiyorum..."
"[english]dia_garrison_creep_04_06_troll_warlord"	"I don't want any trouble..."
"dia_garrison_creep_04_06_dazzle"	"Gözüm üzerinizde..."
"[english]dia_garrison_creep_04_06_dazzle"	"Got my eye on you..."
"dia_garrison_creep_04_06_legion_commander"	"Sancaklarınız görmek ne hoş!"
"[english]dia_garrison_creep_04_06_legion_commander"	"Your banners are a welcome sight!"
"dia_garrison_creep_04_06_windrunner"	"Oralarda kendi kendine bakabilecek birisine benziyorsunuz."
"[english]dia_garrison_creep_04_06_windrunner"	"You look like you can handle yourself out there."
"dia_garrison_creep_04_06_sven"	"O şeyi nasıl sallayabiliyorsun öyle?"
"[english]dia_garrison_creep_04_06_sven"	"How do you even swing that thing?"
"dia_garrison_creep_05_01"	"Neden herkes gergin anlamıyorum."
"[english]dia_garrison_creep_05_01"	"Don't know why everyone's on edge."
"dia_garrison_creep_05_02"	"O kurtlar asal barikatları aşamayacaklar."
"[english]dia_garrison_creep_05_02"	"Those howlers'll never get through the stockade."
"dia_garrison_creep_05_03"	"Bu direkleri kendim yaptım."
"[english]dia_garrison_creep_05_03"	"I dug those posts myself."
"dia_garrison_creep_05_04"	"Kayıp askerlerin iyi olduklarına eminim."
"[english]dia_garrison_creep_05_04"	"I'm sure the missing soldiers are fine."
"dia_garrison_creep_05_05"	"Kalabor'dan gelecek olan sıradaki karavan yakında gelmiş olur."
"[english]dia_garrison_creep_05_05"	"The next caravan from Kalabor should arrive soon."
"dia_garrison_creep_05_06"	"Kampın bir süre sonra tam bir kasaba olacağına eminim."
"[english]dia_garrison_creep_05_06"	"Pretty soon this camp'll be a full-fledged town."
"dia_garrison_creep_05_07"	"Torunlarıma bundan bahsedeceğim!"
"[english]dia_garrison_creep_05_07"	"I'll tell my grandkids about this!"
"Dialog_Ogre_Kill_Boss"	"İLK ANKABOOT'U ÖLDÜRÜN!"
"[english]Dialog_Ogre_Kill_Boss"	"KILL ANKABOOT FIRST!"
"dia_special_guest_01"	"Buradaki aptallar benim Gallaron olduğumu düşünüyorlar, ancak bazıları beni başka bir ad ile tanıyor..."
"[english]dia_special_guest_01"	"The fools here think me Gallaron, but some know me by a different name..."
"dia_special_guest_04"	"Quas Wex İhracattan bir hazine almaya mı yelteniyorsunuz?"
"[english]dia_special_guest_04"	"Dare you purchase a treasure from Quas Wex Exports?"
"DOTA_Tooltip_Ability_item_treasure_box"	"Gallaron'un Kumarı"
"[english]DOTA_Tooltip_Ability_item_treasure_box"	"Gallaron's Gamble"
"dia_temple_adventurer_02"	"Örümcekleri ve kurtları halledebilirim. Ama kılıcımı uçan gargoyle'lar için köreltmeyeceğim!"
"[english]dia_temple_adventurer_02"	"Spiders and wolves I can handle. But I'm not going to dull my blade on flying gargoyles!"
"dia_wisp_temple_03"	"Rhyzik içinde ustasının özünün bir kısmını taşıyor."
"[english]dia_wisp_temple_03"	"Rhyzik carries inside him a measure of his master's essence."
"dia_wisp_temple_05"	"Kuzeyde küçük bir direniş karakolu son bir hamleye hazırlanıyor."
"[english]dia_wisp_temple_05"	"Far to the north, a small outpost of resistance makes a final stand."
"dia_wisp_epi_01"	"Çok şey başardınız, ancak daha yapılacak çok iş var."
"[english]dia_wisp_epi_01"	"You have done much, but more work remains."
"dia_wisp_epi_02"	"Bu geçit ile Karanlık Resif'e gidin ve gerçek görevinize devam edin."
"[english]dia_wisp_epi_02"	"Take this portal to Dark Reef, and the true task at hand."
"Dialog_FriendlyBristlebackSon_PreMission_02"	"Belki de siz buradayken her şey yoluna girecek! Hazır olduğunuzda bana haber verin."
"[english]Dialog_FriendlyBristlebackSon_PreMission_02"	"With you here, maybe it's ok! Just let me know when you're ready."
"Dialog_FriendlyBristlebackSon"	"Kalabor bu tarafta. Kapıyı yabancılara açmazlar, o yüzden beni arkada bırakma!"
"[english]Dialog_FriendlyBristlebackSon"	"Kalabor's this way. They won't open the gate for strangers, so don't leave me behind!"
"Dialog_BristleDad"	"Karakolu geri alırken çok fazla kişi kaybettik. Bölgede hala düşman varken kimsenin geçmesine izin veremeyiz. Centaur Savaş Lordlarını yok edin ve sizin geçmenize izin vereyim."
"[english]Dialog_BristleDad"	"We lost too much retaking the outpost. Can't let anyone through while the area's still so overrun. Destroy the Centaur Warlords and I can let you pass."
"Dialog_BristleDad_GoToOutpost"	"Son saldırıyı yapmak için vakit geldi. Kaptan Lightfoot ve adamlar köprünün öbür ucunda bekleyecekler. Onlar sizinle Rhyzik'e karşı ilerleyecekler."
"[english]Dialog_BristleDad_GoToOutpost"	"It's time to make the final push. Captain Lightfoot and his men wait across the bridge. They'll march with you against Rhyzik."
"Dialog_RadiantCaptain_BeginAssault"	"Bugün onlara Kalabor'un savunucuların kim olduklarını gösterme vakti!"
"[english]Dialog_RadiantCaptain_BeginAssault"	"Today we show them what Kalabor's defenders are made of!"
"desert_town_folk_01_01"	"Bu adam hangi cehennemde?"
"[english]desert_town_folk_01_01"	"Where the hell is that guy?"
"desert_town_folk_01_05"	"Muhtemelen bir yerde uyuyordur."
"[english]desert_town_folk_01_05"	"He's probably asleep somewhere."
"desert_town_folk_01_06"	"Onu bulduğumda..."
"[english]desert_town_folk_01_06"	"When I find him..."
"desert_town_folk_01_06_drow_ranger"	"Hiç her şeyi geride bırakmayı arzuladın mı?"
"[english]desert_town_folk_01_06_drow_ranger"	"Ever wish you could leave it all behind?"
"desert_town_folk_01_06_sven"	"Yaptığın şeyden övünç duy ya da yapma. Tamam mı?"
"[english]desert_town_folk_01_06_sven"	"Take pride in what you do, or don't do it. Right?"
"desert_town_folk_01_06_legion_commander"	"Ömründe hiç çalışmak zorunda kalmamıştı."
"[english]desert_town_folk_01_06_legion_commander"	"He never had to work a day in his life."
"desert_town_folk_01_06_witch_doctor"	"Tembelliğin bir tedavisi var mı?"
"[english]desert_town_folk_01_06_witch_doctor"	"Is there a cure for laziness?"
"desert_town_folk_01_06_windrunner"	"Bazı insanlar sadece istediklerini elde edemez."
"[english]desert_town_folk_01_06_windrunner"	"Some people just aren't go-getters."
"desert_town_folk_01_06_jakiro"	"Ondan bir süre uzak durmam lazım."
"[english]desert_town_folk_01_06_jakiro"	"I need to get away from him for awhile."
"desert_town_folk_02_02"	"Anne inatçdır. Kalabor'da doğma büyüme olunca..."
"[english]desert_town_folk_02_02"	"Ma's stubborn. Born and raised in Kalabor."
"desert_town_folk_02_03"	"Burada kalıyor."
"[english]desert_town_folk_02_03"	"She ain't leaving."
"desert_town_folk_02_04"	"Kahretsin, ben de burada doğup büyüdüm."
"[english]desert_town_folk_02_04"	"Heck, I was born and raised here, too."
"desert_town_folk_02_05"	"Hâlâ burada olmamın tek sebebi o!"
"[english]desert_town_folk_02_05"	"Only reason I'm still here is her!"
"desert_town_folk_02_06_abaddon"	"Fakat sen ailen olmadan nesin ki?"
"[english]desert_town_folk_02_06_abaddon"	"But what are you without family?"
"desert_town_folk_02_06_jakiro"	"Keşke kardeşim hâlâ buralarda olsaydı..."
"[english]desert_town_folk_02_06_jakiro"	"Wish my brother were still around..."
"desert_town_folk_03_05"	"Keyfine bak."
"[english]desert_town_folk_03_05"	"Help yourself."
"desert_town_folk_04_04"	"Bu kum okyanusunda artık benim gibi eski çiftçilere ihtiyaç yok."
"[english]desert_town_folk_04_04"	"No use for old farmers like me now in this ocean of sand."
"desert_town_folk_04_06_drow_ranger"	"İşler bayağı çirkinleşecek..."
"[english]desert_town_folk_04_06_drow_ranger"	"Things are gonna get real ugly..."
"desert_town_folk_05_02"	"İnsanlar deliymişim gibi davranıyor."
"[english]desert_town_folk_05_02"	"People act like I'm crazy."
"desert_town_folk_06_03"	"Çok fazla şey feda ettik!"
"[english]desert_town_folk_06_03"	"We've sacrificed plenty!"
"desert_town_folk_06_07_legion_commander"	"İhtimaller bize karşı."
"[english]desert_town_folk_06_07_legion_commander"	"The odds are against us."
"desert_town_folk_07_05"	"Sanırım şu an iyiyim."
"[english]desert_town_folk_07_05"	"I think I'm good now."
"desert_town_folk_07_06_dazzle"	"Birazcık daha zamana ihtiyacım var..."
"[english]desert_town_folk_07_06_dazzle"	"Just need a little more time..."
"desert_town_folk_07_06_drow_ranger"	"Yalnız olmayı seviyorum."
"[english]desert_town_folk_07_06_drow_ranger"	"I like to be alone."
"desert_town_folk_07_06_jakiro"	"Uçup gidebilmeyi isterdim..."
"[english]desert_town_folk_07_06_jakiro"	"Wish I could fly away..."
"desert_town_folk_07_01_templar_assassin"	"Oh! Ah... Merhaba."
"[english]desert_town_folk_07_01_templar_assassin"	"Oh! Uh... Hi."
"desert_town_folk_07_05_templar_assassin"	"Zamanımın çoğunu okuyarak geçirdim..."
"[english]desert_town_folk_07_05_templar_assassin"	"Spend most my time reading..."
"Dialog_RadiantSoldier_Rescued"	"Lütfen! Kaptanı bulun!"
"[english]Dialog_RadiantSoldier_Rescued"	"Please! Find the Captain!"
"dia_rescued creepsoldier_02"	"Bol şans. Ben kaçtım!"
"[english]dia_rescued creepsoldier_02"	"Good luck. I'm out of here!"
"dia_rescued creepsoldier_03"	"Orb of Passage? Kaptanda bir tane olabilir."
"[english]dia_rescued creepsoldier_03"	"Orb of Passage? Captain might have one."
"dia_rescued creepsoldier_04"	"Memlekete geri dönüp babamın çiftliğini devralma vakti."
"[english]dia_rescued creepsoldier_04"	"Time to move back home and take over dad's farm."
"dia_rescued creepsoldier_05"	"Burası Kalabor'dan bile kötü olabilir."
"[english]dia_rescued creepsoldier_05"	"This place is almost worse than Kalabor."
"dia_rescued creepsoldier_06"	"Güneş yanığı ve centaurları sırılsıklam bir kafes ve aç canavarlara tercih ettim."
"[english]dia_rescued creepsoldier_06"	"I traded sunburn and centaurs for a soggy cage and hungry ogres."
"dia_rescued creepsoldier_07"	"Birinin geleceğini biliyordum!"
"[english]dia_rescued creepsoldier_07"	"I knew someone would come!"
"dia_rescued creepsoldier_08"	"Yaralarım bir iyileşsin, o canavarların göreceği var!"
"[english]dia_rescued creepsoldier_08"	"Once I'm patched up, these ogres are done for!"
"dia_rescued creepsoldier_09"	"Bir çorba kazanında öleceğimi düşünmüştüm!"
"[english]dia_rescued creepsoldier_09"	"Thought I was gonna die in a stew pot!"
"dia_rescued creepsoldier_10"	"Kamp güvenli mi? Kurtların toplandığını görmüştüm..."
"[english]dia_rescued creepsoldier_10"	"Is the camp safe? I saw the hounds gathering..."
"npc_dota_journal_note_01"	"Gün 6 : Girdi 1"
"[english]npc_dota_journal_note_01"	"Day 6 : Entry 1"
"npc_dota_journal_note_02"	"Gün 14 : Girdi 2"
"[english]npc_dota_journal_note_02"	"Day 14 : Entry 2"
"npc_dota_journal_note_03"	"Gün 22 : Girdi 3"
"[english]npc_dota_journal_note_03"	"Day 22 : Entry 3"
"npc_dota_journal_note_04"	"Gün 29 : Girdi 4"
"[english]npc_dota_journal_note_04"	"Day 29 : Entry 4"
"npc_dota_journal_note_05"	"Gün 31 : Girdi 5"
"[english]npc_dota_journal_note_05"	"Day 31 : Entry 5"
"npc_dota_journal_note_06"	"Gün 32 : Girdi 6"
"[english]npc_dota_journal_note_06"	"Day 32 : Entry 6"
"npc_dota_journal_note_07"	"Gün 35 : Girdi 7"
"[english]npc_dota_journal_note_07"	"Day 35 : Entry 7"
"npc_dota_journal_note_08"	"Gün 41 : Girdi 8"
"[english]npc_dota_journal_note_08"	"Day 41 : Entry 8"
"npc_dota_journal_note_09"	"Gün 46 : Girdi 9"
"[english]npc_dota_journal_note_09"	"Day 46 : Entry 9"
"npc_dota_journal_note_10"	"Gün 57 : Girdi 10"
"[english]npc_dota_journal_note_10"	"Day 57 : Entry 10"
"npc_dota_journal_note_11"	"Gün 66 : Girdi 11"
"[english]npc_dota_journal_note_11"	"Day 66 : Entry 11"
"chef_journal_01"	"Beyaz Orkideler tekrar bir araya toplanana kadar geçen süre çok kısa. Eğer bu saygıdeğer aşçı düzenine katılmak istersem onların tabağına yaraşır bir şeyler bulmam gerekli."
"[english]chef_journal_01"	"Time is running short before the White Orchids gather again.  If I wish to join this august order of culinary adventurers, I need to find something worthy of their palate."
"chef_journal_02"	"Geçen sene wyvern filetolarımın rozetimi kazandıracak kadar iyi olduklarını düşünürdüm ancak her sene sadece bir yeni üyenin kabul edildiği yerde kendi rekabetimi küçümsemişim... En vahşi rüyalarımda bile birisinin bir Roshan peynir tekerleği getireceğini hayal edemezdim."
"[english]chef_journal_02"	"Last year I thought my wyvern filets would have been enough to earn my pin, but only one new member is admitted each year and I underestimated my competition... never in my wildest dreams did I expect someone to prepare a wheel of Roshan cheese."
"chef_journal_03"	"Ancak bu sene gizli bir silahım var... Maskeler Adasından bir çanta çeşni. Eğer bu kayıp çeşniler ile beraber pişireceğim yemeği doğru seçersem üyeliğim kesin demektir."
"[english]chef_journal_03"	"This year though, I have a secret weapon... a trunk of seasoning from The Isle of Masks.  If I find the right dish to pair these lost spices with, my membership is all but assured."
"chef_journal_04"	"Uluyan Kırlar gezintim şu ana kadar büyük bir başarısızlıktan ibaret. Bonemeal Canavarları ile Lucius Longclaw arasındaki anlaşmazlık, kendisinden kurtulan bütün vahşi yaşamı hellbearlara yem etmiş... ancak belki de bunlar bile işe yarayabilmesi için yeterlidir..."
"[english]chef_journal_04"	"My expedition to the Howling Weald has so far been a failure.  The conflict between the Bonemeal Ogres and Lucius Longclaw scared away most of the wildlife save for the hellbears... but perhaps that is enough to work with."
"chef_journal_05"	"Görünen o ki bu korkunç kurtlar lezzetli bir yemekte kullanılmak için oldukça cesurlar. Ancak dikenleri hangi proteinleri sunacağı fark etmeksizin bir şiş olarak kullanılmak için kusursuzlar."
"[english]chef_journal_05"	"It seems dire wolves are too gamey to be used for elevated cuisine, but the quills are perfect to be fashioned into skewers for whatever protein will be featured."
"chef_journal_06"	"Silkmire örümcek yumurtaları memnun edici bir derecede ekşidir. Ancak, yedikten sonra kustuğum miktarı göz önüne alınca sanırım bunlardan tatlı yapma hayallerimden vazgeçmem gerekiyor."
"[english]chef_journal_06"	"Silkmire spider eggs are pleasingly tart.  However, based on the amount of vomiting I did after eating some, I think it’s best that I abandon dreams of using these to make a dessert."
"chef_journal_07"	"Silmire'ı arkamda bırakmışken uzun süredir unutulmuş bir tapınağa doğru gidiyorum. Belki de ölü kralın mezarında bulunan nadir bir mantar keşfedilmeyi bekliyordur. Ya da eski bir ok tuzağının zehri, suda kaynatılarak bir çorbada kullanılabilir."
"[english]chef_journal_07"	"With Silkmire behind me I turn to a temple long since forgotten.  Perhaps a rare truffle waits to be found in a dead king's tomb, or maybe the poison from an old dart trap could be diluted and used in broth."
"chef_journal_08"	"Tapınak umduğum kadar verimli değildi. Taş yarasalar, her ne kadar ucuz bir tokmak olarak kullanılabilse de pek yenilebilecek türden sayılmazlar."
"[english]chef_journal_08"	"The temple did not prove as fertile as I had hoped.  Stone bats, while a viable option for a kitschy pestle, are not particularly edible."
"chef_journal_09"	"Üç gündür bir thunderhide alpha arıyorum ancak bütün çabalarım boşa imiş. Bir Marrowfell av partisinin gözü o büyük canavarda imiş... Ve sinirli centaurlar ile yasak avlanma konusunda ağız dalaşına girilmeyeceğini biliyorum."
"[english]chef_journal_09"	"For three days I tracked a thunderhide alpha, but it was all for naught - a Marrowfell hunting party all had eyes on the great beast... and I know better than to quibble over poaching rights with a pack of angry centaurs."
"chef_journal_10"	"Yeniden başarısızlık ile yüzleştim. Yarışmaya kalan zaman azalırken yeni bir çözüm için arayışlardaydım: Şarabı çıkartmanın vakti geldi."
"[english]chef_journal_10"	"Again I have been met with failure.  With time running short before the competition, I must dig deep and find a new solution:  Time to break out the wine."
"chef_journal_11"	"Kalabor kalan zamanımın da israfıydı. Eğer bir toprak meyve vermiyorsa denizlere yönelmeliyim. Eğer Karanlık Resif'i çevreleyen kara sularda bile kıymetli bir protein bulamazsam, kendimi bir gastromancer olarak sayabilir miyim?"
"[english]chef_journal_11"	"Kalabor is a waste of what little time remains. If land is bearing no fruit, I must turn to the seas.  If I can't find a worthy protein in the black waters surrounding Dark Reef, can I even call myself a gastromancer?"
"npc_dota_creature_hellbear"	"Berzerker Hellbear"
"[english]npc_dota_creature_hellbear"	"Berzerker Hellbear"
"npc_dota_creature_dire_hound"	"Dire Hound"
"[english]npc_dota_creature_dire_hound"	"Dire Hound"
"npc_dota_creature_ghost"	"Banshee"
"[english]npc_dota_creature_ghost"	"Banshee"
"npc_dota_creature_small_ghost"	"Crone"
"[english]npc_dota_creature_small_ghost"	"Crone"
"npc_dota_creature_ogre_magi"	"Bonemeal Ogre"
"[english]npc_dota_creature_ogre_magi"	"Bonemeal Ogre"
"npc_dota_creature_ogre_tank"	"Bonemeal Tank"
"[english]npc_dota_creature_ogre_tank"	"Bonemeal Tank"
"npc_dota_creature_ogre_seer"	"Bonemeal Seer"
"[english]npc_dota_creature_ogre_seer"	"Bonemeal Seer"
"npc_dota_creature_ogre_tank_boss"	"Bogdugg"
"[english]npc_dota_creature_ogre_tank_boss"	"Bogdugg"
"npc_dota_creature_friendly_ogre_tank"	"Burp"
"[english]npc_dota_creature_friendly_ogre_tank"	"Burp"
"npc_dota_creature_lycan_boss"	"Lucius Longclaw"
"[english]npc_dota_creature_lycan_boss"	"Lucius Longclaw"
"npc_dota_dungeon_start_building"	"Brine Karakolu"
"[english]npc_dota_dungeon_start_building"	"Brine Post"
"npc_dota_rescue_cage"	"Tetanoz Kafesi"
"[english]npc_dota_rescue_cage"	"Tetanus Cage"
"npc_dota_forest_camp_chief"	"Komutan Targan"
"[english]npc_dota_forest_camp_chief"	"Commander Targan"
"npc_dota_radiant_captain"	"Kaptan Lightfoot"
"[english]npc_dota_radiant_captain"	"Captain Lightfoot"
"npc_dota_radiant_soldier"	"Piyade"
"[english]npc_dota_radiant_soldier"	"Footman"
"npc_dota_holdout_tower"	"Kule"
"[english]npc_dota_holdout_tower"	"Watchtower"
"npc_treasure_chest"	"Hazine Sandığı"
"[english]npc_treasure_chest"	"Treasure Chest"
"npc_dota_creature_techies_land_mine"	"Land Mine"
"[english]npc_dota_creature_techies_land_mine"	"Land Mine"
"trap_sun_strike"	"Sun Strike"
"[english]trap_sun_strike"	"Sun Strike"
"npc_dota_creature_spider_small"	"Silkmire Swarmer"
"[english]npc_dota_creature_spider_small"	"Silkmire Swarmer"
"npc_dota_creature_spider_medium"	"Silkmire Spitter"
"[english]npc_dota_creature_spider_medium"	"Silkmire Spitter"
"npc_dota_creature_kidnap_spider"	"Silkmire Marauder"
"[english]npc_dota_creature_kidnap_spider"	"Silkmire Marauder"
"npc_dota_spider_sack"	"Parlayan Yumurta Kesesi"
"[english]npc_dota_spider_sack"	"Pulsing Egg Sack"
"npc_dota_spider_web"	"Silkmire Çeliği"
"[english]npc_dota_spider_web"	"Silkmire Steel"
"npc_dota_creature_spider_boss"	"Ankaboot"
"[english]npc_dota_creature_spider_boss"	"Ankaboot"
"npc_dota_creature_small_lycosidae"	"Ankaboot'un Kesesi"
"[english]npc_dota_creature_small_lycosidae"	"Ankaboot's Brood"
"npc_dota_creature_bandit_captain"	"Sabaku Kaptanı"
"[english]npc_dota_creature_bandit_captain"	"Sabaku Captain"
"npc_dota_creature_bandit"	"Sabaku Hırsızı"
"[english]npc_dota_creature_bandit"	"Sabaku Thief"
"npc_dota_creature_bandit_archer"	"Sabaku Okçusu"
"[english]npc_dota_creature_bandit_archer"	"Sabaku Archer"
"npc_dota_creature_centaur_warlord"	"Centaur Savaş Lordu"
"[english]npc_dota_creature_centaur_warlord"	"Centaur Warlord"
"npc_dota_creature_centaur_scout"	"Centaur Scout"
"[english]npc_dota_creature_centaur_scout"	"Centaur Scout"
"npc_dota_creature_centaur_shaman"	"Centaur Shaman"
"[english]npc_dota_creature_centaur_shaman"	"Centaur Shaman"
"npc_dota_creature_bat"	"Darkwing Golem"
"[english]npc_dota_creature_bat"	"Darkwing Golem"
"npc_dota_creature_temple_guardian"	"Tapınak Muhafızı"
"[english]npc_dota_creature_temple_guardian"	"Temple Guardian"
"npc_dota_friendly_bristleback"	"Jungtrall"
"[english]npc_dota_friendly_bristleback"	"Jungtrall"
"npc_dota_friendly_bristleback_son"	"Brigwyr"
"[english]npc_dota_friendly_bristleback_son"	"Brigwyr"
"npc_dota_bristleback_grandpa"	"Sathington"
"[english]npc_dota_bristleback_grandpa"	"Sathington"
"npc_dota_creature_sand_king"	"Rhyzik"
"[english]npc_dota_creature_sand_king"	"Rhyzik"
"npc_dota_creature_catapult"	"Linebreaker Catapult"
"[english]npc_dota_creature_catapult"	"Linebreaker Catapult"
"npc_dota_assault_melee_rax"	"Piyade Barakaları"
"[english]npc_dota_assault_melee_rax"	"Footman Barracks"
"npc_dota_assault_ranged_rax"	"Büyücü Barakaları"
"[english]npc_dota_assault_ranged_rax"	"Mage Barracks"
"npc_dota_assault_bad_melee_creep"	"Buzzick Piyadesi"
"[english]npc_dota_assault_bad_melee_creep"	"Buzzick Footman"
"npc_dota_assault_bad_ranged_creep"	"Buzzick Büyücüsü"
"[english]npc_dota_assault_bad_ranged_creep"	"Buzzick Mage"
"npc_dota_dire_assault_captain"	"Buzzick Kaptanı"
"[english]npc_dota_dire_assault_captain"	"Buzzick Captain"
"npc_dota_assault_good_melee_creep"	"Kalabor Piyadesi"
"[english]npc_dota_assault_good_melee_creep"	"Kalabor Footman"
"npc_dota_assault_good_ranged_creep"	"Kalabor Büyücüsü"
"[english]npc_dota_assault_good_ranged_creep"	"Kalabor Mage"
"npc_dota_creature_living_treasure"	"Yalnız Scarab"
"[english]npc_dota_creature_living_treasure"	"Lonely Scarab"
"npc_dota_desert_townfolk_1"	"Wellum Potes"
"[english]npc_dota_desert_townfolk_1"	"Wellum Potes"
"npc_dota_desert_townfolk_2"	"Marica Basil"
"[english]npc_dota_desert_townfolk_2"	"Marica Basil"
"npc_dota_desert_townfolk_3"	"Pip Bon Aire"
"[english]npc_dota_desert_townfolk_3"	"Pip Bon Aire"
"npc_dota_desert_townfolk_4"	"Hathe Moonie"
"[english]npc_dota_desert_townfolk_4"	"Hathe Moonie"
"npc_dota_desert_townfolk_5"	"Ed Moor"
"[english]npc_dota_desert_townfolk_5"	"Ed Moor"
"npc_dota_desert_townfolk_6"	"Kane Istan"
"[english]npc_dota_desert_townfolk_6"	"Kane Istan"
"npc_dota_desert_townfolk_7"	"Donce Cesa"
"[english]npc_dota_desert_townfolk_7"	"Donce Cesa"
"npc_dota_injured_contact"	"Theod"
"[english]npc_dota_injured_contact"	"Theod"
"npc_dota_creature_invoker"	"The Dark Magus"
"[english]npc_dota_creature_invoker"	"The Dark Magus"
"npc_dota_temple_wisp"	"Aibi"
"[english]npc_dota_temple_wisp"	"Aibi"
"npc_dota_fire_trap_ward_unified"	"Arcane Ateş Tuzağı"
"[english]npc_dota_fire_trap_ward_unified"	"Arcane Fire Trap"
"npc_dota_fire_trap_ward"	"Arcane Ateş Tuzağı"
"[english]npc_dota_fire_trap_ward"	"Arcane Fire Trap"
"npc_dota_stone_trap_ward"	"Ok Tuzağı"
"[english]npc_dota_stone_trap_ward"	"Arrow Trap"
"npc_dota_poisoncloud_trap_ward"	"Zehir Tuzağı"
"[english]npc_dota_poisoncloud_trap_ward"	"Poison Trap"
"npc_dota_forest_holdout_gate"	"Kapı"
"[english]npc_dota_forest_holdout_gate"	"Gate"
"npc_dota_dungeon_checkpoint"	"Kontrol Noktası"
"[english]npc_dota_dungeon_checkpoint"	"Checkpoint"
"npc_dota_forest_camp_small_tent"	"Çadır"
"[english]npc_dota_forest_camp_small_tent"	"Tent"
"npc_dota_forest_camp_medium_tent"	"Çadır"
"[english]npc_dota_forest_camp_medium_tent"	"Tent"
"npc_dota_forest_camp_fade_top_tent"	"Çadır"
"[english]npc_dota_forest_camp_fade_top_tent"	"Tent"
"npc_dota_forest_holdout_fence"	"Çit"
"[english]npc_dota_forest_holdout_fence"	"Stockade"
"npc_dota_forest_assault_fence"	"Çit"
"[english]npc_dota_forest_assault_fence"	"Stockade"
"npc_dota_forest_camp_melee_creep_1"	"Piyade"
"[english]npc_dota_forest_camp_melee_creep_1"	"Footman"
"npc_dota_forest_camp_melee_creep_2"	"Piyade"
"[english]npc_dota_forest_camp_melee_creep_2"	"Footman"
"npc_dota_forest_camp_melee_creep_3"	"Piyade"
"[english]npc_dota_forest_camp_melee_creep_3"	"Footman"
"npc_dota_forest_camp_melee_creep_4"	"Piyade"
"[english]npc_dota_forest_camp_melee_creep_4"	"Footman"
"npc_dota_forest_camp_melee_creep_5"	"Piyade"
"[english]npc_dota_forest_camp_melee_creep_5"	"Footman"
"DOTA_Tooltip_ability_holdout_shackleshot"	"Shackleshot"
"[english]DOTA_Tooltip_ability_holdout_shackleshot"	"Shackleshot"
"DOTA_Tooltip_ability_holdout_shackleshot_Description"	"Hedefi düşman birimlerine veya direkt olarak arkasındaki bir çizgi üzerinde bulunan bir ağaca bağlar. Eğer başka bir birim veya ağaç yoksa, sersemletme süresi 0.75'e düşürülür. <font color='#70EA72'>Eğer ikinci bir birime bağlama yapılırsa, bağlama o birim üzerinden sıçrayacak ve maksimum sayıya ulaşana veya hiçbir birim ya da ağaç bulunmayana kadar devam edecektir.</font>"
"[english]DOTA_Tooltip_ability_holdout_shackleshot_Description"	"Shackles the target to enemy units or a tree in a line directly behind it.  If no unit or tree is present, the stun duration is reduced to 0.75.  <font color='#70EA72'>If a shackle is made to a second unit, the shackle will bounce and continue behind that unit, until the max count is reached or no unit or tree is found.</font>"
"DOTA_Tooltip_ability_holdout_shackleshot_Lore"	"Windranger'ın çeşitli yay yetenekleri arasında kaçmaya çalışan rakipleri yavaşlatmak için kalın iplere bağlı bir ok da bulunmaktadır."
"[english]DOTA_Tooltip_ability_holdout_shackleshot_Lore"	"Windranger's variety of bow skills includes an arrow with thick ropes attached to encumber any escaping target."
"DOTA_Tooltip_ability_holdout_shackleshot_shackle_count"	"<font color='#70EA72'>SHACKLE SAYISI:</font>"
"[english]DOTA_Tooltip_ability_holdout_shackleshot_shackle_count"	"<font color='#70EA72'>SHACKLE COUNT:</font>"
"DOTA_Tooltip_ability_holdout_shackleshot_Note0"	"Bu büyü iki düşmanı birlikte zincirleyebilir, onların ikisini de sersemletir."
"[english]DOTA_Tooltip_ability_holdout_shackleshot_Note0"	"This spell can shackle two enemies together, stunning them both."
"DOTA_Tooltip_ability_holdout_shackleshot_Note1"	"Hedefi diğer bir düşmanla veya en fazla 525/500 uzaklığındaki arkasında ki bir ağaçla, kelepçeleyebilir."
"[english]DOTA_Tooltip_ability_holdout_shackleshot_Note1"	"Can shackle the target to an enemy unit or tree at most 525/500 behind it."
"DOTA_Tooltip_ability_holdout_shackleshot_Note2"	"Shackleshot'tan kaçınılamaz."
"[english]DOTA_Tooltip_ability_holdout_shackleshot_Note2"	"Shackleshot cannot be disjointed."
"DOTA_Tooltip_ability_holdout_shackleshot_stun_duration"	"<font color='#70EA72'>KİLİTLEME SÜRESİ:</font>"
"[english]DOTA_Tooltip_ability_holdout_shackleshot_stun_duration"	"<font color='#70EA72'>SHACKLE DURATION:</font>"
"DOTA_Tooltip_ability_holdout_windrun"	"Windrun"
"[english]DOTA_Tooltip_ability_holdout_windrun"	"Windrun"
"DOTA_Tooltip_ability_holdout_windrun_Description"	"Hareket hızını arttırır, tüm fiziksel saldırılardan kaçınmayı sağlar ve yakındaki rakiplerin hareket hızını düşürür."
"[english]DOTA_Tooltip_ability_holdout_windrun_Description"	"Increases movement speed and adds evasion from all physical attacks, while slowing movement of nearby enemies."
"DOTA_Tooltip_ability_holdout_windrun_Lore"	"Lyralei sahip olduğu adını doğru çıkarırcasına, gelen saldırıları savuşturmak için ani rüzgârları büyüler."
"[english]DOTA_Tooltip_ability_holdout_windrun_Lore"	"True to her namesake, Lyralei enchants gusts of winds to flight incoming attacks."
"DOTA_Tooltip_ability_holdout_windrun_Note0"	"Yavaşlatma düşmanları büyü bağışıklığı ile etkileyecektir."
"[english]DOTA_Tooltip_ability_holdout_windrun_Note0"	"The slow will affect enemies with magic immunity."
"DOTA_Tooltip_ability_holdout_windrun_Note1"	"Windrun, etkinleştirilmesinden önce atılan şeylerden kaçmanızı sağlamaz."
"[english]DOTA_Tooltip_ability_holdout_windrun_Note1"	"Windrun will not evade projectiles that were created before it was activated."
"DOTA_Tooltip_ability_holdout_windrun_enemy_movespeed_bonus_pct"	"%<font color='#70EA72'>DÜŞMAN YAVAŞLATMA:</font>"
"[english]DOTA_Tooltip_ability_holdout_windrun_enemy_movespeed_bonus_pct"	"%<font color='#70EA72'>ENEMY SLOW:</font>"
"DOTA_Tooltip_ability_holdout_windrun_movespeed_bonus_pct"	"%FAZLADAN HAREKET HIZI:"
"[english]DOTA_Tooltip_ability_holdout_windrun_movespeed_bonus_pct"	"%MOVE SPEED BONUS:"
"DOTA_Tooltip_ability_holdout_windrun_duration"	"<font color='#70EA72'>SÜRE:</font>"
"[english]DOTA_Tooltip_ability_holdout_windrun_duration"	"<font color='#70EA72'>DURATION:</font>"
"DOTA_Tooltip_ability_holdout_windrun_radius"	"<font color='#70EA72'>YARIÇAPI:</font>"
"[english]DOTA_Tooltip_ability_holdout_windrun_radius"	"<font color='#70EA72'>RADIUS:</font>"
"DOTA_Tooltip_ability_holdout_focusfire"	"Zephyr"
"[english]DOTA_Tooltip_ability_holdout_focusfire"	"Zephyr"
"DOTA_Tooltip_ability_holdout_focusfire_Description"	"Windranger, Eşsiz Saldırı Eklentileri ve öğe efektleri de dahil olmak üzere hasarını azaltmasına rağmen maksimum saldırı hızı kazanarak rüzgarı yönlendirir. <font color='#70EA72'>Windranger her saldırısında, saldırılan birimin çevresindeki bir hedefe fazladan bir ok atma şansına sahiptir. 20 saniye sürer.</font>"
"[english]DOTA_Tooltip_ability_holdout_focusfire_Description"	"Windranger channels the wind, gaining maximum attack speed, although with reduced damage, including damage from Unique Attack Modifiers and item effects. <font color='#70EA72'>With each attack, Windranger has a chance to fire an additional arrow at a target within a radius of the attacked unit. Lasts 20 seconds.</font>"
"DOTA_Tooltip_ability_holdout_focusfire_Lore"	"Lyralei'in düşmanlarını oklara boğması yeteneği emsalsizdir - bedeli isabetli atış olsa bile."
"[english]DOTA_Tooltip_ability_holdout_focusfire_Lore"	"Lyralei's ability to bombard opponents with a flurry of arrows is unparalleled - even at the expense of accuracy."
"DOTA_Tooltip_ability_holdout_focusfire_Note0"	"Binaları ve büyüye bağışıklığı olan birimleri hedef alabilir."
"[english]DOTA_Tooltip_ability_holdout_focusfire_Note0"	"Can target buildings and magic immune units."
"DOTA_Tooltip_ability_holdout_focusfire_focusfire_damage_reduction"	"%HASAR AZALTMA:"
"[english]DOTA_Tooltip_ability_holdout_focusfire_focusfire_damage_reduction"	"%DAMAGE REDUCTION:"
"DOTA_Tooltip_ability_holdout_focusfire_bonus_arrow_chance"	"%<font color='#70EA72'>BONUS OK ŞANSI:</font>"
"[english]DOTA_Tooltip_ability_holdout_focusfire_bonus_arrow_chance"	"%<font color='#70EA72'>BONUS ARROW CHANCE:</font>"
"DOTA_Tooltip_ability_holdout_focusfire_bonus_arrow_radius"	"<font color='#70EA72'>BONUS OK YARIÇAPI:</font>"
"[english]DOTA_Tooltip_ability_holdout_focusfire_bonus_arrow_radius"	"<font color='#70EA72'>BONUS ARROW RADIUS:</font>"
"DOTA_Tooltip_ability_holdout_focusfire_bonus_arrows"	"<font color='#70EA72'>BONUS OKLAR:</font>"
"[english]DOTA_Tooltip_ability_holdout_focusfire_bonus_arrows"	"<font color='#70EA72'>BONUS ARROWS:</font>"
"DOTA_Tooltip_ability_holdout_glacier_arrows"	"Frost Arrows"
"[english]DOTA_Tooltip_ability_holdout_glacier_arrows"	"Frost Arrows"
"DOTA_Tooltip_ability_holdout_glacier_arrows_Description"	"Drow'un saldırılarına dondurma efekti ekleyerek düşmanların hareket hızını yavaşlatır. <font color='#70EA72'>İlk saldırıda, birimler geriye savrulur.</font>\n\nFrost Arrows, bir Eşsiz Saldırı Eklentisidir ve diğer Eşsiz Saldırı Eklentileri ile istiflenemez."
"[english]DOTA_Tooltip_ability_holdout_glacier_arrows_Description"	"Adds a freezing effect to Drow's attacks, slowing enemy movement.\n\nFrost Arrows is a Unique Attack Modifier, and does not stack with other Unique Attack Modifiers."
"DOTA_Tooltip_ability_holdout_glacier_arrows_Lore"	"Buz kaplamalı oklar sessizliği deler, vurduğu kurbanını içten içe dondurur."
"[english]DOTA_Tooltip_ability_holdout_glacier_arrows_Lore"	"Ice-encased arrows pierce the silence, chilling their victims to the core."
"DOTA_Tooltip_ability_holdout_glacier_arrows_Note0"	"Art arda kullanıldığında yavaşlatma süresi yenilenir."
"[english]DOTA_Tooltip_ability_holdout_glacier_arrows_Note0"	"The slow duration is refreshed on successive casts."
"DOTA_Tooltip_ability_holdout_glacier_arrows_frost_arrows_movement_speed"	"%HAREKET HIZI:"
"[english]DOTA_Tooltip_ability_holdout_glacier_arrows_frost_arrows_movement_speed"	"%MOVE SPEED:"
"DOTA_Tooltip_ability_holdout_glacier_arrows_slow_duration"	"YAVAŞLATMA SÜRESİ:"
"[english]DOTA_Tooltip_ability_holdout_glacier_arrows_slow_duration"	"SLOW DURATION:"
"DOTA_Tooltip_ability_holdout_multishot"	"Quelling Shot"
"[english]DOTA_Tooltip_ability_holdout_multishot"	"Quelling Shot"
"DOTA_Tooltip_ability_holdout_multishot_Description"	"<font color='#70EA72'>Drow'un oku daha az hasar vermek fakat birçok hedefe bölünmek üzere bir koni şeklinde ayrılır. Her bir ok, bir hedefe sadece tek sefer vurabilir. Frost Arrows aktifleştirildiyse, Quelling Shot okları ok başına mana bedeli yükseltilerek Frost Arrow'a dönüştürülür.</font>\n\nQuelling Shot bir Eşsiz Saldırı Eklentisidir ve diğer Eşsiz Saldırı Eklentileri ile birlikte çalışmaz."
"[english]DOTA_Tooltip_ability_holdout_multishot_Description"	"<font color='#70EA72'>Drow's arrow splits in front of her in a cone shape, dealing less damage but cleaving multiple targets.  If Frost Arrows is activated, Quelling Shot's arrows will be converted to Frost Arrows, increasing the mana cost per arrow.</font>\n\nQuelling Shot is a Unique Attack Modifier, and does not stack with other Unique Attack Modifiers."
"DOTA_Tooltip_ability_holdout_multishot_arrow_range"	"MENZİL:"
"[english]DOTA_Tooltip_ability_holdout_multishot_arrow_range"	"RANGE:"
"DOTA_Tooltip_ability_holdout_multishot_arrow_count"	"OK SAYISI:"
"[english]DOTA_Tooltip_ability_holdout_multishot_arrow_count"	"ARROW COUNT:"
"DOTA_Tooltip_ability_holdout_multishot_damage_reduction_pct"	"%HASAR AZALTMA:"
"[english]DOTA_Tooltip_ability_holdout_multishot_damage_reduction_pct"	"%DAMAGE REDUCTION:"
"DOTA_Tooltip_ability_holdout_marksmanship"	"Marksmanship"
"[english]DOTA_Tooltip_ability_holdout_marksmanship"	"Marksmanship"
"DOTA_Tooltip_ability_holdout_marksmanship_Description"	"Drow'un savaş deneyimleri, bir çarpışma sırasında isabetliliğini ve etkililiğini pasif bir Çeviklik bonusu ile arttırır. <font color='#70EA72'>Etki alanının yakınında düşman canlılar varsa bonus sağlamaz.</font>"
"[english]DOTA_Tooltip_ability_holdout_marksmanship_Description"	"Drow's experiences in battle improve her accuracy and effectiveness in combat, providing a passive bonus to Agility. <font color='#70EA72'>Grants no bonus if there are enemy creatures within an area of effect.</font>"
"DOTA_Tooltip_ability_holdout_marksmanship_Lore"	"Drow Ranger, kahraman okçuların en somut örneğidir."
"[english]DOTA_Tooltip_ability_holdout_marksmanship_Lore"	"The Drow Ranger is the epitome of archery prowess."
"DOTA_Tooltip_ability_holdout_marksmanship_marksmanship_agility_bonus"	"FAZLADAN ÇEVİKLİK:"
"[english]DOTA_Tooltip_ability_holdout_marksmanship_marksmanship_agility_bonus"	"BONUS AGILITY:"
"DOTA_Tooltip_ability_holdout_marksmanship_radius"	"<font color='#70EA72'>YARIÇAP:</font>"
"[english]DOTA_Tooltip_ability_holdout_marksmanship_radius"	"<font color='#70EA72'>RADIUS:</font>"
"DOTA_Tooltip_ability_holdout_storm_bolt"	"Storm Hammer"
"[english]DOTA_Tooltip_ability_holdout_storm_bolt"	"Storm Hammer"
"DOTA_Tooltip_ability_holdout_storm_bolt_Description"	"Sven düşman birimleri sersemleten ve hasar veren büyülü eldivenini salıverir."
"[english]DOTA_Tooltip_ability_holdout_storm_bolt_Description"	"Sven unleashes his magical gauntlet that deals damage and stuns enemy units."
"DOTA_Tooltip_ability_holdout_storm_bolt_Lore"	"Rogue Knight'ın babasının okulundan alınan demir eldivenleri, düşmanlarının tam kalbine saldırır."
"[english]DOTA_Tooltip_ability_holdout_storm_bolt_Lore"	"The Rogue Knight's iron gauntlet, taken from the school of his father, strikes his foes to their core."
"DOTA_Tooltip_ability_holdout_storm_bolt_Note0"	"Storm Hammer'dan sadece görünmez olarak kaçınılabilir."
"[english]DOTA_Tooltip_ability_holdout_storm_bolt_Note0"	"Storm Hammer can only be disjointed by going invisible."
"DOTA_Tooltip_ability_holdout_storm_bolt_bolt_stun_duration"	"SÜRE:"
"[english]DOTA_Tooltip_ability_holdout_storm_bolt_bolt_stun_duration"	"DURATION:"
"DOTA_Tooltip_ability_holdout_storm_bolt_bolt_aoe"	"YARIÇAP:"
"[english]DOTA_Tooltip_ability_holdout_storm_bolt_bolt_aoe"	"RADIUS:"
"DOTA_Tooltip_ability_holdout_great_cleave"	"Great Cleave"
"[english]DOTA_Tooltip_ability_holdout_great_cleave"	"Great Cleave"
"DOTA_Tooltip_ability_holdout_great_cleave_Description"	"Sven müthiş bir güçle saldırır, saldırılarıyla yakındaki düşman birimlere toplu hasar verir."
"[english]DOTA_Tooltip_ability_holdout_great_cleave_Description"	"Sven strikes with great force, cleaving all nearby enemy units with his attack."
"DOTA_Tooltip_ability_holdout_great_cleave_Lore"	"Vigil Şövalyeleri hâlâ Sven'den geri almak için Outcast Blade'i aramaktalar ki bu silah bozkırlar boyunca tüm savaşçıları kesebilecek güçtedir."
"[english]DOTA_Tooltip_ability_holdout_great_cleave_Lore"	"The Vigil Knights still seek to reclaim the stolen Outcast Blade from Sven, a weapon capable of cutting wide swaths through lesser warriors."
"DOTA_Tooltip_ability_holdout_great_cleave_Note0"	"Saçma hasarı zırh değeri tarafından değil zırh türü tarafından azaltılır."
"[english]DOTA_Tooltip_ability_holdout_great_cleave_Note0"	"Cleave damage is reduced by armor type but not by armor value."
"DOTA_Tooltip_ability_holdout_great_cleave_Note1"	"Saçma hasarı büyü bağışıklığından geçer."
"[english]DOTA_Tooltip_ability_holdout_great_cleave_Note1"	"Cleave damage goes through magic immunity."
"DOTA_Tooltip_ability_holdout_great_cleave_Note2"	"Sven'in önündeki dairesel alana yayılma hasarı verir."
"[english]DOTA_Tooltip_ability_holdout_great_cleave_Note2"	"The cleave damages a circular area in front of Sven."
"DOTA_Tooltip_ability_holdout_great_cleave_great_cleave_damage"	"%SAÇMA HASARI:"
"[english]DOTA_Tooltip_ability_holdout_great_cleave_great_cleave_damage"	"%CLEAVE DAMAGE:"
"DOTA_Tooltip_ability_holdout_great_cleave_great_cleave_radius"	"YARIÇAP:"
"[english]DOTA_Tooltip_ability_holdout_great_cleave_great_cleave_radius"	"RADIUS:"
"DOTA_Tooltip_ability_holdout_great_cleave_great_cleave_notes"	"Notlar:\n\nSaçma hasarı zırh tipiyle azaltılır ama zırh miktarıyla azaltılmaz.\n\nSaçma hasarı büyü bağışıklığından geçer.\n\nSaçma hasarı Sven'in önündeki dairesel bir alanı etkiler."
"[english]DOTA_Tooltip_ability_holdout_great_cleave_great_cleave_notes"	"Notes:\n\nCleave damage is reduced by armor type but not by armor value.\n\nCleave damage goes through magic immunity.\n\nThe cleave damages a circular area in front of Sven."
"DOTA_Tooltip_ability_dungeon_sven_great_cleave"	"Great Cleave"
"[english]DOTA_Tooltip_ability_dungeon_sven_great_cleave"	"Great Cleave"
"DOTA_Tooltip_ability_dungeon_sven_great_cleave_Description"	"Sven müthiş bir güçle saldırır, saldırılarıyla yakındaki düşman birimlere toplu hasar verir."
"[english]DOTA_Tooltip_ability_dungeon_sven_great_cleave_Description"	"Sven strikes with great force, cleaving all nearby enemy units with his attack."
"DOTA_Tooltip_ability_dungeon_sven_great_cleave_Lore"	"Vigil Şövalyeleri hâlâ Sven'den geri almak için Outcast Blade'i aramaktalar ki bu silah bozkırlar boyunca tüm savaşçıları kesebilecek güçtedir."
"[english]DOTA_Tooltip_ability_dungeon_sven_great_cleave_Lore"	"The Vigil Knights still seek to reclaim the stolen Outcast Blade from Sven, a weapon capable of cutting wide swaths through lesser warriors."
"DOTA_Tooltip_ability_dungeon_sven_great_cleave_Note0"	"Saçma hasarı zırh değeri tarafından değil zırh türü tarafından azaltılır."
"[english]DOTA_Tooltip_ability_dungeon_sven_great_cleave_Note0"	"Cleave damage is reduced by armor type but not by armor value."
"DOTA_Tooltip_ability_dungeon_sven_great_cleave_Note1"	"Cleave hasarı büyü bağışıklığını deler."
"[english]DOTA_Tooltip_ability_dungeon_sven_great_cleave_Note1"	"Cleave damage goes through spell immunity."
"DOTA_Tooltip_ability_dungeon_sven_great_cleave_Note2"	"Sven'in önündeki dairesel alana yayılma hasarı verir."
"[english]DOTA_Tooltip_ability_dungeon_sven_great_cleave_Note2"	"The cleave damages a circular area in front of Sven."
"DOTA_Tooltip_ability_dungeon_sven_great_cleave_great_cleave_damage"	"%SAÇMA HASARI:"
"[english]DOTA_Tooltip_ability_dungeon_sven_great_cleave_great_cleave_damage"	"%CLEAVE DAMAGE:"
"DOTA_Tooltip_ability_holdout_warcry"	"Warcry"
"[english]DOTA_Tooltip_ability_holdout_warcry"	"Warcry"
"DOTA_Tooltip_ability_holdout_warcry_Description"	"Sven'in Warcry'ı dostlarını savaş için cesaretlendirir, hareket hızlarını ve zırhlarını artırır."
"[english]DOTA_Tooltip_ability_holdout_warcry_Description"	"Sven's Warcry heartens his allies for battle, increasing their movement speed and armor."
"DOTA_Tooltip_ability_holdout_warcry_Lore"	"Uyanık Kalma Kodeks'inden birkaç satırı okumak Sven'in hilekârlık kurallarına olan bağlılığını güçlendirir. Ne kadar da şairane!"
"[english]DOTA_Tooltip_ability_holdout_warcry_Lore"	"Calling a few lines from the Vigil Codex fortifies Sven's obedience to his rogue code. So poetic!"
"DOTA_Tooltip_ability_holdout_warcry_Note0"	"Diğer zırh ve hız kazandıran yeteneklerle istiflenir."
"[english]DOTA_Tooltip_ability_holdout_warcry_Note0"	"Fully stacks with other armor and speed granting abilities."
"DOTA_Tooltip_ability_holdout_warcry_warcry_radius"	"YARIÇAP:"
"[english]DOTA_Tooltip_ability_holdout_warcry_warcry_radius"	"RADIUS:"
"DOTA_Tooltip_ability_holdout_warcry_warcry_armor"	"FAZLADAN ZIRH:"
"[english]DOTA_Tooltip_ability_holdout_warcry_warcry_armor"	"BONUS ARMOR:"
"DOTA_Tooltip_ability_holdout_warcry_warcry_movespeed"	"%<font color='#70EA72'>FAZLADAN HIZ:</font>"
"[english]DOTA_Tooltip_ability_holdout_warcry_warcry_movespeed"	"%<font color='#70EA72'>BONUS SPEED:</font>"
"DOTA_Tooltip_ability_holdout_warcry_warcry_duration"	"<font color='#70EA72'>SÜRE:</font>"
"[english]DOTA_Tooltip_ability_holdout_warcry_warcry_duration"	"<font color='#70EA72'>DURATION:</font>"
"DOTA_Tooltip_ability_holdout_warcry_warcry_notes"	"Not:\n\nEtki alanındayken fazladan zırh sağlayan eşyalarla istiflenir.\n\nEtki alanındayken fazladan hareket hızı kazandıran yetenek ve eşyalarla istiflenir."
"[english]DOTA_Tooltip_ability_holdout_warcry_warcry_notes"	"Notes:\n\nFully stacks with other bonus armor auras from items.\n\nFully stacks with other abilities and items that give a bonus to movement speed."
"DOTA_Tooltip_ability_holdout_gods_strength"	"God's Strength"
"[english]DOTA_Tooltip_ability_holdout_gods_strength"	"God's Strength"
"DOTA_Tooltip_ability_holdout_gods_strength_Description"	"<font color='#70EA72'>Sven bonus güç ve hasar kazanır. Bir düşman birimini God's Strength efekti altındayken öldürdüğünde Sven'in tüm yeteneklerinin bekleme süreleri azalır. Bu efekt sınırsız miktarda meydana gelebilir.</font>"
"[english]DOTA_Tooltip_ability_holdout_gods_strength_Description"	"<font color='#70EA72'>Sven gains bonus strength and damage.  Upon killing an enemy unit while under the effects of God's Strength, all of Sven's ability cooldowns are reduced.  This effect can occur an unlimited amount of times.</font>"
"DOTA_Tooltip_ability_holdout_gods_strength_Lore"	"Rogue Knight, Scared Helm'i parçalayan gücüyle, yakın dövüşte rakipsizdir."
"[english]DOTA_Tooltip_ability_holdout_gods_strength_Lore"	"With the strength that shattered the Sacred Helm, the Rogue Knight stands unopposed in melee combat."
"DOTA_Tooltip_ability_holdout_gods_strength_bonus_strength"	"FAZLADAN KUVVET:"
"[english]DOTA_Tooltip_ability_holdout_gods_strength_bonus_strength"	"BONUS STRENGTH:"
"DOTA_Tooltip_ability_holdout_gods_strength_cooldown_reduction_per_kill"	"ÖLDÜRME BAŞINA DOLUM SÜRESİ AZALTMA:"
"[english]DOTA_Tooltip_ability_holdout_gods_strength_cooldown_reduction_per_kill"	"COOLDOWN REDUCTION PER KILL:"
"DOTA_Tooltip_ability_holdout_gods_strength_gods_strength_damage"	"%FAZLADAN HASAR:"
"[english]DOTA_Tooltip_ability_holdout_gods_strength_gods_strength_damage"	"%BONUS DAMAGE:"
"DOTA_Tooltip_ability_holdout_gladiators_unite"	"Gladyatörler, Toplanın!"
"[english]DOTA_Tooltip_ability_holdout_gladiators_unite"	"Gladiators, Unite!"
"DOTA_Tooltip_ability_holdout_gladiators_unite_Description"	"<font color='#70EA72'>Legion Commander dost kahramanlarını beraber bir arenada savaşmaya çağırır. Arenada savaşa katılan her fazladan dost kahraman her savaşçıya fazladan hasar, zırh ve can çalma sağlar.</font>"
"[english]DOTA_Tooltip_ability_holdout_gladiators_unite_Description"	"<font color='#70EA72'>Legion Commander calls her allied heroes together to fight in an arena.  Each additional friendly hero that joins the fight in the arena grants additional bonus damage, armor, and lifesteal to each arena combatant.</font>"
"DOTA_Tooltip_ability_holdout_gladiators_unite_bonus_armor_per_hero"	"KAHRAMAN BAŞINA FAZLADAN ZIRH:"
"[english]DOTA_Tooltip_ability_holdout_gladiators_unite_bonus_armor_per_hero"	"BONUS ARMOR PER HERO:"
"DOTA_Tooltip_ability_holdout_gladiators_unite_bonus_damage_per_hero"	"KAHRAMAN BAŞINA FAZLADAN HASAR:"
"[english]DOTA_Tooltip_ability_holdout_gladiators_unite_bonus_damage_per_hero"	"BONUS DAMAGE PER HERO:"
"DOTA_Tooltip_ability_holdout_gladiators_unite_lifesteal_per_hero"	"%KAHRAMAN BAŞINA CAN ÇALMA:"
"[english]DOTA_Tooltip_ability_holdout_gladiators_unite_lifesteal_per_hero"	"%LIFESTEAL PER HERO:"
"DOTA_Tooltip_ability_holdout_gladiators_unite_duration"	"SÜRE:"
"[english]DOTA_Tooltip_ability_holdout_gladiators_unite_duration"	"DURATION:"
"DOTA_Tooltip_ability_holdout_gladiators_unite_radius"	"YARIÇAP:"
"[english]DOTA_Tooltip_ability_holdout_gladiators_unite_radius"	"RADIUS:"
"DOTA_Tooltip_modifier_holdout_gladiators_unite"	"Gladyatörler, Toplanın!"
"[english]DOTA_Tooltip_modifier_holdout_gladiators_unite"	"Gladiators, Unite!"
"DOTA_Tooltip_modifier_holdout_gladiators_unite_Description"	"Fazladan %dMODIFIER_PROPERTY_PHYSICAL_ARMOR_BONUS% zırh, %dMODIFIER_PROPERTY_PREATTACK_BONUS_DAMAGE% hasar, ve fiziksel saldırılarda %%%dMODIFIER_PROPERTY_TOOLTIP% can çalma kazanılıyor."
"[english]DOTA_Tooltip_modifier_holdout_gladiators_unite_Description"	"Gaining %dMODIFIER_PROPERTY_PHYSICAL_ARMOR_BONUS% bonus armor, %dMODIFIER_PROPERTY_PREATTACK_BONUS_DAMAGE% bonus damage, and %dMODIFIER_PROPERTY_TOOLTIP%%% lifesteal on physical attacks."
"DOTA_Tooltip_ability_holdout_dragon_slave"	"Dragon Slave"
"[english]DOTA_Tooltip_ability_holdout_dragon_slave"	"Dragon Slave"
"DOTA_Tooltip_ability_holdout_dragon_slave_Description"	"Lina, bir ejderin nefesini yönlendirerek yoluna çıkan her şeyi kül eden bir ateş dalgası gönderir."
"[english]DOTA_Tooltip_ability_holdout_dragon_slave_Description"	"Lina channels the breath of a dragon, sending out a wave of fire that scorches every enemy in its path."
"DOTA_Tooltip_ability_holdout_dragon_slave_Lore"	"Lina, Misrule'un kavrulmuş çölünde, Çöl Ejderinin alevli nefesini yönlendirmeyi bir eğlence biçimi olarak öğrendi."
"[english]DOTA_Tooltip_ability_holdout_dragon_slave_Lore"	"In the scorched barren of Misrule, Lina learned to manipulate the fiery breath of the Desert Wyrm as a form of entertainment."
"DOTA_Tooltip_ability_holdout_dragon_slave_Note0"	"Dragon Slave 1225 menzil uzaklıktaki birimlere vurabilir."
"[english]DOTA_Tooltip_ability_holdout_dragon_slave_Note0"	"Dragon Slave can hit units up to 1225 units away."
"DOTA_Tooltip_ability_holdout_light_strike_array"	"Light Strike Array"
"[english]DOTA_Tooltip_ability_holdout_light_strike_array"	"Light Strike Array"
"DOTA_Tooltip_ability_holdout_light_strike_array_Description"	"Düşmanlara hasar veren ve onları sersemleten bir alev sütunu yaratır."
"[english]DOTA_Tooltip_ability_holdout_light_strike_array_Description"	"Summons a column of flames that damages and stuns enemies."
"DOTA_Tooltip_ability_holdout_light_strike_array_Lore"	"Lina'nın özü onu güneşin enerjisine odaklanmasını sağlar ve istediğinde havanın patlamasına neden olur."
"[english]DOTA_Tooltip_ability_holdout_light_strike_array_Lore"	"Lina's essence allows her to focus the sun's energies, causing air to combust at will."
"DOTA_Tooltip_ability_holdout_light_strike_array_Note0"	"Light Strike Array etki alanı içerisindeki ağaçları yok eder."
"[english]DOTA_Tooltip_ability_holdout_light_strike_array_Note0"	"Light Strike Array will destroy trees in its area of effect."
"DOTA_Tooltip_ability_holdout_light_strike_array_light_strike_array_aoe"	"YARIÇAP:"
"[english]DOTA_Tooltip_ability_holdout_light_strike_array_light_strike_array_aoe"	"RADIUS:"
"DOTA_Tooltip_ability_holdout_light_strike_array_light_strike_array_stun_duration"	"SERSEMLETME SÜRESİ:"
"[english]DOTA_Tooltip_ability_holdout_light_strike_array_light_strike_array_stun_duration"	"STUN DURATION:"
"DOTA_Tooltip_ability_holdout_light_strike_array_light_strike_array_delay_time"	"KULLANMA GECİKMESİ:"
"[english]DOTA_Tooltip_ability_holdout_light_strike_array_light_strike_array_delay_time"	"CAST DELAY:"
"DOTA_Tooltip_ability_holdout_fiery_soul"	"Blazing Soul"
"[english]DOTA_Tooltip_ability_holdout_fiery_soul"	"Blazing Soul"
"DOTA_Tooltip_ability_holdout_fiery_soul_Description"	"Lina'ya, her yetenek kullandığında fazladan saldırı hızı, hareket hızı ve <font color='#70EA72'>yetenek kullanım süresini azaltma</font> sağlar. Kendisiyle istiflenir."
"[english]DOTA_Tooltip_ability_holdout_fiery_soul_Description"	"Grants bonus attack speed, movement speed, and <font color='#70EA72'>decreased cast time</font> each time Lina casts a spell. Stacks with itself."
"DOTA_Tooltip_ability_holdout_fiery_soul_Lore"	"Dans eden alevler Lina'nın oyuncu doğasını yansıtarak, asıl alevli kişiliğini meydana çıkarır."
"[english]DOTA_Tooltip_ability_holdout_fiery_soul_Lore"	"Dancing flames embody Lina's playful nature, bringing out her true blazing self."
"DOTA_Tooltip_ability_holdout_fiery_soul_Note0"	"Yeni bir büyü yapıldığında süre yenilenir."
"[english]DOTA_Tooltip_ability_holdout_fiery_soul_Note0"	"Duration refreshes each time a new spell is cast."
"DOTA_Tooltip_ability_holdout_fiery_soul_Note1"	"Eşya kullanmak Fiery Soul'u tetiklemez."
"[english]DOTA_Tooltip_ability_holdout_fiery_soul_Note1"	"Using items does not trigger Fiery Soul."
"DOTA_Tooltip_ability_holdout_fiery_soul_fiery_soul_attack_speed_bonus"	"FAZLADAN SALDIRI HIZI:"
"[english]DOTA_Tooltip_ability_holdout_fiery_soul_fiery_soul_attack_speed_bonus"	"ATTACK SPEED BONUS:"
"DOTA_Tooltip_ability_holdout_fiery_soul_fiery_soul_move_speed_bonus"	"%FAZLADAN HAREKET HIZI:"
"[english]DOTA_Tooltip_ability_holdout_fiery_soul_fiery_soul_move_speed_bonus"	"%MOVE SPEED BONUS:"
"DOTA_Tooltip_ability_holdout_fiery_soul_fiery_soul_max_stacks"	"<font color='#70EA72'>MAKS İSTİF:</font>"
"[english]DOTA_Tooltip_ability_holdout_fiery_soul_fiery_soul_max_stacks"	"<font color='#70EA72'>MAX STACKS:</font>"
"DOTA_Tooltip_ability_holdout_fiery_soul_duration"	"<font color='#70EA72'>SÜRE:</font>"
"[english]DOTA_Tooltip_ability_holdout_fiery_soul_duration"	"<font color='#70EA72'>DURATION:</font>"
"DOTA_Tooltip_ability_holdout_fiery_soul_fiery_soul_cast_point_bonus"	"<font color='#70EA72'>KULLANIM ZAMANLAMASI BONUSU:</font>"
"[english]DOTA_Tooltip_ability_holdout_fiery_soul_fiery_soul_cast_point_bonus"	"<font color='#70EA72'>CAST POINT BONUS:</font>"
"DOTA_Tooltip_modifier_holdout_fiery_soul"	"Blazing Soul"
"[english]DOTA_Tooltip_modifier_holdout_fiery_soul"	"Blazing Soul"
"DOTA_Tooltip_modifier_holdout_fiery_soul_Description"	"Saldırı Hızı %dMODIFIER_PROPERTY_ATTACKSPEED_BONUS_CONSTANT% kadar artar, hareket hızı %%%dMODIFIER_PROPERTY_MOVESPEED_BONUS_PERCENTAGE% kadar artar ve kullanım zamanlaması %fMODIFIER_PROPERTY_TOOLTIP% kadar düşer. \\r\ngames/dota2/holdout_english.txt: Saldırı Hızı %dMODIFIER_PROPERTY_ATTACKSPEED_BONUS_CONSTANT% kadar artar, hareket hızı %%%dMODIFIER_PROPERTY_MOVESPEED_BONUS_PERCENTAGE% kadar artar ve kullanım zamanlaması %fMODIFIER_PROPERTY_TOOLTIP% kadar düşer."
"[english]DOTA_Tooltip_modifier_holdout_fiery_soul_Description"	"Attack Speed increased by %dMODIFIER_PROPERTY_ATTACKSPEED_BONUS_CONSTANT%, movement Speed by %dMODIFIER_PROPERTY_MOVESPEED_BONUS_PERCENTAGE%%%, and cast point decreased by %fMODIFIER_PROPERTY_TOOLTIP%."
"DOTA_Tooltip_ability_templar_assassin_refraction_holdout"	"Deflection"
"[english]DOTA_Tooltip_ability_templar_assassin_refraction_holdout"	"Deflection"
"DOTA_Tooltip_ability_templar_assassin_refraction_holdout_Lore"	"Lanaya psiyonik örtüsünü kullanarak doğanın kanunlarını kendi arzuna göre büker."
"[english]DOTA_Tooltip_ability_templar_assassin_refraction_holdout_Lore"	"Manipulating her psionic veil, Lanaya bends nature's law to her will."
"DOTA_Tooltip_ability_templar_assassin_refraction_holdout_Description"	"Templar Assassin çevresine hasarı emen ve ona bonus hasar kazandıran koruyucu bir kalkan oluşturur."
"[english]DOTA_Tooltip_ability_templar_assassin_refraction_holdout_Description"	"Templar Assassin creates a defensive shield around herself that absorbs damage and provides a bonus to her damage."
"DOTA_Tooltip_ability_templar_assassin_refraction_holdout_Note0"	"Can Azaltma türü hasarlar Saptırmayı etkilemez."
"[english]DOTA_Tooltip_ability_templar_assassin_refraction_holdout_Note0"	"Damage as HP Removal bypasses Deflection."
"DOTA_Tooltip_ability_templar_assassin_refraction_holdout_damage_absorb"	"%HASAR EMME:"
"[english]DOTA_Tooltip_ability_templar_assassin_refraction_holdout_damage_absorb"	"%DAMAGE ABSORB:"
"DOTA_Tooltip_ability_templar_assassin_refraction_holdout_bonus_damage"	"%FAZLADAN HASAR:"
"[english]DOTA_Tooltip_ability_templar_assassin_refraction_holdout_bonus_damage"	"%BONUS DAMAGE:"
"DOTA_Tooltip_ability_templar_assassin_refraction_holdout_duration"	"SÜRE:"
"[english]DOTA_Tooltip_ability_templar_assassin_refraction_holdout_duration"	"DURATION:"
"DOTA_Tooltip_ability_templar_assassin_psionic_trap_holdout"	"Psionic Trap"
"[english]DOTA_Tooltip_ability_templar_assassin_psionic_trap_holdout"	"Psionic Trap"
"DOTA_Tooltip_ability_templar_assassin_psionic_trap_holdout_Lore"	"Gizli tapınağın tepesine hükmederken kimse Tapınakçının gözünden kaçamaz."
"[english]DOTA_Tooltip_ability_templar_assassin_psionic_trap_holdout_Lore"	"Calling upon the reach of the Hidden Temple, none escape the eye of the Templar."
"DOTA_Tooltip_ability_templar_assassin_psionic_trap_holdout_Description"	"Templar Assassin düşman hareketine duyarlı, görünmez, mistik tuzaklar kurar. Bu tuzaklar Templar Assassin'in komutuyla patlatılırlarsa, o alana %%30 yavaşlatan bir etki uygularlar. Bu tuzaklar zamanla saniye başına %%5 ve en fazla %%50 olmak üzere fazladan yavaşlatma da sağlar."
"[english]DOTA_Tooltip_ability_templar_assassin_psionic_trap_holdout_Description"	"Templar Assassin places mystical traps that invisibly monitor enemy movement. When sprung, at her command, they exert a slowing influence of 30%% in the area. Traps charge up to slow more by 5%% for each second up to 50%%."
"DOTA_Tooltip_ability_templar_assassin_psionic_trap_holdout_Note0"	"Tuzaklar süresizdir."
"[english]DOTA_Tooltip_ability_templar_assassin_psionic_trap_holdout_Note0"	"Traps last indefinitely."
"DOTA_Tooltip_ability_templar_assassin_psionic_trap_holdout_Note1"	"İki saniye içinde görünmez olurlar, büyü bağışıklığına sahiptirler ve 100 sağlık değerleri vardır."
"[english]DOTA_Tooltip_ability_templar_assassin_psionic_trap_holdout_Note1"	"They have invisibility that fades in over 2 seconds, magic immunity, and 100 HP."
"DOTA_Tooltip_ability_templar_assassin_psionic_trap_holdout_Note2"	"Tuzakların 400/400 görüş menzili vardır ve tarafsız yaratık kamplarından yaratık çıkmasını engellemez."
"[english]DOTA_Tooltip_ability_templar_assassin_psionic_trap_holdout_Note2"	"Traps have 400/400 vision range and don't prevent neutral camps from spawning."
"DOTA_Tooltip_ability_templar_assassin_psionic_trap_holdout_max_traps"	"MAKS TUZAK:"
"[english]DOTA_Tooltip_ability_templar_assassin_psionic_trap_holdout_max_traps"	"MAX TRAPS:"
"DOTA_Tooltip_ability_holdout_paralyzing_cask"	"Paralyzing Cask"
"[english]DOTA_Tooltip_ability_holdout_paralyzing_cask"	"Paralyzing Cask"
"DOTA_Tooltip_ability_holdout_paralyzing_cask_Description"	"Düşman birimlerinin arasında onları sersemleterek ve hasar vererek seken, felç edici tozla dolu bir varil yuvarlar."
"[english]DOTA_Tooltip_ability_holdout_paralyzing_cask_Description"	"Launches a cask of paralyzing powder that ricochets between enemy units, stunning and damaging those it hits."
"DOTA_Tooltip_ability_holdout_paralyzing_cask_Lore"	"Witch Doctor ölen arkadaşlarının ve düşmanlarının kemiklerini toz haline getirip, efsun ve alşimi repertuarına eklemek üzere yeniden kullanır."
"[english]DOTA_Tooltip_ability_holdout_paralyzing_cask_Lore"	"The Witch Doctor recycles the bones of fallen friends and foes, using the powder as part of his arsenal of charms and alchemy."
"DOTA_Tooltip_ability_holdout_paralyzing_cask_Note0"	"Sekme sırasında başka birimler de isabet aldığı sürece aynı hedefe birden fazla vurulabilir."
"[english]DOTA_Tooltip_ability_holdout_paralyzing_cask_Note0"	"Targets can be hit multiple times, as long as another unit is struck in between the bounces."
"DOTA_Tooltip_ability_holdout_paralyzing_cask_bounces_tooltip"	"SEKMELER:"
"[english]DOTA_Tooltip_ability_holdout_paralyzing_cask_bounces_tooltip"	"BOUNCES:"
"DOTA_Tooltip_ability_holdout_paralyzing_cask_hero_duration"	"KAHRAMAN SERSEMLETME SÜRESİ:"
"[english]DOTA_Tooltip_ability_holdout_paralyzing_cask_hero_duration"	"HERO STUN DURATION:"
"DOTA_Tooltip_ability_holdout_paralyzing_cask_creep_duration"	"YARATIK SERSEMLETME SÜRESİ:"
"[english]DOTA_Tooltip_ability_holdout_paralyzing_cask_creep_duration"	"CREEP STUN DURATION:"
"DOTA_Tooltip_ability_holdout_paralyzing_cask_hero_damage"	"KAHRAMAN HASARI:"
"[english]DOTA_Tooltip_ability_holdout_paralyzing_cask_hero_damage"	"HERO DAMAGE:"
"DOTA_Tooltip_ability_holdout_voodoo_restoration"	"Voodoo Restoration"
"[english]DOTA_Tooltip_ability_holdout_voodoo_restoration"	"Voodoo Restoration"
"DOTA_Tooltip_ability_holdout_voodoo_restoration_Description"	"Witch Doctor büyüsünü yakındaki dostlarının sağlıklarını yenilemek için kullanır."
"[english]DOTA_Tooltip_ability_holdout_voodoo_restoration_Description"	"Witch Doctor focuses his magic to heal nearby allied units."
"DOTA_Tooltip_ability_holdout_voodoo_restoration_Lore"	"Zharvakko'nun hokus pokusu sadece düşmanlarını lanetlemek üzerine değildir, aynı zamanda hastalıkları da iyileştirebilir."
"[english]DOTA_Tooltip_ability_holdout_voodoo_restoration_Lore"	"Zharvakko's hocus pocus is not limited only to hexxing his opponents and is quite adept at curing ailments."
"DOTA_Tooltip_ability_holdout_voodoo_restoration_Note0"	"İyileştirme, 0.33 saniyelik aralıklarla yapılır."
"[english]DOTA_Tooltip_ability_holdout_voodoo_restoration_Note0"	"Healing is done in 0.33 second intervals."
"DOTA_Tooltip_ability_holdout_voodoo_restoration_Note1"	"Büyü bağışıklığına sahip birimleri iyileştirebilir."
"[english]DOTA_Tooltip_ability_holdout_voodoo_restoration_Note1"	"Can heal magic immune units."
"DOTA_Tooltip_ability_holdout_voodoo_restoration_mana_per_second"	"SANİYE BAŞINA MANA:"
"[english]DOTA_Tooltip_ability_holdout_voodoo_restoration_mana_per_second"	"MANA PER SEC:"
"DOTA_Tooltip_ability_holdout_voodoo_restoration_heal"	"İYİLEŞTİRME:"
"[english]DOTA_Tooltip_ability_holdout_voodoo_restoration_heal"	"HEAL:"
"DOTA_Tooltip_ability_holdout_voodoo_restoration_radius"	"YARIÇAP:"
"[english]DOTA_Tooltip_ability_holdout_voodoo_restoration_radius"	"RADIUS:"
"DOTA_Tooltip_ability_holdout_death_ward"	"Death Ward"
"[english]DOTA_Tooltip_ability_holdout_death_ward"	"Death Ward"
"DOTA_Tooltip_ability_holdout_death_ward_Description"	"SÜRELİ - Düşman kahramanlarına saldıran ölümcül bir Ward'ı emrine çağırır. Death Ward'ın menzili 700'dür ve her .25 saniyede bir saldırır. <font color='#70EA72'>10 saniye sürer.</font> .\n\nAghanim's Scepter ile geliştirilebilir."
"[english]DOTA_Tooltip_ability_holdout_death_ward_Description"	"CHANNELED - Summons a deadly ward to attack enemy heroes.  The Death Ward has attack range of 700, and attacks every .25 seconds. <font color='#70EA72'>Lasts 10 seconds.</font> .\n\nUpgradable by Aghanim's Scepter."
"DOTA_Tooltip_ability_holdout_death_ward_Lore"	"Witch Doctor anlatacak kadar uzun yaşayanların kabuslarına giren bir dini dans gerçekleştirir."
"[english]DOTA_Tooltip_ability_holdout_death_ward_Lore"	"Witch Doctor performs a ritualistic dance, one that haunts the dreams of those who live to recount it."
"DOTA_Tooltip_ability_holdout_death_ward_Note0"	"Death Ward'a hasar verilemez ve sadece Witch \\r\nDoctor durdurulduğunda veya süresi bittiğinde yok olur."
"[english]DOTA_Tooltip_ability_holdout_death_ward_Note0"	"The Death Ward is invulnerable, and is only destroyed if Witch Doctor is interrupted or its duration expires."
"DOTA_Tooltip_ability_holdout_death_ward_Note1"	"Death Ward kontrol edilebilir ve belirli bir hedefe saldırması sağlanabilir."
"[english]DOTA_Tooltip_ability_holdout_death_ward_Note1"	"The Death Ward can be controlled, and made to attack a specific target."
"DOTA_Tooltip_ability_holdout_death_ward_damage"	"HASAR:"
"[english]DOTA_Tooltip_ability_holdout_death_ward_damage"	"DAMAGE:"
"DOTA_Tooltip_ability_holdout_death_ward_bounces"	"<font color='#70EA72'>SEKMELER:</font>"
"[english]DOTA_Tooltip_ability_holdout_death_ward_bounces"	"<font color='#70EA72'>BOUNCES:</font>"
"DOTA_Tooltip_ability_holdout_death_ward_damage_scepter"	"SCEPTER'LI HASAR:"
"[english]DOTA_Tooltip_ability_holdout_death_ward_damage_scepter"	"SCEPTER DAMAGE:"
"DOTA_Tooltip_ability_holdout_death_ward_scepter_bounces"	"<font color='#70EA72'>SCEPTER'LI SEKME:</font>"
"[english]DOTA_Tooltip_ability_holdout_death_ward_scepter_bounces"	"<font color='#70EA72'>SCEPTER BOUNCES:</font>"
"DOTA_Tooltip_ability_phantom_assassin_stifling_dagger_nb2017"	"Stifling Dagger"
"[english]DOTA_Tooltip_ability_phantom_assassin_stifling_dagger_nb2017"	"Stifling Dagger"
"DOTA_Tooltip_ability_phantom_assassin_stifling_dagger_nb2017_Description"	"<font color='#70EA72'>Hedeflediği alana bir seri hançer fırlatır ve her bir yolu üzerindeki birime vurur.</font> Hançer düşman biriminin hareket hızını yavaşlatır, Phantom Assassin'in saldırı hasarının %%%base_damage%+%attack_factor_tooltip% kadarını fiziksel hasar olarak veren ve eşyaların ve yeteneklerin etkilerini uygular."
"[english]DOTA_Tooltip_ability_phantom_assassin_stifling_dagger_nb2017_Description"	"<font color='#70EA72'>Throws a flurry of daggers at the area around the target point, each one hitting the first unit in its path.</font>  The daggers slow enemy movement speed, and deal %base_damage%+%attack_factor_tooltip%%% of Phantom Assassin's attack damage as physical damage and applying attack effects from items and abilities."
"DOTA_Tooltip_ability_phantom_assassin_stifling_dagger_nb2017_Note0"	"Eğer bir saldırı efekti şans bazlıysa, uygulanma şansı o şansın oluşma olasılığıyla aynı olacaktır."
"[english]DOTA_Tooltip_ability_phantom_assassin_stifling_dagger_nb2017_Note0"	"If an attack effect is chance-based, the chance of its application will be the same as its chance to occur."
"DOTA_Tooltip_ability_phantom_assassin_stifling_dagger_nb2017_Lore"	"Veil Kardeşler tarafından öğrenilen ilk yetenek genellikle gelen bir saldırıyı bildirir."
"[english]DOTA_Tooltip_ability_phantom_assassin_stifling_dagger_nb2017_Lore"	"The first skill learned by the Sisters of the Veil often signals an incoming hit."
"DOTA_Tooltip_ability_phantom_assassin_stifling_dagger_nb2017_move_slow"	"%HAREKET YAVAŞLATMASI:"
"[english]DOTA_Tooltip_ability_phantom_assassin_stifling_dagger_nb2017_move_slow"	"%MOVE SLOW:"
"DOTA_Tooltip_ability_phantom_assassin_stifling_dagger_nb2017_duration"	"YAVAŞLATMA SÜRESİ:"
"[english]DOTA_Tooltip_ability_phantom_assassin_stifling_dagger_nb2017_duration"	"SLOW DURATION:"
"DOTA_Tooltip_ability_phantom_assassin_stifling_dagger_nb2017_base_damage"	"TEMEL HASAR:"
"[english]DOTA_Tooltip_ability_phantom_assassin_stifling_dagger_nb2017_base_damage"	"BASE DAMAGE:"
"DOTA_Tooltip_ability_phantom_assassin_stifling_dagger_nb2017_attack_factor_tooltip"	"%SALDIRI HASARI:"
"[english]DOTA_Tooltip_ability_phantom_assassin_stifling_dagger_nb2017_attack_factor_tooltip"	"%ATTACK DAMAGE:"
"DOTA_Tooltip_ability_phantom_assassin_stifling_dagger_nb2017_dagger_count"	"HANÇER SAYISI:"
"[english]DOTA_Tooltip_ability_phantom_assassin_stifling_dagger_nb2017_dagger_count"	"DAGGER COUNT:"
"DOTA_Tooltip_ability_phantom_assassin_stifling_dagger_nb2017_dagger_range"	"HANÇER MENZİLİ:"
"[english]DOTA_Tooltip_ability_phantom_assassin_stifling_dagger_nb2017_dagger_range"	"DAGGER RANGE:"
"DOTA_Tooltip_ability_tiny_trample"	"Trample"
"[english]DOTA_Tooltip_ability_tiny_trample"	"Trample"
"DOTA_Tooltip_ability_tiny_trample_Description"	"Tiny ileriye doğru atılır, devasa boyutuyla düşmanları ezip geçer. Ezdiği her bir düşman sersemler ve Tiny'nin saldırı hasarının bir kısmı kadar hasar verir. Fazladan hareket hızı ve fazlı çarpışma kazanır."
"[english]DOTA_Tooltip_ability_tiny_trample_Description"	"Tiny rushes forward, trampling enemy units with his craggy mass.  He gains bonus movement speed and phased collison, while each enemy he tramples is stunned and dealt a portion of his attack damage."
"DOTA_Tooltip_ability_tiny_trample_attack_factor_tooltip"	"%SALDIRI HASARI:"
"[english]DOTA_Tooltip_ability_tiny_trample_attack_factor_tooltip"	"%ATTACK DAMAGE:"
"DOTA_Tooltip_ability_tiny_trample_bonus_movespeed_pct"	"%FAZLADAN HAREKET HIZI:"
"[english]DOTA_Tooltip_ability_tiny_trample_bonus_movespeed_pct"	"%BONUS MOVEMENT SPEED:"
"DOTA_Tooltip_ability_tiny_trample_duration"	"EZME SÜRESİ:"
"[english]DOTA_Tooltip_ability_tiny_trample_duration"	"TRAMPLE DURATION:"
"DOTA_Tooltip_ability_tiny_trample_stun_duration"	"SERSEMLETME SÜRESİ:"
"[english]DOTA_Tooltip_ability_tiny_trample_stun_duration"	"STUN DURATION:"
"DOTA_Tooltip_modifier_tiny_trample"	"Trample"
"[english]DOTA_Tooltip_modifier_tiny_trample"	"Trample"
"DOTA_Tooltip_ability_dungeon_tidehunter_gush"	"Gush"
"[english]DOTA_Tooltip_ability_dungeon_tidehunter_gush"	"Gush"
"DOTA_Tooltip_ability_dungeon_tidehunter_gush_Description"	"Yoluna çıkan düşmanları yavaşlatmak ve zırhlarını zayıflatmak için suyun gücünü çağırır. 4 saniye sürer.\n\nAghanim's Scepter ile geliştirilebilir."
"[english]DOTA_Tooltip_ability_dungeon_tidehunter_gush_Description"	"Summons a gush of water to damage an enemy unit, reducing their movement speed and armor.  Lasts 4 seconds.\n\nUpgradable by Aghanim's Scepter."
"DOTA_Tooltip_ability_dungeon_tidehunter_gush_Lore"	"Batık Adalarındaki üstünlüğü boyunca, Leviathan açık denizlerde ustalık kazandı."
"[english]DOTA_Tooltip_ability_dungeon_tidehunter_gush_Lore"	"During his championship of the Sunken Isles, Leviathan gained mastery over the open sea."
"DOTA_Tooltip_ability_dungeon_tidehunter_gush_movement_speed"	"%YAVAŞLATMA:"
"[english]DOTA_Tooltip_ability_dungeon_tidehunter_gush_movement_speed"	"%SLOW:"
"DOTA_Tooltip_ability_dungeon_tidehunter_gush_negative_armor"	"ZIRH AZALTMA:"
"[english]DOTA_Tooltip_ability_dungeon_tidehunter_gush_negative_armor"	"ARMOR REDUCTION:"
"DOTA_Tooltip_ability_dungeon_tidehunter_gush_cast_range_scepter"	"SCEPTER MENZİLİ:"
"[english]DOTA_Tooltip_ability_dungeon_tidehunter_gush_cast_range_scepter"	"SCEPTER RANGE:"
"DOTA_Tooltip_ability_dungeon_tidehunter_gush_aoe_scepter"	"SCEPTER'LI YARIÇAP:"
"[english]DOTA_Tooltip_ability_dungeon_tidehunter_gush_aoe_scepter"	"SCEPTER RADIUS:"
"DOTA_Tooltip_ability_dungeon_tidehunter_gush_cooldown_scepter"	"SCEPTER'LI DOLUM SÜRESİ:"
"[english]DOTA_Tooltip_ability_dungeon_tidehunter_gush_cooldown_scepter"	"SCEPTER COOLDOWN:"
"DOTA_Tooltip_ability_dungeon_tidehunter_gush_aghanim_description"	"Gush yeteneği düşman kahramanları düz bir çizgide yeri hedefleyen dalga yeteneğine dönüşür. Dolum süresini düşürür."
"[english]DOTA_Tooltip_ability_dungeon_tidehunter_gush_aghanim_description"	"Gush becomes a ground targeted wave ability that affects enemy units in a line.  Decreases cooldown."
"DOTA_Tooltip_ability_dungeon_tidehunter_ravage"	"Ravage"
"[english]DOTA_Tooltip_ability_dungeon_tidehunter_ravage"	"Ravage"
"DOTA_Tooltip_ability_dungeon_tidehunter_ravage_Description"	"Yere tüm gücüyle vurarak her yerden dokungaç çıkmasını sağlar. Dokungaçlar çevredeki tüm düşman birimlerini sersemleterek hasar verir."
"[english]DOTA_Tooltip_ability_dungeon_tidehunter_ravage_Description"	"Slams the ground, causing tentacles to erupt in all directions, damaging and stunning all nearby enemy units."
"DOTA_Tooltip_ability_dungeon_tidehunter_ravage_Lore"	"Derin denizlerin tanrısı Maelrawn'a yapılan çağrı, denizdeki bütün donanmaların kaybolması ile sonuçladı."
"[english]DOTA_Tooltip_ability_dungeon_tidehunter_ravage_Lore"	"Calling to the abyssal god Maelrawn has resulted in entire armadas being lost at sea."
"DOTA_Tooltip_ability_dungeon_tidehunter_ravage_Note0"	"Ravage görünmez birimlere vurur."
"[english]DOTA_Tooltip_ability_dungeon_tidehunter_ravage_Note0"	"Ravage will hit invisible units."
"DOTA_Tooltip_ability_dungeon_tidehunter_ravage_Note1"	"Ravage dalgası 775 birimlik hızla ilerler."
"[english]DOTA_Tooltip_ability_dungeon_tidehunter_ravage_Note1"	"Ravage waves move outwards at a speed of 775."
"DOTA_Tooltip_ability_dungeon_tidehunter_ravage_radius"	"YARIÇAP:"
"[english]DOTA_Tooltip_ability_dungeon_tidehunter_ravage_radius"	"RADIUS:"
"DOTA_Tooltip_ability_dungeon_tidehunter_ravage_duration"	"SÜRE:"
"[english]DOTA_Tooltip_ability_dungeon_tidehunter_ravage_duration"	"DURATION:"
"DOTA_Tooltip_ability_dungeon_nevermore_shadowraze1"	"Shadowraze"
"[english]DOTA_Tooltip_ability_dungeon_nevermore_shadowraze1"	"Shadowraze"
"DOTA_Tooltip_ability_dungeon_nevermore_shadowraze1_Description"	"Shadow Fiend önündeki alanı yerle bir eder, alandaki düşman birimlere hasar verir."
"[english]DOTA_Tooltip_ability_dungeon_nevermore_shadowraze1_Description"	"Shadow Fiend razes the area in front of him, dealing damage to enemy units in an area."
"DOTA_Tooltip_ability_dungeon_nevermore_shadowraze1_Lore"	"Nevermore'un ruh toplama imzası."
"[english]DOTA_Tooltip_ability_dungeon_nevermore_shadowraze1_Lore"	"Nevermore's trademark for harvesting souls."
"DOTA_Tooltip_ability_dungeon_nevermore_shadowraze1_shadowraze_range"	"MENZİL:"
"[english]DOTA_Tooltip_ability_dungeon_nevermore_shadowraze1_shadowraze_range"	"RANGE:"
"DOTA_Tooltip_ability_dungeon_nevermore_shadowraze2"	"Shadowraze"
"[english]DOTA_Tooltip_ability_dungeon_nevermore_shadowraze2"	"Shadowraze"
"DOTA_Tooltip_ability_dungeon_nevermore_shadowraze2_Description"	"Shadow Fiend önündeki alanı yerle bir eder, alandaki düşman birimlere hasar verir."
"[english]DOTA_Tooltip_ability_dungeon_nevermore_shadowraze2_Description"	"Shadow Fiend razes the area in front of him, dealing damage to enemy units in an area."
"DOTA_Tooltip_ability_dungeon_nevermore_shadowraze2_Lore"	"Nevermore'un ruh toplama imzası."
"[english]DOTA_Tooltip_ability_dungeon_nevermore_shadowraze2_Lore"	"Nevermore's trademark for harvesting souls."
"DOTA_Tooltip_ability_dungeon_nevermore_shadowraze2_shadowraze_range"	"MENZİL:"
"[english]DOTA_Tooltip_ability_dungeon_nevermore_shadowraze2_shadowraze_range"	"RANGE:"
"DOTA_Tooltip_ability_dungeon_nevermore_shadowraze3"	"Shadowraze"
"[english]DOTA_Tooltip_ability_dungeon_nevermore_shadowraze3"	"Shadowraze"
"DOTA_Tooltip_ability_dungeon_nevermore_shadowraze3_Description"	"Shadow Fiend önündeki alanı yerle bir eder, alandaki düşman birimlere hasar verir."
"[english]DOTA_Tooltip_ability_dungeon_nevermore_shadowraze3_Description"	"Shadow Fiend razes the area in front of him, dealing damage to enemy units in an area."
"DOTA_Tooltip_ability_dungeon_nevermore_shadowraze3_Lore"	"Nevermore'un ruh toplama imzası."
"[english]DOTA_Tooltip_ability_dungeon_nevermore_shadowraze3_Lore"	"Nevermore's trademark for harvesting souls."
"DOTA_Tooltip_ability_dungeon_nevermore_shadowraze3_shadowraze_range"	"MENZİL:"
"[english]DOTA_Tooltip_ability_dungeon_nevermore_shadowraze3_shadowraze_range"	"RANGE:"
"DOTA_Tooltip_ability_nevermore_necromastery"	"Necromastery"
"[english]DOTA_Tooltip_ability_nevermore_necromastery"	"Necromastery"
"DOTA_Tooltip_ability_nevermore_necromastery_Description"	"Shadow Fiend öldürdüğü birimlerin ruhlarını çalarak fazladan hasar kazanır. Öldürülen birim bir kahraman ise 12 ruh çalar. Öldüğü zaman ruhların yarısını serbest bırakır.\n\nAghanim's Scepter ile geliştirilebilir."
"[english]DOTA_Tooltip_ability_nevermore_necromastery_Description"	"Shadow Fiend steals the soul from units he kills, gaining bonus damage. If the killed unit is a hero, he gains 12 souls.  On death, he releases half of them from bondage.\n\nUpgradable by Aghanim's Scepter."
"DOTA_Tooltip_ability_nevermore_necromastery_Lore"	"Toplanmış ruhlar boşlukta girdap yaparak döner, Shadow Fiend'i toplamasını artırmak üzere güçlendirirler."
"[english]DOTA_Tooltip_ability_nevermore_necromastery_Lore"	"Harvested souls swirl in and out of the Abysm, empowering the Shadow Fiend to increase the size of his collection."
"DOTA_Tooltip_ability_nevermore_necromastery_Note0"	"Reddetmeler ve tarafsız yaratıklarda Necromastery aracılığıyla fazladan hasar sağlar."
"[english]DOTA_Tooltip_ability_nevermore_necromastery_Note0"	"Denies and neutral creeps also provide bonus damage through Necromastery."
"DOTA_Tooltip_ability_nevermore_necromastery_necromastery_max_souls"	"MAKS RUH:"
"[english]DOTA_Tooltip_ability_nevermore_necromastery_necromastery_max_souls"	"MAX SOULS:"
"DOTA_Tooltip_ability_nevermore_necromastery_necromastery_damage_per_soul"	"RUH BAŞINA HASAR:"
"[english]DOTA_Tooltip_ability_nevermore_necromastery_necromastery_damage_per_soul"	"DAMAGE PER SOUL:"
"DOTA_Tooltip_ability_nevermore_necromastery_necromastery_max_souls_scepter"	"SCEPTER'LI MAKS RUH:"
"[english]DOTA_Tooltip_ability_nevermore_necromastery_necromastery_max_souls_scepter"	"SCEPTER MAX SOULS:"
"DOTA_Tooltip_ability_nevermore_necromastery_aghanim_description"	"Maksimum ruh sayısını artırır."
"[english]DOTA_Tooltip_ability_nevermore_necromastery_aghanim_description"	"Increases max souls."
"DOTA_Tooltip_ability_nevermore_dark_lord"	"Presence of the Dark Lord"
"[english]DOTA_Tooltip_ability_nevermore_dark_lord"	"Presence of the Dark Lord"
"DOTA_Tooltip_ability_nevermore_dark_lord_Description"	"Shadow Fiend'ın varlığı yakındaki düşmanların zırhlarını düşürür."
"[english]DOTA_Tooltip_ability_nevermore_dark_lord_Description"	"Shadow Fiend's presence reduces the armor of nearby enemies."
"DOTA_Tooltip_ability_nevermore_dark_lord_Lore"	"Nevermore'un yakınında olmak bile insanın ruhunu emer."
"[english]DOTA_Tooltip_ability_nevermore_dark_lord_Lore"	"Even being near Nevermore eats away at one's soul."
"DOTA_Tooltip_ability_nevermore_dark_lord_Note0"	"Diğer zırh azaltmalar ve auralar ile istiflenebilir."
"[english]DOTA_Tooltip_ability_nevermore_dark_lord_Note0"	"Stacks fully with other armor reduction abilities and aura."
"DOTA_Tooltip_ability_nevermore_dark_lord_presence_armor_reduction"	"AZALTMA:"
"[english]DOTA_Tooltip_ability_nevermore_dark_lord_presence_armor_reduction"	"REDUCTION:"
"DOTA_Tooltip_ability_nevermore_dark_lord_presence_radius"	"YARIÇAP:"
"[english]DOTA_Tooltip_ability_nevermore_dark_lord_presence_radius"	"RADIUS:"
"DOTA_Tooltip_ability_nevermore_requiem"	"Requiem of Souls"
"[english]DOTA_Tooltip_ability_nevermore_requiem"	"Requiem of Souls"
"DOTA_Tooltip_ability_nevermore_requiem_Description"	"Shadow Fiend hapsedilmiş ruhları şeytani enerji çizgileri üzerinde salmak için bir araya getirir. Ruhlar salındığında Shadow Fiend'e yakın olan birimler birden fazla enerji çizgisi tarafından hasar alabilirler. Requiem of Souls tarafından hasar alan bütün birimlerin haraket hızı ve saldırı hasarı azaltılır. Enerji çizgileri Necromastery tarafından hapsedilen her 2 ruh için bir tanedir. Shadow Fiend öldüğünde Requiem of Souls yeteneği, dolum süresi dikkate alınmaksızın otomatik olarak kullanılır.\n\nAghanim's Scepter ile geliştirilebilir."
"[english]DOTA_Tooltip_ability_nevermore_requiem_Description"	"Shadow Fiend gathers his captured souls to release them as lines of demonic energy. Units near Shadow Fiend when the souls are released can be damaged by several lines of energy. Any unit damaged by Requiem of Souls will have its movement speed and attack damage reduced. Lines of energy are created for every 2 souls captured through Necromastery. Requiem of Souls is automatically cast whenever Shadow Fiend dies, regardless of its cooldown.\n\nUpgradable by Aghanim's Scepter."
"DOTA_Tooltip_ability_nevermore_requiem_aghanim_description"	"Necromastery maksimum ruh sayısını artırır ve Requiem of Souls'un Shadow Fiend'e geri dönmesine neden olur. Shadow Fiend'e geri dönen dalga daha az hasar verir ancak verdiği hasar Shadow Fiend'ı iyileştirir."
"[english]DOTA_Tooltip_ability_nevermore_requiem_aghanim_description"	"Increases Necromastery Max Souls and causes Requiem of Souls to return back to Shadow Fiend. The wave back to Shadow Fiend deals less damage, but heals Shadow Fiend for all the damage it dealt."
"DOTA_Tooltip_ability_nevermore_requiem_cast_time_tooltip"	"KULLANMA GECİKMESİ:"
"[english]DOTA_Tooltip_ability_nevermore_requiem_cast_time_tooltip"	"CAST DELAY:"
"DOTA_Tooltip_ability_nevermore_requiem_requiem_slow_duration"	"AZALTMA SÜRESİ:"
"[english]DOTA_Tooltip_ability_nevermore_requiem_requiem_slow_duration"	"REDUCTION DURATION:"
"DOTA_Tooltip_ability_nevermore_requiem_requiem_heal_pct_scepter"	"%SCEPTER GERİ DÖNEN İYİLEŞTİRME:"
"[english]DOTA_Tooltip_ability_nevermore_requiem_requiem_heal_pct_scepter"	"%SCEPTER HEAL ON RETURN:"
"DOTA_Tooltip_ability_nevermore_requiem_Lore"	"Ölen düşmanların yakalanmış ruhları, eski müttefiklerini yıkmak için azat edilir."
"[english]DOTA_Tooltip_ability_nevermore_requiem_Lore"	"The captured souls of those past slain are released to ravage their former allies."
"DOTA_Tooltip_ability_nevermore_requiem_Note0"	"Shadow Fiend'in etrafında her bir sıra için 2 ruh olmak üzere, azami 18 sıra yaratılabilir (Scepter ile 23 sıra)."
"[english]DOTA_Tooltip_ability_nevermore_requiem_Note0"	"One line is generated from Shadow Fiend for every 2 souls in his possession, for a maximum of 18 lines (23 lines with Scepter)."
"DOTA_Tooltip_ability_nevermore_requiem_Note1"	"Requiem of Souls tarafından uygulanan hareket ve saldırı hasarı azaltması büyü bağışıklığından geçer."
"[english]DOTA_Tooltip_ability_nevermore_requiem_Note1"	"The movement and attack damage reductions from Requiem of Souls go through spell immunity."
"DOTA_Siltbreaker_Quests"	"GÖREVLER"
"[english]DOTA_Siltbreaker_Quests"	"QUESTS"
"DOTA_Siltbreaker_NoResurrections"	"Hiç Canlandırma Kalmadı"
"[english]DOTA_Siltbreaker_NoResurrections"	"No Resurrections Remaining"
"DOTA_Siltbreaker_Resurrect"	"Canlandır"
"[english]DOTA_Siltbreaker_Resurrect"	"Resurrect"
"DOTA_Siltbreaker_RespawnNearest"	"Takımınız bir sonraki kontrol noktasına ulaşırsa canlanacaksınız"
"[english]DOTA_Siltbreaker_RespawnNearest"	"You will respawn if your team gets to the next checkpoint"
"DOTA_Siltbreaker_BuybacksLeft"	"Kalan Anında Canlanma:"
"[english]DOTA_Siltbreaker_BuybacksLeft"	"Buybacks Left:"
"DOTA_Siltbreaker_BuybackCost"	"Anında Canlama Bedeli:"
"[english]DOTA_Siltbreaker_BuybackCost"	"Buyback Cost:"
"DOTA_Siltbreaker_ContinueSpeechText"	"Hazır"
"[english]DOTA_Siltbreaker_ContinueSpeechText"	"Ready"
"DOTA_Siltbreaker_PreviousZone"	"Önceki Bölge"
"[english]DOTA_Siltbreaker_PreviousZone"	"Previous Zone"
"DOTA_Siltbreaker_NextZone"	"Sonraki Bölge"
"[english]DOTA_Siltbreaker_NextZone"	"Next Zone"
"DOTA_Siltbreaker_Disconnect"	"Ayrıl"
"[english]DOTA_Siltbreaker_Disconnect"	"Leave"
"DOTA_Siltbreaker_Continue"	"Devam et"
"[english]DOTA_Siltbreaker_Continue"	"Continue"
"DOTA_Siltbreaker_Failure"	"Başarısız oldun"
"[english]DOTA_Siltbreaker_Failure"	"You have Failed"
"DOTA_Siltbreaker_Success"	"Rhyzik'i Mağlup Ettiniz<br> Bölüm I Tamamlandı"
"[english]DOTA_Siltbreaker_Success"	"You Have Defeated Rhyzik!<br> Act I Complete"
"DOTA_Siltbreaker_Success_actii"	"Siltbreaker'ı Mağlup Ettiniz!"
"[english]DOTA_Siltbreaker_Success_actii"	"You Have Defeated Siltbreaker!"
"DOTA_Siltbreaker_RelicsButton"	"Eserler"
"[english]DOTA_Siltbreaker_RelicsButton"	"Artifacts"
"DOTA_Siltbreaker_PersonalBestTime"	"Kişisel En İyi: {s:best_time}"
"[english]DOTA_Siltbreaker_PersonalBestTime"	"Personal Best: {s:best_time}"
"DOTA_Siltbreaker_hud_respawn_remcount"	"Kalan Canlanma"
"[english]DOTA_Siltbreaker_hud_respawn_remcount"	"Respawns Remaining"
"DOTA_Tooltip_ability_item_gravel_foot_Description"	"Gerekli seviye: %required_level%\n\n"
"[english]DOTA_Tooltip_ability_item_gravel_foot_Description"	"Required Level: %required_level%\n\n"
"DOTA_Tooltip_ability_item_gravel_foot_bonus_hp_regen"	"FAZLADAN SAĞLIK YENİLEME:"
"[english]DOTA_Tooltip_ability_item_gravel_foot_bonus_hp_regen"	"BONUS HP REGEN:"
"npc_dota_weather_dummy"	"Bonefrost"
"[english]npc_dota_weather_dummy"	"Bonefrost"
"npc_dota_creature_spectral_tusk"	"Odobenus Wraith"
"[english]npc_dota_creature_spectral_tusk"	"Odobenus Wraith"
"npc_dota_creature_spectral_tusk_skeleton"	"Odobenus Ghoul"
"[english]npc_dota_creature_spectral_tusk_skeleton"	"Odobenus Ghoul"
"npc_dota_creature_icy_tusk_skeleton"	"Odobenus Frost Mage"
"[english]npc_dota_creature_icy_tusk_skeleton"	"Odobenus Frost Mage"
"npc_dota_undead_tusk_tombstone"	"Odobenus Tombstone"
"[english]npc_dota_undead_tusk_tombstone"	"Odobenus Tombstone"
"npc_dota_creature_tusk_skeleton"	"Odobenus Footman"
"[english]npc_dota_creature_tusk_skeleton"	"Odobenus Footman"
"npc_dota_creature_undead_ogre_seal"	"Odobenus Ogre Seal"
"[english]npc_dota_creature_undead_ogre_seal"	"Odobenus Ogre Seal"
"crypt_holdout"	"The Odobenus Onslaught"
"[english]crypt_holdout"	"The Odobenus Onslaught"
"speak_to_naga"	"Slithereen Sürgününü selamlayın"
"[english]speak_to_naga"	"Greet the Slithereen Exile"
"learn_about_crypt_holdout"	"Slithereen Sürgünü ile konuşun"
"[english]learn_about_crypt_holdout"	"Speak to the Slithereen Exile"
"escape_crypt_holdout"	"Mahzenden kaçın"
"[english]escape_crypt_holdout"	"Escape the Crypt"
"Dialog_Naga_LearnAboutCryptHoldout_02"	"Kaçmak için taht odasındaki 4 mührü de çözmelisiniz."
"[english]Dialog_Naga_LearnAboutCryptHoldout_02"	"To escape, you must unlock each of the four seals in the throne room."
"Dialog_Naga_LearnAboutCryptHoldout_03"	"Kapıyı indirmek için her bir mührün üzerinde yeteri kadar bekleyin. Dört mühür de çözüldüğünde kapı açılacaktır."
"[english]Dialog_Naga_LearnAboutCryptHoldout_03"	"Stand on each seal long enough to lower the door. When all four have been unlocked, the path will open."
"npc_dota_creature_octopus"	"Abraham"
"[english]npc_dota_creature_octopus"	"Abraham"
"Dialog_Octopus_Greeting"	"Hey, sen! Gel buraya..."
"[english]Dialog_Octopus_Greeting"	"Hey, you! Over here..."
"Dialog_Octopus_Greeting_sven"	"Sven?! Sen misin?"
"[english]Dialog_Octopus_Greeting_sven"	"Sven?! Is that you?"
"Dialog_Octopus_Greeting_tidehunter"	"Tidehunter! Seni bir daha hiç göremeyeceğimi düşünmüştüm."
"[english]Dialog_Octopus_Greeting_tidehunter"	"Tidehunter! Thought I'd never see you again."
"Dialog_Octopus_Greeting_weaver"	"Etkileyici bacakların var!"
"[english]Dialog_Octopus_Greeting_weaver"	"Impressive set of legs you've got there!"
"Dialog_Octopus_Greeting_witchdoctor"	"Hey! Doktor olduğunuzu duydum, doğru mu?"
"[english]Dialog_Octopus_Greeting_witchdoctor"	"Hey! Did I hear it right that you're a doctor?"
"Dialog_Octopus_Greeting_vengefulspirit"	"Hey çocuk, neşelen haydi. Hayat o kadar da kötü değil."
"[english]Dialog_Octopus_Greeting_vengefulspirit"	"Hey, perk up, kid. Life ain't all bad."
"Dialog_Octopus_Greeting_legion_commander"	"Sen! Evet, sen! Buraya gel. Şimdi!"
"[english]Dialog_Octopus_Greeting_legion_commander"	"You! Yeah, you! Get over here. Now!"
"Dialog_Octopus_Greeting_drow_ranger"	"Vav, oldukça kötü yanmışsın!"
"[english]Dialog_Octopus_Greeting_drow_ranger"	"Wow, that's some wicked sunburn!"
"Dialog_Octopus_Greeting_windrunner"	"Hey, nereye kaçıyorsun?"
"[english]Dialog_Octopus_Greeting_windrunner"	"Hey, where you running off to?"
"Dialog_Octopus_Story"	"Buralarda pek tanıdık yüz göremiyoruz."
"[english]Dialog_Octopus_Story"	"Don't see too many friendly faces down here."
"Dialog_Octopus_Story_02"	"Bulunduğum ortama uyum sağlayacak kadar oldukça fazla zaman geçirdim..."
"[english]Dialog_Octopus_Story_02"	"Spend a lot of time blending in with my surroundings..."
"Dialog_Octopus_Story_03"	"Her neyse, bu yoldan gitmek istediğinize emin misiniz?"
"[english]Dialog_Octopus_Story_03"	"Anyway, you sure you want to go that way?"
"Dialog_Octopus_Story_04"	"Karanlık Resif'e oldukça yaklaşıyorsunuz..."
"[english]Dialog_Octopus_Story_04"	"Getting really close to Dark Reef..."
"Dialog_Octopus_Story_05"	"Orada korkunç, her zamankinden daha kötü, bir şey olduğu söyleniyor."
"[english]Dialog_Octopus_Story_05"	"Word on the currents says something bad--worse than usual--is going down in there."
"Dialog_Octopus_Story_06"	"Beni yanlış anlamayın. Yaptığınız iş sizi ilgilendirir."
"[english]Dialog_Octopus_Story_06"	"Don't get me wrong. Your business is your business."
"Dialog_Octopus_Story_07"	"Sadece, Karanlık Resif'e kendi kararıyla giden birisini hiç görmedim..."
"[english]Dialog_Octopus_Story_07"	"Just never seen anyone go into Dark Reef of their own accord..."
"Dialog_Octopus_Story_08"	"Fakat size eşlik etmekten memnuniyet duyarım!"
"[english]Dialog_Octopus_Story_08"	"But I'm happy for the company!"
"Dialog_Octopus_Story_09"	"Burada entelektüel konuşmalar pek yapılmaz."
"[english]Dialog_Octopus_Story_09"	"This place lacks quality conversationalists."
"Dialog_Octopus_Story_20"	"Bak ne diyeceğim-- Oh, üzgünüm böldüm. Devam edin?"
"[english]Dialog_Octopus_Story_20"	"But I'll tell you what-- Oh, sorry, I interrupted. Go on?"
"Dialog_Octopus_Story_bye_04"	"Her neyse, görüşürüz."
"[english]Dialog_Octopus_Story_bye_04"	"Anyway, see you around."
"reefs_edge"	"Resifin Eşiği"
"[english]reefs_edge"	"Reef's Edge"
"npc_dota_creature_amoeba_boss"	"Giant Amoeboid"
"[english]npc_dota_creature_amoeba_boss"	"Giant Amoeboid"
"npc_dota_creature_sub_amoeba_boss"	"Amoebite"
"[english]npc_dota_creature_sub_amoeba_boss"	"Amoebite"
"kill_amoeba"	"Giant Amoeboid'i öldür"
"[english]kill_amoeba"	"Destroy the Giant Amoeboid"
"dark_reef_a"	"Batık Geçit"
"[english]dark_reef_a"	"Sunken Passage"
"npc_dota_creature_coral_furryfish"	"Omera"
"[english]npc_dota_creature_coral_furryfish"	"Omera"
"Dialog_CoralFurryfish_Greeting"	"Daha önce hiç bu kadar güzel bir gün görmüş müydünüz?"
"[english]Dialog_CoralFurryfish_Greeting"	"Have you ever seen such a beautiful day?"
"dark_reef_b"	"Karanlık Resif Hapishanesi"
"[english]dark_reef_b"	"Dark Reef Prison"
"unlock_prison_cells"	"Hapishane hücrelerini inceleyin"
"[english]unlock_prison_cells"	"Explore the prison cells"
"DOTA_Tooltip_Ability_item_prison_cell_key"	"Hapishane Hücresi Anahtarı"
"[english]DOTA_Tooltip_Ability_item_prison_cell_key"	"Prison Cell Key"
"npc_dota_creature_gaoler"	"Galvanite Gaoler"
"[english]npc_dota_creature_gaoler"	"Galvanite Gaoler"
"npc_dota_creature_prisoner_crab"	"Reefbottom Ravager"
"[english]npc_dota_creature_prisoner_crab"	"Reefbottom Ravager"
"npc_dota_creature_meranth_guard"	"Reefwatch Thrall"
"[english]npc_dota_creature_meranth_guard"	"Reefwatch Thrall"
"silt_arena"	"Siltbreaker"
"[english]silt_arena"	"Siltbreaker"
"npc_dota_creature_siltbreaker"	"Siltbreaker"
"[english]npc_dota_creature_siltbreaker"	"Siltbreaker"
"kill_siltbreaker"	"Siltbreaker'ı Yen"
"[english]kill_siltbreaker"	"Defeat Siltbreaker"
"npc_dota_creature_meranth_minion"	"Reefwatch Renegade"
"[english]npc_dota_creature_meranth_minion"	"Reefwatch Renegade"
"npc_dota_warden_note_01"	"Kayıt: 37. Gün, Yıl 118"
"[english]npc_dota_warden_note_01"	"Log: 37d 118ty"
"npc_dota_warden_note_02"	"Kayıt: 142. Gün, Yıl 118"
"[english]npc_dota_warden_note_02"	"Log: 142d 118ty"
"npc_dota_warden_note_03"	"Kayıt: 156. Gün, Yıl 118"
"[english]npc_dota_warden_note_03"	"Log: 156d 118ty"
"npc_dota_warden_note_04"	"Kayıt: 58. Gün, Yıl 136"
"[english]npc_dota_warden_note_04"	"Log: 58d 136ty"
"npc_dota_warden_note_05"	"Kayıt: 23. Gün, Yıl 159"
"[english]npc_dota_warden_note_05"	"Log: 23d 159ty"
"npc_dota_warden_note_06"	"Kayıt: 32. Gün, Yıl 159"
"[english]npc_dota_warden_note_06"	"Log: 32d 159ty"
"npc_dota_warden_note_07"	"Kayıt: 95. Gün, Yıl 159"
"[english]npc_dota_warden_note_07"	"Log: 95d 159ty"
"npc_dota_warden_note_08"	"Kayıt: 96. Gün, Yıl 159"
"[english]npc_dota_warden_note_08"	"Log: 96d 159ty"
"npc_dota_warden_note_09"	"Kayıt: 97. Gün, Yıl 159"
"[english]npc_dota_warden_note_09"	"Log: 97d 159ty"
"npc_dota_warden_note_10"	"Kayıt: 99. Gün, Yıl 159"
"[english]npc_dota_warden_note_10"	"Log: 99d 159ty"
"npc_dota_warden_note_11"	"Kayıt: 101. Gün, Yıl 159"
"[english]npc_dota_warden_note_11"	"Log: 101d 159ty"
"DOTA_Tooltip_ability_item_pocket_campfire"	"Taşınabilir Kamp Ateşi"
"[english]DOTA_Tooltip_ability_item_pocket_campfire"	"Pocket Campfire"
"DOTA_Tooltip_ability_item_pocket_campfire_Description"	"Isınmak için bunlardan birisini yere kurun. Bonefrost'un lanetini kaldırır."
"[english]DOTA_Tooltip_ability_item_pocket_campfire_Description"	"Place one of these in the world to warm up.  Cures the effects of Bonefrost."
"DOTA_Tooltip_modifier_pocket_campfire_effect"	"Taşınabilir Kamp Ateşinin Sıcaklığı"
"[english]DOTA_Tooltip_modifier_pocket_campfire_effect"	"Pocket Campfire Warmth"
"DOTA_Tooltip_modifier_pocket_campfire_effect_Description"	"Taşınabilir kamp ateşi sizi ısıtıyor, Bonefrost'tan koruyor ve saniyede 60 sağlık ve mana yeniliyor. 30 saniye sürer."
"[english]DOTA_Tooltip_modifier_pocket_campfire_effect_Description"	"The pocket campfire warms you, warding off the Bonefrost as well as regenerating 60 health and 60 mana per second. Expires after 30 seconds."
"DOTA_Tooltip_ability_frostbitten_shaman_buff"	"Disenchant"
"[english]DOTA_Tooltip_ability_frostbitten_shaman_buff"	"Disenchant"
"DOTA_Tooltip_ability_frostbitten_shaman_buff_Description"	"Yakındaki yaratıkları büyünün etkisinden kurtarır ve onları büyü bağışıklı yapar."
"[english]DOTA_Tooltip_ability_frostbitten_shaman_buff_Description"	"Disenchants nearby creatures, rendering them immune to magic."
"DOTA_Tooltip_modifier_frostbitten_shaman_buff"	"Büyü etkisinden kurtarıldı"
"[english]DOTA_Tooltip_modifier_frostbitten_shaman_buff"	"Disenchanted"
"DOTA_Tooltip_modifier_frostbitten_shaman_buff_Description"	"Büyü etkisinden kurtarılmış bu birim büyü bağışıklıdır."
"[english]DOTA_Tooltip_modifier_frostbitten_shaman_buff_Description"	"This disenchanted unit is immune to magic."
"DOTA_Tooltip_modifier_weather_snowstorm_effect"	"Bonefrost"
"[english]DOTA_Tooltip_modifier_weather_snowstorm_effect"	"Bonefrost"
"DOTA_Tooltip_modifier_weather_snowstorm_effect_Description"	"Soğuğun kemiklerine işlediğini hissediyorsun ve saniye başına 60 hasar alıyorsun. Donarak ölmeden önce bir ısı kaynağı bul."
"[english]DOTA_Tooltip_modifier_weather_snowstorm_effect_Description"	"You feel the cold seeping into your bones, causing 60 damage per second. Find a source of warmth before you freeze to death."
"DOTA_Tooltip_modifier_weather_snowstorm_cold"	"Soğuk"
"[english]DOTA_Tooltip_modifier_weather_snowstorm_cold"	"Cold"
"DOTA_Tooltip_modifier_weather_snowstorm_cold_Description"	"Bu birim aşırı soğuğa maruz kaldı ve eğer ısınacak bir şey bulamazsa Boneforst'tan acı çekmeye başlayacak."
"[english]DOTA_Tooltip_modifier_weather_snowstorm_cold_Description"	"This unit is exposed to extreme cold and  will start to suffer from Bonefrost if it doesn't find warmth."
"DOTA_Tooltip_modifier_campfire_effect"	"Kamp Ateşi Isısı"
"[english]DOTA_Tooltip_modifier_campfire_effect"	"Campfire Warmth"
"DOTA_Tooltip_modifier_campfire_effect_Description"	"Kamp ateşi seni ısıtıyor, Boneforst'tan koruyor ve saniyede 30 sağlık ve 20 mana yeniliyor."
"[english]DOTA_Tooltip_modifier_campfire_effect_Description"	"The campfire warms you, warding off the Bonefrost as well as regenerating 30 health and 20 mana per second."
"DOTA_Tooltip_modifier_frostbitten_freezing_blast"	"Titriyor, daha Donmamış"
"[english]DOTA_Tooltip_modifier_frostbitten_freezing_blast"	"Chilled, not Frozen"
"DOTA_Tooltip_modifier_frostbitten_freezing_blast_Description"	"Omurganızdan aşağı bir titreme başlar, hareket ve saldırı hızınızı yavaşlatır."
"[english]DOTA_Tooltip_modifier_frostbitten_freezing_blast_Description"	"A shiver runs down your spine, slowing your move speed and attack speed."
"DOTA_Tooltip_modifier_siltbreaker_attack"	"Corrosion"
"[english]DOTA_Tooltip_modifier_siltbreaker_attack"	"Corrosion"
"DOTA_Tooltip_modifier_siltbreaker_attack_Description"	"Bu birimin zırhını büyük ölçüde azaltır."
"[english]DOTA_Tooltip_modifier_siltbreaker_attack_Description"	"This unit's armor is drastically reduced."
"DOTA_Tooltip_ability_siltbreaker_mind_control"	"Mind Control"
"[english]DOTA_Tooltip_ability_siltbreaker_mind_control"	"Mind Control"
"DOTA_Tooltip_ability_siltbreaker_mind_control_Description"	"Önemsiz varlıkların zihnini kontrol eder."
"[english]DOTA_Tooltip_ability_siltbreaker_mind_control_Description"	"Control the minds of lesser beings."
"DOTA_Tooltip_modifier_siltbreaker_mind_control"	"Mind Control"
"[english]DOTA_Tooltip_modifier_siltbreaker_mind_control"	"Mind Control"
"DOTA_Tooltip_modifier_siltbreaker_mind_control_Description"	"Bu birim daha büyük bir varlığın kontrolü altında."
"[english]DOTA_Tooltip_modifier_siltbreaker_mind_control_Description"	"This unit is under the command of a greater being."
"DOTA_Tooltip_modifier_siltbreaker_mind_control_movespeed_bonus"	"FAZLADAN HAREKET HIZI:"
"[english]DOTA_Tooltip_modifier_siltbreaker_mind_control_movespeed_bonus"	"BONUS MOVE SPEED:"
"DOTA_Tooltip_modifier_siltbreaker_mind_control_attackspeed_bonus"	"FAZLADAN SALDIRI HIZI:"
"[english]DOTA_Tooltip_modifier_siltbreaker_mind_control_attackspeed_bonus"	"BONUS ATTACK SPEED:"
"DOTA_Tooltip_modifier_siltbreaker_immune_physical"	"Physical Immunity"
"[english]DOTA_Tooltip_modifier_siltbreaker_immune_physical"	"Physical Immunity"
"DOTA_Tooltip_modifier_siltbreaker_immune_physical_Description"	"Bu birim fiziksel hasara karşı bağışıklı."
"[english]DOTA_Tooltip_modifier_siltbreaker_immune_physical_Description"	"This unit is immune to physical damage."
"DOTA_Tooltip_modifier_siltbreaker_immune_magical"	"Magical Immunity"
"[english]DOTA_Tooltip_modifier_siltbreaker_immune_magical"	"Magical Immunity"
"DOTA_Tooltip_modifier_siltbreaker_immune_magical_Description"	"Bu birim büyüsel hasara karşı bağışıklı."
"[english]DOTA_Tooltip_modifier_siltbreaker_immune_magical_Description"	"This unit is immune to magical damage."
"DOTA_Tooltip_ability_siltbreaker_waves"	"Waves"
"[english]DOTA_Tooltip_ability_siltbreaker_waves"	"Waves"
"DOTA_Tooltip_ability_siltbreaker_line_wave"	"Line Wave"
"[english]DOTA_Tooltip_ability_siltbreaker_line_wave"	"Line Wave"
"DOTA_Tooltip_ability_siltbreaker_mouth_beam"	"Mouth Beam"
"[english]DOTA_Tooltip_ability_siltbreaker_mouth_beam"	"Mouth Beam"
"DOTA_Tooltip_ability_siltbreaker_summon_clone"	"Summon Clone"
"[english]DOTA_Tooltip_ability_siltbreaker_summon_clone"	"Summon Clone"
"DOTA_Tooltip_ability_siltbreaker_summon_minions"	"Summon Minions"
"[english]DOTA_Tooltip_ability_siltbreaker_summon_minions"	"Summon Minions"
"DOTA_Tooltip_ability_siltbreaker_summon_minions_medium"	"Summon Minions Medium"
"[english]DOTA_Tooltip_ability_siltbreaker_summon_minions_medium"	"Summon Minions Medium"
"DOTA_Tooltip_ability_siltbreaker_kraken_shell"	"Kraken Shell"
"[english]DOTA_Tooltip_ability_siltbreaker_kraken_shell"	"Kraken Shell"
"DOTA_Tooltip_ability_siltbreaker_torrents"	"Torrents"
"[english]DOTA_Tooltip_ability_siltbreaker_torrents"	"Torrents"
"DOTA_Tooltip_ability_siltbreaker_sprint"	"Sprint"
"[english]DOTA_Tooltip_ability_siltbreaker_sprint"	"Sprint"
"DOTA_Tooltip_ability_siltbreaker_tail_spin_ccw"	"Tail Spin"
"[english]DOTA_Tooltip_ability_siltbreaker_tail_spin_ccw"	"Tail Spin"
"DOTA_Tooltip_ability_siltbreaker_go_phase_two"	"İkinci Aşamaya Geç"
"[english]DOTA_Tooltip_ability_siltbreaker_go_phase_two"	"Go Phase Two"
"DOTA_Tooltip_ability_siltbreaker_go_phase_three"	"Üçüncü Aşamaya Geç"
"[english]DOTA_Tooltip_ability_siltbreaker_go_phase_three"	"Go Phase Three"
"DOTA_Tooltip_ability_siltbreaker_teleport"	"Teleport"
"[english]DOTA_Tooltip_ability_siltbreaker_teleport"	"Teleport"
"DOTA_Tooltip_ability_weaver_the_swarm_dungeon"	"The Swarm"
"[english]DOTA_Tooltip_ability_weaver_the_swarm_dungeon"	"The Swarm"
"DOTA_Tooltip_ability_weaver_the_swarm_dungeon_Description"	"Weaver, yolları üzerindeki tüm düşman birimlerine tutunan 12 yavru Weaver gönderir. Bunlar öldürülene kadar hedef birimlere saldırır ve zırhlarını düşürür."
"[english]DOTA_Tooltip_ability_weaver_the_swarm_dungeon_Description"	"Weaver launches a swarm of 12 young Weavers that latch on any enemy unit in their path, attacking and reducing armor until it is killed."
"DOTA_Tooltip_ability_weaver_the_swarm_dungeon_Lore"	"Skitskurr zamanda bir boşluk yaratır ve genç Weaverların gerçekliği istila ederek kendisine yardım etmelerini sağlar."
"[english]DOTA_Tooltip_ability_weaver_the_swarm_dungeon_Lore"	"Skitskurr opens a gap in the space time fabric, allowing young Weavers to slip through and aid him in combat."
"DOTA_Tooltip_ability_weaver_the_swarm_dungeon_Note0"	"Bir böcek hedefe yapıştığında öldürülene ya da süresi dolana kadar orada kalır."
"[english]DOTA_Tooltip_ability_weaver_the_swarm_dungeon_Note0"	"When a beetle latches on a target, it will remain there until it is killed or the duration expires."
"DOTA_Tooltip_ability_weaver_the_swarm_dungeon_Note1"	"Böceklerin Büyü Bağışıklığı vardır fakat kahramanlar tarafından 4, diğer birimler tarafından 8 vuruşta öldürülebilir."
"[english]DOTA_Tooltip_ability_weaver_the_swarm_dungeon_Note1"	"Beetles are Spell Immune, but can be killed in 4 attacks from a hero, or 8 from other units."
"DOTA_Tooltip_ability_weaver_the_swarm_dungeon_Note2"	"Böcekler 321/321 görüş sağlar ancak hedefleri görünmez olursa düşerler."
"[english]DOTA_Tooltip_ability_weaver_the_swarm_dungeon_Note2"	"Beetles provide 321/321 sight, but will drop off their target if it becomes invisible."
"DOTA_Tooltip_ability_weaver_the_swarm_dungeon_damage"	"SALDIRI HASARI:"
"[english]DOTA_Tooltip_ability_weaver_the_swarm_dungeon_damage"	"ATTACK DAMAGE:"
"DOTA_Tooltip_ability_weaver_the_swarm_dungeon_attack_rate"	"SALDIRI SIKLIĞI:"
"[english]DOTA_Tooltip_ability_weaver_the_swarm_dungeon_attack_rate"	"ATTACK FREQUENCY:"
"DOTA_Tooltip_ability_weaver_the_swarm_dungeon_duration"	"SÜRE:"
"[english]DOTA_Tooltip_ability_weaver_the_swarm_dungeon_duration"	"DURATION:"
"DOTA_Tooltip_ability_weaver_the_swarm_dungeon_count"	"SAYISI:"
"[english]DOTA_Tooltip_ability_weaver_the_swarm_dungeon_count"	"COUNT:"
"DOTA_Tooltip_ability_weaver_the_swarm_dungeon_armor_reduction"	"ZIRH AZALTMA:"
"[english]DOTA_Tooltip_ability_weaver_the_swarm_dungeon_armor_reduction"	"ARMOR REDUCTION:"
"DOTA_Tooltip_ability_weaver_the_swarm_dungeon_destroy_attacks"	"YOK ETMEK İÇİN SALDIRI:"
"[english]DOTA_Tooltip_ability_weaver_the_swarm_dungeon_destroy_attacks"	"ATTACKS TO DESTROY:"
"DOTA_Tooltip_ability_gyrocopter_rocket_barrage_dungeon"	"Rocket Barrage"
"[english]DOTA_Tooltip_ability_gyrocopter_rocket_barrage_dungeon"	"Rocket Barrage"
"DOTA_Tooltip_ability_gyrocopter_rocket_barrage_dungeon_Description"	"Gyrocopter'ın etrafındaki birimlere roketlerle yaylım ateşi yapar. 3 saniye sürer."
"[english]DOTA_Tooltip_ability_gyrocopter_rocket_barrage_dungeon_Description"	"Launches a salvo of rockets at nearby enemy units in a radius around the Gyrocopter.  Lasts 3 seconds."
"DOTA_Tooltip_ability_gyrocopter_rocket_barrage_dungeon_Lore"	"Aurel'in yeni yeteneği ile roketlerin kapsül kapasitesi artmış ve onların daha seri ateşlenmesini sağlamıştır."
"[english]DOTA_Tooltip_ability_gyrocopter_rocket_barrage_dungeon_Lore"	"Aurel's new craft has an increased payload for rockets, enhancing their rapid-fire capabilities."
"DOTA_Tooltip_ability_gyrocopter_rocket_barrage_dungeon_Note0"	"Rocket Barrage Gyrocopter'ın göremediklerine isabet etmez."
"[english]DOTA_Tooltip_ability_gyrocopter_rocket_barrage_dungeon_Note0"	"Rocket Barrage can't hit units Gyrocopter has no vision over."
"DOTA_Tooltip_ability_gyrocopter_rocket_barrage_dungeon_rockets_per_second"	"SANİYE BAŞINA ROKET:"
"[english]DOTA_Tooltip_ability_gyrocopter_rocket_barrage_dungeon_rockets_per_second"	"ROCKETS PER SECOND:"
"DOTA_Tooltip_ability_gyrocopter_rocket_barrage_dungeon_radius"	"YARIÇAP:"
"[english]DOTA_Tooltip_ability_gyrocopter_rocket_barrage_dungeon_radius"	"RADIUS:"
"DOTA_Tooltip_ability_sniper_assassinate_dm2017"	"Assassinate"
"[english]DOTA_Tooltip_ability_sniper_assassinate_dm2017"	"Assassinate"
"DOTA_Tooltip_ability_sniper_assassinate_dm2017_Description"	"Sniper hedef düşman birime kilitlenir ve %total_cast_time_tooltip% saniye sonra uzun menzilden hasar veren ve kısa süreliğine sersemleten tahrip edici bir atış yapar. <font color='#70EA72'>Mermi hedefe çarptığında onu 3 saniyeliğine sersemletir ve bir koni şeklinde parçalanmasına neden olarak birincil hedefin arkasındakilere verdiği hasarın yarısını uygular.</font> \n\n Aghanim's Scepter ile geliştirilebilir."
"[english]DOTA_Tooltip_ability_sniper_assassinate_dm2017_Description"	"Sniper locks onto a target enemy unit and, after %total_cast_time_tooltip% seconds, fires a devastating shot that deals damage at long range. <font color='#70EA72'>When the shell strikes the target, it stuns it for 3s and causes a scatter shot in a cone, dealing half damage to targets behind the primary target.</font> \n\nUpgradable by Aghanim's Scepter."
"DOTA_Tooltip_ability_sniper_assassinate_aghanim_description"	"Assassinate yeteneğini zemini hedefleyen bir etki alanı yeteneğine çevirir, yönlendirme süresinin sonunda etki alanı içindeki birimlere kritik saldırı ve Headshot uygular. Sadece görünürdeki kahramanları etkiler."
"[english]DOTA_Tooltip_ability_sniper_assassinate_aghanim_description"	"Turns Assassinate into a ground target AoE ability, that after the channel period launches a critical strike and procs headshot on units in the AoE. Only affects visible heroes."
"DOTA_Tooltip_ability_sniper_assassinate_dm2017_Lore"	"Kehâneti yerine getirmek ve evine geri dönmek için Kardel'in, kadim testindeki gündeki gibi mükemmellikte başka bir atış yapması gerekmektedir."
"[english]DOTA_Tooltip_ability_sniper_assassinate_dm2017_Lore"	"In order to fulfill the prophecy and return to his home town, Kardel must make another shot as perfect as the one on the day of his ancient test."
"DOTA_Tooltip_ability_sniper_assassinate_dm2017_assassinate_damage"	"HASAR:"
"[english]DOTA_Tooltip_ability_sniper_assassinate_dm2017_assassinate_damage"	"DAMAGE:"
"DOTA_Tooltip_ability_sniper_assassinate_dm2017_scatter_range"	"DAĞILMA MENZİLİ:"
"[english]DOTA_Tooltip_ability_sniper_assassinate_dm2017_scatter_range"	"SCATTER RANGE:"
"DOTA_Tooltip_ability_sniper_assassinate_dm2017_Note0"	"Nişan göstergesi sadece dost birimlere görünür."
"[english]DOTA_Tooltip_ability_sniper_assassinate_dm2017_Note0"	"Crosshair effect is only visible to allies."
"DOTA_Tooltip_ability_sniper_assassinate_dm2017_Note1"	"Görünmezlik gelen saldırılardan kaçındırmaz."
"[english]DOTA_Tooltip_ability_sniper_assassinate_dm2017_Note1"	"Invisibility doesn't disjoint the projectile."
"DOTA_Tooltip_ability_sniper_assassinate_dm2017_Note2"	"Büyü Bağışıklı birimler de dahil olmak üzere yönlendirilen büyüleri bozar."
"[english]DOTA_Tooltip_ability_sniper_assassinate_dm2017_Note2"	"Interrupts channeling spell, including on Spell Immune units."
"DOTA_Tooltip_ability_sniper_assassinate_dm2017_tooltip_range"	"MENZİL:"
"[english]DOTA_Tooltip_ability_sniper_assassinate_dm2017_tooltip_range"	"RANGE:"
"DOTA_Tooltip_ability_sniper_assassinate_dm2017_scepter_radius"	"SCEPTER'LI YARIÇAP:"
"[english]DOTA_Tooltip_ability_sniper_assassinate_dm2017_scepter_radius"	"SCEPTER RADIUS:"
"DOTA_Tooltip_ability_sniper_assassinate_dm2017_scepter_crit_bonus"	"%SCEPTER'LI KRİTİK ŞANSI:"
"[english]DOTA_Tooltip_ability_sniper_assassinate_dm2017_scepter_crit_bonus"	"%SCEPTER CRITICAL DAMAGE:"
"DOTA_Tooltip_ability_zuus_arc_lightning_dungeon"	"Arc Lightning"
"[english]DOTA_Tooltip_ability_zuus_arc_lightning_dungeon"	"Arc Lightning"
"DOTA_Tooltip_ability_zuus_arc_lightning_dungeon_Description"	"Yakındaki düşman birimleri arasında seken bir şimşek gönderir."
"[english]DOTA_Tooltip_ability_zuus_arc_lightning_dungeon_Description"	"Hurls a bolt of lightning that leaps through nearby enemy units."
"DOTA_Tooltip_ability_zuus_arc_lightning_dungeon_Lore"	"Arc Lightning, Zeus'un acınası fanilere karşı kullanmayı en sevdiği büyüdür."
"[english]DOTA_Tooltip_ability_zuus_arc_lightning_dungeon_Lore"	"Arc Lightning is Zeus' favorite spell to use against puny mortals."
"DOTA_Tooltip_ability_zuus_arc_lightning_dungeon_jump_count"	"SIÇRAMA:"
"[english]DOTA_Tooltip_ability_zuus_arc_lightning_dungeon_jump_count"	"JUMPS:"
"DOTA_Tooltip_ability_zuus_static_field_dark_moon"	"Static Field"
"[english]DOTA_Tooltip_ability_zuus_static_field_dark_moon"	"Static Field"
"DOTA_Tooltip_ability_zuus_static_field_dark_moon_Description"	"Zeus her büyü kullandığında yakınlardaki düşman birimlerine elektrik şoku uygular ve bu şok onların mevcut sağlıklarının belirli bir oranı kadar hasar verir."
"[english]DOTA_Tooltip_ability_zuus_static_field_dark_moon_Description"	"Zeus shocks all nearby enemy units whenever he casts a spell, causing damage proportional to their current health."
"DOTA_Tooltip_ability_zuus_static_field_dark_moon_Lore"	"Thundergod dünya üzerinde yürüdükçe hava statik ile çatırdar."
"[english]DOTA_Tooltip_ability_zuus_static_field_dark_moon_Lore"	"The air crackles with static when the Thundergod walks the world."
"DOTA_Tooltip_ability_zuus_static_field_dark_moon_Note0"	"Static Field tarafından verilen hasar büyü kullanılmadan önce verilir."
"[english]DOTA_Tooltip_ability_zuus_static_field_dark_moon_Note0"	"The damage from Static Field is dealt before the damage from the used spell."
"DOTA_Tooltip_ability_zuus_static_field_dark_moon_Note1"	"Eşyaları kullanmak Static Field'ı tetiklemez."
"[english]DOTA_Tooltip_ability_zuus_static_field_dark_moon_Note1"	"Using items doesn't trigger Static Field."
"DOTA_Tooltip_ability_zuus_static_field_dark_moon_Note2"	"Birimlerin etkilenmeleri için görünür olmalarına gerek yoktur."
"[english]DOTA_Tooltip_ability_zuus_static_field_dark_moon_Note2"	"Does not require unit visibility to take effect."
"DOTA_Tooltip_ability_zuus_static_field_dark_moon_damage_health_pct"	"%SAĞLIK AZALTMA:"
"[english]DOTA_Tooltip_ability_zuus_static_field_dark_moon_damage_health_pct"	"%HEALTH REDUCTION:"
"DOTA_Tooltip_ability_zuus_static_field_dark_moon_radius"	"MENZİL:"
"[english]DOTA_Tooltip_ability_zuus_static_field_dark_moon_radius"	"RANGE:"
"DOTA_Tooltip_ability_zeus_thundergods_wrath_nb2017"	"Thundergod's Salvation"
"[english]DOTA_Tooltip_ability_zeus_thundergods_wrath_nb2017"	"Thundergod's Salvation"
"DOTA_Tooltip_ability_zeus_thundergods_wrath_nb2017_Description"	"<font color='#70EA72'>Zeus, her bir dost kahramanı koruması için hareketsiz bir Bulut indirir. Her bir Bulut, Zeus'un mevcut Lightning Bolt seviyesi kadar hasar verir.</font>"
"[english]DOTA_Tooltip_ability_zeus_thundergods_wrath_nb2017_Description"	"<font color='#70EA72'>Zeus calls down an immobile Cloud for each allied hero for protection.  Each Cloud attacks nearby enemies using Zeus' current level of Lightning Bolt.</font>"
"DOTA_Tooltip_ability_zeus_thundergods_wrath_nb2017_Lore"	"Cennetin Lordu ona yakın veya uzak olan herkesi çarpar."
"[english]DOTA_Tooltip_ability_zeus_thundergods_wrath_nb2017_Lore"	"The Lord of Heaven smites all who oppose him, near or far."
"DOTA_Tooltip_ability_zeus_thundergods_wrath_nb2017_cloud_duration"	"BULUT SÜRESİ:"
"[english]DOTA_Tooltip_ability_zeus_thundergods_wrath_nb2017_cloud_duration"	"CLOUD DURATION:"
"DOTA_Tooltip_ability_zeus_thundergods_wrath_nb2017_cloud_bolt_interval"	"BULUT SALDIRISI ZAMAN ARALIĞI:"
"[english]DOTA_Tooltip_ability_zeus_thundergods_wrath_nb2017_cloud_bolt_interval"	"CLOUD STRIKE INTERVAL:"
"DOTA_Tooltip_ability_leshrac_split_earth_dungeon"	"Split Earth"
"[english]DOTA_Tooltip_ability_leshrac_split_earth_dungeon"	"Split Earth"
"DOTA_Tooltip_ability_leshrac_split_earth_dungeon_Description"	"Düşmanların bastığı toprağı parçalar. Hasar verir ve kısa bir süre sersemletir."
"[english]DOTA_Tooltip_ability_leshrac_split_earth_dungeon_Description"	"Splits the earth under enemies. Deals damage and stuns for a short duration."
"DOTA_Tooltip_ability_leshrac_split_earth_dungeon_Lore"	"Doğayı kendi habis istekleri için büken Leshrac, yoluna çıkacak kadar şanssız olanları kayan toprağa gömer."
"[english]DOTA_Tooltip_ability_leshrac_split_earth_dungeon_Lore"	"Twisting nature to his vile will, the shifting earth consumes those unlucky enough to cross Leshrac's path."
"DOTA_Tooltip_ability_leshrac_split_earth_dungeon_Note0"	"Split Earth etkilediği alandaki ağaçları yok eder."
"[english]DOTA_Tooltip_ability_leshrac_split_earth_dungeon_Note0"	"Split Earth will destroy trees in its area of effect."
"DOTA_Tooltip_ability_leshrac_split_earth_dungeon_Note1"	"Etki uygulanmadan önce 0.35 saniyelik bir gecikme yaşanır."
"[english]DOTA_Tooltip_ability_leshrac_split_earth_dungeon_Note1"	"There is a 0.35 second delay before the effect is applied."
"DOTA_Tooltip_ability_leshrac_split_earth_dungeon_radius"	"YARIÇAP:"
"[english]DOTA_Tooltip_ability_leshrac_split_earth_dungeon_radius"	"RADIUS:"
"DOTA_Tooltip_ability_leshrac_split_earth_dungeon_duration"	"SERSEMLETME SÜRESİ:"
"[english]DOTA_Tooltip_ability_leshrac_split_earth_dungeon_duration"	"STUN DURATION:"
"DOTA_Tooltip_ability_leshrac_split_earth_dungeon_delay"	"SERSEMLETME GECİKMESİ:"
"[english]DOTA_Tooltip_ability_leshrac_split_earth_dungeon_delay"	"STUN DELAY:"
"DOTA_Tooltip_ability_leshrac_diabolic_edict_dungeon"	"Diabolic Edict"
"[english]DOTA_Tooltip_ability_leshrac_diabolic_edict_dungeon"	"Diabolic Edict"
"DOTA_Tooltip_ability_leshrac_diabolic_edict_dungeon_Description"	"Leshrac'ın çevresindeki bölgeyi, düşman birimlere ve binalara fiziksel hasar veren büyülü bir bombardımana tutar. Etrafta ne kadar az birim varsa o birimler o kadar fazla hasar alır. Kulelere %%%tower_bonus% daha fazla hasar verir. %duration_tooltip% saniye sürer."
"[english]DOTA_Tooltip_ability_leshrac_diabolic_edict_dungeon_Description"	"Saturates the area around Leshrac with magical explosions that deal physical damage to enemy units and structures.  The fewer units available to attack, the more damage those units will take.  Deals %tower_bonus%%% more damage to towers.  Lasts %duration_tooltip% seconds."
"DOTA_Tooltip_ability_leshrac_diabolic_edict_dungeon_Lore"	"Dokunduğu her şeyi buharlaştıran zamansal enerjiler bir boyuttan diğerine patlayarak fırlar."
"[english]DOTA_Tooltip_ability_leshrac_diabolic_edict_dungeon_Lore"	"Chronoptic energy bursts from one plane to the other, evaporating anything it touches."
"DOTA_Tooltip_ability_leshrac_diabolic_edict_dungeon_Note0"	"Hasar, hasar engeli tarafından azaltılamaz."
"[english]DOTA_Tooltip_ability_leshrac_diabolic_edict_dungeon_Note0"	"Damage is not reduced by damage block."
"DOTA_Tooltip_ability_leshrac_diabolic_edict_dungeon_Note1"	"Leshrac ölse bile patlamalar devam edecektir."
"[english]DOTA_Tooltip_ability_leshrac_diabolic_edict_dungeon_Note1"	"The explosions will continue even if Leshrac is killed."
"DOTA_Tooltip_ability_leshrac_diabolic_edict_dungeon_Note2"	"Yapılara, Büyü Bağışıklığı olan birimlere ve gizlenmiş birimlere hasar verebilir."
"[english]DOTA_Tooltip_ability_leshrac_diabolic_edict_dungeon_Note2"	"Can damage buildings, Spell Immune units, and invisible units."
"DOTA_Tooltip_ability_leshrac_diabolic_edict_dungeon_radius"	"YARIÇAP:"
"[english]DOTA_Tooltip_ability_leshrac_diabolic_edict_dungeon_radius"	"RADIUS:"
"DOTA_Tooltip_ability_leshrac_diabolic_edict_dungeon_num_explosions"	"PATLAMALAR:"
"[english]DOTA_Tooltip_ability_leshrac_diabolic_edict_dungeon_num_explosions"	"EXPLOSIONS:"
"DOTA_Tooltip_ability_leshrac_lightning_storm_dungeon"	"Lightning Storm"
"[english]DOTA_Tooltip_ability_leshrac_lightning_storm_dungeon"	"Lightning Storm"
"DOTA_Tooltip_ability_leshrac_lightning_storm_dungeon_Description"	"Düşman birimine hasar veren ve çevredeki birimlere geçen bir yıldırım fırtınası yaratır. Çarpılan düşmanlar yavaşlatılır.\n\nAghanim's Scepter ile geliştirilebilir."
"[english]DOTA_Tooltip_ability_leshrac_lightning_storm_dungeon_Description"	"Summons a lightning storm that blasts the target enemy unit, then strikes any nearby enemy units. Struck enemies are slowed.\n\nUpgradable by Aghanim's Scepter."
"DOTA_Tooltip_ability_leshrac_lightning_storm_dungeon_Lore"	"Tormented Soul'un elementler üstündeki ustalığını, karşısında heybetli kasırgalarla yok olan ordulara sorabilirsin."
"[english]DOTA_Tooltip_ability_leshrac_lightning_storm_dungeon_Lore"	"The Tormented Soul's mastery of the elements is evident in the massive storms that strike down armies before him."
"DOTA_Tooltip_ability_leshrac_lightning_storm_dungeon_jump_count"	"YILDIRIM VURUŞLARI:"
"[english]DOTA_Tooltip_ability_leshrac_lightning_storm_dungeon_jump_count"	"LIGHTNING STRIKES:"
"DOTA_Tooltip_ability_leshrac_lightning_storm_dungeon_slow_movement_speed"	"%HAREKET YAVAŞLATMA:"
"[english]DOTA_Tooltip_ability_leshrac_lightning_storm_dungeon_slow_movement_speed"	"%MOVEMENT SLOW:"
"DOTA_Tooltip_ability_leshrac_lightning_storm_dungeon_slow_duration"	"YAVAŞLATMA SÜRESİ:"
"[english]DOTA_Tooltip_ability_leshrac_lightning_storm_dungeon_slow_duration"	"SLOW DURATION:"
"DOTA_Tooltip_ability_leshrac_lightning_storm_dungeon_radius"	"YILDIRIM SEKME YARIÇAPI:"
"[english]DOTA_Tooltip_ability_leshrac_lightning_storm_dungeon_radius"	"LIGHTNING JUMP RADIUS:"
"DOTA_Tooltip_ability_leshrac_lightning_storm_dungeon_interval_scepter"	"SCEPTER'LI ARALIK:"
"[english]DOTA_Tooltip_ability_leshrac_lightning_storm_dungeon_interval_scepter"	"SCEPTER INTERVAL:"
"DOTA_Tooltip_ability_leshrac_lightning_storm_dungeon_radius_scepter"	"SCEPTER'LI YARIÇAP:"
"[english]DOTA_Tooltip_ability_leshrac_lightning_storm_dungeon_radius_scepter"	"SCEPTER RADIUS:"
"DOTA_Tooltip_ability_leshrac_lightning_storm_dungeon_aghanim_description"	"Pulse Nova etkinken Lightning Storm her 1.75 saniyede bir yarıçapı içindeki rastgele bir birime vuracaktır."
"[english]DOTA_Tooltip_ability_leshrac_lightning_storm_dungeon_aghanim_description"	"While Pulse Nova is active, Lightning Storm will hit one random unit in a radius every 1.75 seconds."
"DOTA_Tooltip_ability_leshrac_pulse_nova_dungeon"	"Pulse Nova"
"[english]DOTA_Tooltip_ability_leshrac_pulse_nova_dungeon"	"Pulse Nova"
"DOTA_Tooltip_ability_leshrac_pulse_nova_dungeon_Description"	"Leshrac'ın çevresinde, saniyede bir olmak üzere, enerji dalgaları oluşturur. Bu dalgalar düşmanlara hasar verir."
"[english]DOTA_Tooltip_ability_leshrac_pulse_nova_dungeon_Description"	"Creates waves of damaging energy around Leshrac, one per second, to damage nearby enemy units."
"DOTA_Tooltip_ability_leshrac_pulse_nova_dungeon_Lore"	"Eğer gerekirse, Tormented Soul uzay-zamanı kontrol edebilir ve kendinden küçük varlıklara hasar verir."
"[english]DOTA_Tooltip_ability_leshrac_pulse_nova_dungeon_Lore"	"If necessary, the Tormented Soul can manipulate space time itself, ravaging lesser beings."
"DOTA_Tooltip_ability_leshrac_pulse_nova_dungeon_radius"	"YARIÇAP:"
"[english]DOTA_Tooltip_ability_leshrac_pulse_nova_dungeon_radius"	"RADIUS:"
"DOTA_Tooltip_ability_leshrac_pulse_nova_dungeon_mana_cost_per_second"	"MANA/SANİYE:"
"[english]DOTA_Tooltip_ability_leshrac_pulse_nova_dungeon_mana_cost_per_second"	"MANA/SEC:"
"DOTA_Tooltip_ability_leshrac_pulse_nova_dungeon_damage"	"HASAR:"
"[english]DOTA_Tooltip_ability_leshrac_pulse_nova_dungeon_damage"	"DAMAGE:"
"DOTA_Tooltip_ability_medusa_split_shot"	"Split Shot"
"[english]DOTA_Tooltip_ability_medusa_split_shot"	"Split Shot"
"DOTA_Tooltip_ability_medusa_split_shot_Description"	"Medusa, atışlarını birkaç oka dönüştürür. Bu oklar, normal hasarına göre düşük seviyede hasar verirler.\n\nDiğer hedefler, özel saldırı etkilerinden (kritik saldırı gibi) ve Eşsiz Saldırı Eklentilerinden etkilenmezler."
"[english]DOTA_Tooltip_ability_medusa_split_shot_Description"	"Medusa magically splits her shot into several arrows. These arrows deal a lower percent of her normal damage.\n\nThe extra targets will not receive other attack effects (such as critical strike) and Unique Attack Modifiers."
"DOTA_Tooltip_ability_medusa_split_shot_Lore"	"Lanetlenmiş Gorgon ile karşılaşan her kim ise, onun gazabından korkacak."
"[english]DOTA_Tooltip_ability_medusa_split_shot_Lore"	"All who encounter the cursed Gorgon will feel her rage."
"DOTA_Tooltip_ability_medusa_split_shot_Note0"	"ikincil hedefler  birincil hedefin dışında kalan en yakındaki düşman birimleridir."
"[english]DOTA_Tooltip_ability_medusa_split_shot_Note0"	"Secondary targets will be the closest enemy units excluding the primary target."
"DOTA_Tooltip_ability_medusa_split_shot_Note1"	"Eğer Medusa'nın illüzyonları Split Shot aktif iken yaratılmışsa, onlar da bu yeteneğe sahip olacaklardır."
"[english]DOTA_Tooltip_ability_medusa_split_shot_Note1"	"If illusions of Medusa are created while Split Shot is active, they will also have this ability."
"DOTA_Tooltip_ability_medusa_split_shot_damage_modifier_tooltip"	"%GİDEN HASAR:"
"[english]DOTA_Tooltip_ability_medusa_split_shot_damage_modifier_tooltip"	"%OUTGOING DAMAGE:"
"DOTA_Tooltip_ability_medusa_split_shot_total_arrow_count"	"HEDEF SAYISI:"
"[english]DOTA_Tooltip_ability_medusa_split_shot_total_arrow_count"	"ARROWS:"
"DOTA_Tooltip_ability_medusa_split_shot_range"	"MENZİL:"
"[english]DOTA_Tooltip_ability_medusa_split_shot_range"	"RANGE:"
"DOTA_Tooltip_ability_medusa_mystic_snake_dm2017"	"Mystic Snake"
"[english]DOTA_Tooltip_ability_medusa_mystic_snake_dm2017"	"Mystic Snake"
"DOTA_Tooltip_ability_medusa_mystic_snake_dm2017_Description"	"Mystic snake, hedeften hedefe atlayan, hasar veren ve biraz mana çalan enerjiden oluşmuştur ve <font color='#70EA72'>birimleri taşa çevirir</font>. Son hedefine ulaştıktıktan sonra Medusa'ya geri dönerek Medusa'yı mana ile doldurur. Yılan, her atlamada daha fazla hasar verir ve hedefin toplam manasının %%%snake_mana_steal% kadarını çalar."
"[english]DOTA_Tooltip_ability_medusa_mystic_snake_dm2017_Description"	"A mystic snake made of energy jumps from target to target dealing damage, stealing mana, <font color='#70EA72'>and turning units to stone</font>. After it reaches its last target, it returns to Medusa to replenish her with mana. The snake deals more damage per jump and steals %snake_mana_steal%%% of the targets' total mana."
"DOTA_Tooltip_ability_medusa_mystic_snake_dm2017_Lore"	"Gorgon'un laneti onun en güçlü özelliğiydi."
"[english]DOTA_Tooltip_ability_medusa_mystic_snake_dm2017_Lore"	"The Gorgon's curse is her greatest strength."
"DOTA_Tooltip_ability_medusa_mystic_snake_dm2017_Note0"	"Mystic Snake'te kaçınılamaz."
"[english]DOTA_Tooltip_ability_medusa_mystic_snake_dm2017_Note0"	"Mystic Snake cannot be disjointed."
"DOTA_Tooltip_ability_medusa_mystic_snake_dm2017_radius"	"SIÇRAMA YARIÇAPI:"
"[english]DOTA_Tooltip_ability_medusa_mystic_snake_dm2017_radius"	"JUMP RADIUS:"
"DOTA_Tooltip_ability_medusa_mystic_snake_dm2017_snake_jumps"	"SIÇRAMA:"
"[english]DOTA_Tooltip_ability_medusa_mystic_snake_dm2017_snake_jumps"	"JUMPS:"
"DOTA_Tooltip_ability_medusa_mystic_snake_dm2017_snake_damage"	"HASAR:"
"[english]DOTA_Tooltip_ability_medusa_mystic_snake_dm2017_snake_damage"	"DAMAGE:"
"DOTA_Tooltip_ability_medusa_mystic_snake_dm2017_snake_scale"	"%SIÇRAMA BAŞINA HASAR ARTIŞI:"
"[english]DOTA_Tooltip_ability_medusa_mystic_snake_dm2017_snake_scale"	"%DAMAGE INCREASE PER JUMP:"
"DOTA_Tooltip_ability_medusa_mystic_snake_dm2017_snake_mana_steal"	"%MANA ÇALMA:"
"[english]DOTA_Tooltip_ability_medusa_mystic_snake_dm2017_snake_mana_steal"	"%MANA STEAL:"
"DOTA_Tooltip_ability_treant_leech_seed_nb2017"	"Leech Seed"
"[english]DOTA_Tooltip_ability_treant_leech_seed_nb2017"	"Leech Seed"
"DOTA_Tooltip_ability_treant_leech_seed_nb2017_Description"	"<font color='#70EA72'>Dolum süresi hazır olduğunda Leech Seed, Treant'in bir sonraki saldırısında</font> düşman birime hayat emici tohum ekerek canını emer ve yavaşlatır. Tohum çevresindeki dost birimleri iyileştirir. 6 kez atar."
"[english]DOTA_Tooltip_ability_treant_leech_seed_nb2017_Description"	"<font color='#70EA72'>When the cooldown is ready, Leech Seed causes Treant's next attack to</font> plant a life-sapping seed in an enemy unit, draining its health, while simultaneously slowing it. The seed heals friendly units around it.  Pulses 6 times."
"DOTA_Tooltip_ability_treant_leech_seed_nb2017_Lore"	"Rooftrellen kutsal topraklarına kaçak girenlerin hayat güçleri ile devamlılığını sağladığı gözetimi altındaki varlıkları yetiştirir."
"[english]DOTA_Tooltip_ability_treant_leech_seed_nb2017_Lore"	"Rooftrellen nurtures the beings under his stewardship, sustained by the lifeforce of trespassers into his sacred ground."
"DOTA_Tooltip_ability_treant_leech_seed_nb2017_leech_damage"	"NABIZ BAŞINA HASAR:"
"[english]DOTA_Tooltip_ability_treant_leech_seed_nb2017_leech_damage"	"DAMAGE PER PULSE:"
"DOTA_Tooltip_ability_treant_leech_seed_nb2017_movement_slow"	"%HAREKET YAVAŞLATMASI:"
"[english]DOTA_Tooltip_ability_treant_leech_seed_nb2017_movement_slow"	"%MOVEMENT SLOW:"
"DOTA_Tooltip_ability_treant_leech_seed_nb2017_radius"	"YARIÇAP:"
"[english]DOTA_Tooltip_ability_treant_leech_seed_nb2017_radius"	"RADIUS:"
"DOTA_Tooltip_ability_treant_leech_seed_nb2017_duration"	"SÜRE:"
"[english]DOTA_Tooltip_ability_treant_leech_seed_nb2017_duration"	"DURATION:"
"DOTA_Tooltip_ability_treant_great_protector"	"Great Protector"
"[english]DOTA_Tooltip_ability_treant_great_protector"	"Great Protector"
"DOTA_Tooltip_ability_treant_great_protector_Description"	"Treant, köklerini salar ve boyutunu büyütür ve aynı zamanda büyük miktarda kuvvet kazanırken hareket hızını kaybeder."
"[english]DOTA_Tooltip_ability_treant_great_protector_Description"	"Treant plants his roots and grows in size, gaining large amounts of bonus strength while losing movement speed."
"DOTA_Tooltip_ability_treant_great_protector_Lore"	" "
"[english]DOTA_Tooltip_ability_treant_great_protector_Lore"	""
"DOTA_Tooltip_ability_treant_great_protector_bonus_strength"	"FAZLADAN KUVVET:"
"[english]DOTA_Tooltip_ability_treant_great_protector_bonus_strength"	"BONUS STRENGTH:"
"DOTA_Tooltip_ability_treant_great_protector_move_speed"	"HAREKET HIZI:"
"[english]DOTA_Tooltip_ability_treant_great_protector_move_speed"	"MOVE SPEED:"
"DOTA_Tooltip_ability_treant_great_protector_duration"	"SÜRE:"
"[english]DOTA_Tooltip_ability_treant_great_protector_duration"	"DURATION:"
"DOTA_Tooltip_ability_dragon_knight_dragon_tail_dungeon"	"Dragon Tail"
"[english]DOTA_Tooltip_ability_dragon_knight_dragon_tail_dungeon"	"Dragon Tail"
"DOTA_Tooltip_ability_dragon_knight_dragon_tail_dungeon_Description"	"Dragon Knight yakın mesafedeki bir düşman birimine kalkanıyla yapıştırarak sersemlemesini ve hafifçe hasar almasını sağlar. Elder Dragon Form'da iken kullanma menzili 400'e çıkar."
"[english]DOTA_Tooltip_ability_dragon_knight_dragon_tail_dungeon_Description"	"Dragon Knight smites an enemy unit in melee range with his shield, stunning it while dealing minor damage.  When in Elder Dragon Form, the cast range increases to 400."
"DOTA_Tooltip_ability_dragon_knight_dragon_tail_dungeon_Lore"	"Davion'ın ejderhalara özgü yetenekleri ve şövalye özellikle onu yakın dövüşte amansız bir rakibe dönüştürür."
"[english]DOTA_Tooltip_ability_dragon_knight_dragon_tail_dungeon_Lore"	"Davion's combination of dragon talents and knightly skills makes him a vicious opponent in melee combat."
"DOTA_Tooltip_ability_dragon_knight_dragon_tail_dungeon_stun_duration"	"SERSEMLETME SÜRESİ:"
"[english]DOTA_Tooltip_ability_dragon_knight_dragon_tail_dungeon_stun_duration"	"STUN DURATION:"
"DOTA_Tooltip_Ability_item_greater_salve"	"Greater Salve"
"[english]DOTA_Tooltip_Ability_item_greater_salve"	"Greater Salve"
"DOTA_Tooltip_Ability_item_greater_clarity"	"Greater Clarity"
"[english]DOTA_Tooltip_Ability_item_greater_clarity"	"Greater Clarity"
"DOTA_Tooltip_Ability_item_wand_of_the_brine_bonus_intelligence"	"+$int"
"[english]DOTA_Tooltip_Ability_item_wand_of_the_brine_bonus_intelligence"	"+$int"
"DOTA_Tooltip_Ability_item_wand_of_the_brine_bonus_mana_regen_pct"	"%+$mana_regen"
"[english]DOTA_Tooltip_Ability_item_wand_of_the_brine_bonus_mana_regen_pct"	"%+$mana_regen"
"DOTA_Tooltip_modifier_item_wand_of_the_brine_bubble"	"Brinefoam"
"[english]DOTA_Tooltip_modifier_item_wand_of_the_brine_bubble"	"Brinefoam"
"DOTA_Tooltip_modifier_item_wand_of_the_brine_bubble_Description"	"Bu birim Brineform tarafından korunmaktadır. Saniyede 300 sağlık yeniliyor."
"[english]DOTA_Tooltip_modifier_item_wand_of_the_brine_bubble_Description"	"This unit is protected by Brinefoam.  Healing 300 hp/sec."
"DOTA_Tooltip_Ability_item_slippers_of_the_abyss_Lore"	"Hacimli derinliklerde hızlı hareket edemeyenler ilk ölür."
"[english]DOTA_Tooltip_Ability_item_slippers_of_the_abyss_Lore"	"In the voluminous depths, those who cannot move swiftly will be the first to die."
"DOTA_Tooltip_Ability_item_slippers_of_the_abyss_bonus_movement_speed"	"FAZLADAN HAREKET HIZI:"
"[english]DOTA_Tooltip_Ability_item_slippers_of_the_abyss_bonus_movement_speed"	"BONUS MOVEMENT SPEED:"
"DOTA_Tooltip_Ability_item_slippers_of_the_abyss_bonus_atk_speed"	"FAZLADAN SALDIRI HIZI:"
"[english]DOTA_Tooltip_Ability_item_slippers_of_the_abyss_bonus_atk_speed"	"BONUS ATTACK SPEED:"
"DOTA_Tooltip_Ability_item_slippers_of_the_abyss_bonus_strength"	"+$str"
"[english]DOTA_Tooltip_Ability_item_slippers_of_the_abyss_bonus_strength"	"+$str"
"DOTA_Tooltip_Ability_item_slippers_of_the_abyss_bonus_agility"	"+$agi"
"[english]DOTA_Tooltip_Ability_item_slippers_of_the_abyss_bonus_agility"	"+$agi"
"DOTA_Tooltip_modifier_item_slippers_of_the_abyss_sprint"	"Aqueous Rush"
"[english]DOTA_Tooltip_modifier_item_slippers_of_the_abyss_sprint"	"Aqueous Rush"
"DOTA_Tooltip_modifier_item_slippers_of_the_abyss_sprint_Description"	"Bu birimin hareket hızı aşırı derecede arttı."
"[english]DOTA_Tooltip_modifier_item_slippers_of_the_abyss_sprint_Description"	"This unit has greatly increased movement speed."
"DOTA_Tooltip_Ability_item_glimmerdark_shield_Lore"	"Bu kalkanın ilk sahibi savaş alanında ölümsüz olduğuna inanıyordu ta ki ikinci sahibinin sihri akmaya başlayana dek."
"[english]DOTA_Tooltip_Ability_item_glimmerdark_shield_Lore"	"This shield's first bearer thought he had gained immortality in battle. Until the second bearer's magic began to flow."
"DOTA_Tooltip_Ability_item_glimmerdark_shield_bonus_strength"	"+$str"
"[english]DOTA_Tooltip_Ability_item_glimmerdark_shield_bonus_strength"	"+$str"
"DOTA_Tooltip_Ability_item_glimmerdark_shield_bonus_agility"	"+$agi"
"[english]DOTA_Tooltip_Ability_item_glimmerdark_shield_bonus_agility"	"+$agi"
"DOTA_Tooltip_Ability_item_glimmerdark_shield_bonus_intellect"	"+$int"
"[english]DOTA_Tooltip_Ability_item_glimmerdark_shield_bonus_intellect"	"+$int"
"DOTA_Tooltip_Ability_item_glimmerdark_shield_bonus_armor"	"FAZLADAN ZIRH:"
"[english]DOTA_Tooltip_Ability_item_glimmerdark_shield_bonus_armor"	"BONUS ARMOR:"
"DOTA_Tooltip_Ability_item_glimmerdark_shield_bonus_health_regen"	"FAZLADAN SAĞLIK YENİLEMESİ:"
"[english]DOTA_Tooltip_Ability_item_glimmerdark_shield_bonus_health_regen"	"BONUS HEALTH REGEN:"
"DOTA_Tooltip_Ability_item_ogre_seal_totem_bonus_strength"	"FAZLADAN KUVVET:"
"[english]DOTA_Tooltip_Ability_item_ogre_seal_totem_bonus_strength"	"BONUS STRENGTH:"
"DOTA_Tooltip_Ability_item_ogre_seal_totem_bonus_hp"	"FAZLADAN SAĞLIK:"
"[english]DOTA_Tooltip_Ability_item_ogre_seal_totem_bonus_hp"	"BONUS HP:"
"DOTA_Tooltip_Ability_item_bear_cloak_bonus_magic_resist"	"KENDİNE FAZLADAN BÜYÜ DİRENCİ:"
"[english]DOTA_Tooltip_Ability_item_bear_cloak_bonus_magic_resist"	"SELF BONUS MAGIC RESIST:"
"DOTA_Tooltip_modifier_item_bear_cloak_effect"	"Rough Bearskin"
"[english]DOTA_Tooltip_modifier_item_bear_cloak_effect"	"Rough Bearskin"
"DOTA_Tooltip_modifier_item_bear_cloak_effect_Description"	"Bu birim fazladan büyü direncine sahip."
"[english]DOTA_Tooltip_modifier_item_bear_cloak_effect_Description"	"This unit has bonus magic resistance."
"DOTA_Tooltip_ability_item_lifestone_Lore"	"Kana susamış bir taş."
"[english]DOTA_Tooltip_ability_item_lifestone_Lore"	"The stone thirsts for blood."
"DOTA_Tooltip_Ability_item_lifestone_hp_regen"	"SAĞLIK YENİLEMESİ:"
"[english]DOTA_Tooltip_Ability_item_lifestone_hp_regen"	"HP REGEN:"
"DOTA_Tooltip_modifier_item_lifestone_pact"	"Health Pact"
"[english]DOTA_Tooltip_modifier_item_lifestone_pact"	"Health Pact"
"DOTA_Tooltip_modifier_item_lifestone_pact_Description"	"Bu birim sağlığını manaya dönüştürüyor."
"[english]DOTA_Tooltip_modifier_item_lifestone_pact_Description"	"This unit is converting health into mana."
"DOTA_Tooltip_ability_item_corrupting_blade_Lore"	"Menekşe Arşivlerinde kaybolan dehşet verici bir silahın tarifi."
"[english]DOTA_Tooltip_ability_item_corrupting_blade_Lore"	"A terrifying weapon whose recipe was lost in the Violet Archives."
"DOTA_Tooltip_Ability_item_corrupting_blade_bonus_damage"	"+$damage"
"[english]DOTA_Tooltip_Ability_item_corrupting_blade_bonus_damage"	"+$damage"
"DOTA_Tooltip_modifier_item_corrupting_blade_buff"	"Devastation"
"[english]DOTA_Tooltip_modifier_item_corrupting_blade_buff"	"Devastation"
"DOTA_Tooltip_modifier_item_corrupting_blade_buff_Description"	"Violet Blade saldırıları bu birimin zırhını 14 azalttı."
"[english]DOTA_Tooltip_modifier_item_corrupting_blade_buff_Description"	"Violet Blade attacks reduced this unit's armor by 14."
"DOTA_Tooltip_ability_item_amorphotic_shell_Lore"	"Tam olarak kavranamayan bir şekle sahip."
"[english]DOTA_Tooltip_ability_item_amorphotic_shell_Lore"	"The shape of it can't quite be grasped."
"DOTA_Tooltip_Ability_item_amorphotic_shell_bonus_strength"	"FAZLADAN KUVVET:"
"[english]DOTA_Tooltip_Ability_item_amorphotic_shell_bonus_strength"	"BONUS STRENGTH:"
"DOTA_Tooltip_Ability_item_amorphotic_shell_bonus_intelligence"	"FAZLADAN ZEKÂ:"
"[english]DOTA_Tooltip_Ability_item_amorphotic_shell_bonus_intelligence"	"BONUS INTELLIGENCE:"
"DOTA_Tooltip_Ability_item_amorphotic_shell_bonus_agility"	"FAZLADAN ÇEVİKLİK:"
"[english]DOTA_Tooltip_Ability_item_amorphotic_shell_bonus_agility"	"BONUS AGILITY:"
}
}
